ܐܦܪܝܩܐ	Afrika
ܝܦܢ	Japan
ܐܡܪܝܩܐ ܬܝܡܢܝܬܐ	Südamerika
ܢܘܪܒܝܓ	Norwegen
ܩܘܛܢܝܘܬܐ ܕܐܝܪܠܢܕ	Irland
ܡܓܪ	Ungarn
ܐܣܦܢܝܐ	Spanien
ܐܘܚܕܢܐ ܡܚܝܕܐ	Vereinigte Staaten
ܒܠܓܝܩܐ	Belgien
ܠܘܟܣܡܒܘܪܓ	Luxemburg
ܬܒܝܠ	Universum
ܐܪܥܐ	Erde
ܡܘܬܐ	Tod
ܒܪ ܐܢܫܐ	Mensch
ܓܘܪܓ ܘܐܫܝܢܓܛܘܢ	George Washington
ܦܝܢܠܢܕ	Finnland
ܣܘܝܕ	Schweden
ܕܐܢܡܐܪܩ	Dänemark
ܦܘܠܢܕ	Polen
ܠܬܘܢܝܐ	Litauen
ܐܝܛܠܝܐ	Italien
ܣܘܝܣܪܐ	Schweiz
ܢܡܣܐ	Österreich
ܝܘܢ	Griechenland
ܛܘܪܩܝܐ	Türkei
ܦܘܪܛܘܓܠ	Portugal
ܐܘܪܘܦܐ (ܝܒܫܬܐ)	Europa
ܐܣܝܐ (ܝܒܫܬܐ)	Asien
ܐܡܪܝܩܐ ܓܪܒܝܝܬܐ	Nordamerika
ܐܢܛܐܪܩܛܝܩܐ	Antarktika
ܘܝܩܝܦܕܝܐ	Wikipedia
ܗܘܠܢܕܐ	Niederlande
ܢܝܘ ܝܘܪܩ (ܡܕܝܢܬܐ)	New York City
ܘܐܫܢܓܛܘܢ (ܐܪܫܟܝܬܐ)	Washington, D.C.
ܒܪܠܝܢ	Berlin
ܚܫܘܒܐ (ܡܐܟܢܐ)	Computer
ܒܪܢ	Bern
ܬܣܝܪܝܟ	Zürich
ܐܢܛܪܢܛ	Internet
ܒܪܐܩ ܐܘܒܐܡܐ	Barack Obama
ܠܘܢܕܘܢ	London
ܐܠܟܣܢܕܪܝܐ	Alexandria
ܦܐܪܝܣ	Paris
ܡܟܣܝܩܘ	Mexiko
ܐܘܩܝܢܘܣ ܐܛܠܢܛܝܐ	Atlantischer Ozean
ܐܘܩܝܢܘܣ ܫܝܢܝܐ	Pazifischer Ozean
ܒܘܣܛܘܢ	Boston
ܬܪܝܢܒܫܒܐ	Montag
ܟܢܘܢ ܒ	Januar
ܫܒܛ	Februar
ܐܕܪ	März
ܟܘܫ	Äthiopien
ܢܝܣܢ	April
ܐܝܪ	Mai
ܚܙܝܪܢ	Juni
ܬܡܘܙ	Juli
ܐܒ	August
ܐܝܠܘܠ	September
ܬܫܪܝܢ ܐ	Oktober
ܬܫܪܝܢ ܒ	November
ܟܢܘܢ ܐ	Dezember
ܬܠܬܒܫܒܐ	Dienstag
ܐܪܒܥܒܫܒܐ	Mittwoch
ܚܡܫܒܫܒܐ	Donnerstag
ܥܪܘܒܬܐ	Freitag
ܫܒܬܐ (ܙܒܢܐ)	Samstag
ܚܕܒܫܒܐ	Sonntag
ܐܪܝܐ	Löwe
ܦܪܢܣܐ	Frankreich
ܟܠܒܐ	Haushund
ܡܠܟܘܬܐ ܡܚܝܕܬܐ	Vereinigtes Königreich
ܩܛܐ	Hauskatze
ܩܘܛܢܝܘܬܐ ܥܡܡܝܬܐ ܕܨܝܢ	Volksrepublik China
ܠܫܢܐ ܦܪܢܣܝܐ	Französische Sprache
ܒܪܐܙܝܠ	Brasilien
ܪܘܣܝܐ	Russland
ܝܡܐ	Meer
ܝܡܐ ܐܘܟܡܐ	Schwarzes Meer
Π	Pi (Buchstabe)
ܐܠܒܐܡܐ	Alabama
ܣܐܘ ܦܐܘܠܘ	São Paulo
ܩܝܒܩ (ܗܘܦܪܟܝܐ)	Québec
ܓܪܡܢ	Deutschland
ܒܠܐܪܘܣ	Weißrussland
ܠܫܢܐ ܓܪܡܢܝܐ	Deutsche Sprache
ܐܠܗܐ	Gott
ܐܣܛܘܢܝܐ	Estland
ܛܝܣܬܐ	Flugzeug
ܩܪܒܐ	Krieg
1 (ܡܢܝܢܐ)	Eins
2 (ܡܢܝܢܐ)	Zwei
3 (ܡܢܝܢܐ)	Drei
4 (ܡܢܝܢܐ)	Vier
5 (ܡܢܝܢܐ)	Fünf
ܠܐܛܒܝܐ	Lettland
ܐܘܩܪܐܝܢܐ	Ukraine
ܬܫܝܟ	Tschechien
ܣܠܘܒܩܝܐ	Slowakei
ܣܠܘܒܢܝܐ	Slowenien
ܡܘܠܕܘܒܐ	Moldawien
ܪܘܡܢܝܐ	Rumänien
ܒܘܠܓܐܪܝܐ	Bulgarien
ܪܗܘܡܐ (ܡܕܝܢܬܐ)	Rom
ܩܘܛܢܝܘܬܐ ܕܡܩܕܘܢܝܐ	Mazedonien
ܐܠܒܢܝܐ	Albanien
ܩܪܘܐܛܝܐ	Kroatien
ܒܘܣܢܐ ܘܗܪܬܣܓܘܒܝܢܐ	Bosnien und Herzegowina
ܐܙܪܒܝܓܐܢ	Aserbaidschan
ܐܢܕܘܪܐ	Andorra
ܩܘܦܪܘܣ	Republik Zypern
ܓܘܪܓܝܐ (ܐܬܪܐ)	Georgien
ܩܙܩܣܛܐܢ	Kasachstan
ܡܝܠܛܐ	Malta
ܡܘܢܐܩܘ	Monaco
ܛܘܪܐ ܐܘܟܡܐ	Montenegro
ܡܕܝܢܬܐ ܕܘܛܝܩܢ	Vatikanstadt
ܣܢ ܡܪܝܢܘ	San Marino
ܒܪܘܟܣܠ	Region Brüssel-Hauptstadt
ܠܘܕܒܝܓ ܒܐܢ ܒܝܛܗܘܒܢ	Ludwig van Beethoven
ܠܫܢܐ ܛܘܪܩܝܐ	Türkische Sprache
ܓܙܐܐܪ	Algerien
ܐܘܙܒܩܣܛܐܢ	Usbekistan
ܘܐܪܣܘ	Warschau
ܚܡܪܐ (ܫܬܝܐ)	Wein
ܡܝܐ	Wasser
ܦܪܣ ܚܙܘܐ	Fernsehen
ܬܫܝܠܝ	Chile
ܐܠ ܓܪܝܩܘ	El Greco
ܝܫܘܥ	Jesus Christus
ܠܫܢܐ (ܡܡܠܠܐ)	Sprache
ܫܘܠܛܢ ܛܪܘܢܘܬܐ	Diktatur
ܡܡܠܠܘܬ ܟܘܟܒܐ	Astronomie
ܡܪܝܡ (ܐܡܗ ܕܝܫܘܥ)	Maria (Mutter Jesu)
ܠܝܟܛܢܫܛܝܢ	Liechtenstein
ܐܕܘܠܦ ܗܝܛܠܪ	Adolf Hitler
ܠܝܢܘܟܣ	Linux
ܠܫܢܐ ܠܐܛܝܢܝܐ	Latein
ܒܚܪܝܢ	Bahrain
ܐܪܡܢܝܐ	Armenien
ܣܪܒܝܐ	Serbien
ܣܗܪܐ	Mond
ܐܝܣܛܢܒܘܠ (ܡܕܝܢܬܐ)	Istanbul
ܐܘܣܛܪܠܝܐ (ܐܬܪܐ)	Australien
ܦܝܣܝܟ	Physik
ܩܘܪܐܢ	Koran
ܐܣܠܐܡ	Islam
ܟܡܬܪܐ	Birnen
ܠܟ ܒܐܘܢܣܐ	Lech Wałęsa
ܫܠܡܐ (ܫܝܢܐ)	Frieden
ܚܘܝܕܐ ܐܘܪܘܦܝܐ	Europäische Union
ܐܢܬܬܐ	Frau
ܛܝܙܐ	Anus
ܫܚܬܐ (ܝܘܠܦܢ ܨܪܘܝܘܬܐ)	Achsel
ܗܒܒܐ	Blüte
ܝܘܠܦܢ ܨܪܘܝܘܬܐ	Anatomie
ܡܕܝܢܬܐ	Stadt
ܢܐܦܠܝܘܢ ܒܘܢܐܦܪܛ	Napoleon Bonaparte
ܟܘܟܒܐ	Stern
ܫܡܫܐ	Sonne
ܩܪܝܬܐ	Dorf
ܝܡܐ ܕܡܕܢܚܐ	Ostsee
ܫܢܐ	Zahn
ܘܝܩܝܡܝܕܝܐ ܩܘܡܡܘܢܣ	Wikimedia Commons
ܟܬܒܐ (ܣܦܪܐ)	Buch
ܝܘܡܐ	Tag
ܠܠܝܐ	Nacht
ܫܢܬܐ (ܙܒܢܐ)	Jahr
ܕܪܐ	Jahrhundert
ܐܘܣܠܘ	Oslo
ܠܫܒܘܢܐ	Lissabon
ܦܠܝܛܐ	Planet
ܙܡܪܘܬܐ	Musik
ܡܘܣܩܒܐ	Moskau
ܠܫܢܐ ܐܝܛܠܝܐ	Italienische Sprache
ܬܫܐܕ	Tschad
ܬܝܡܢܐ	Norden
ܢܝܘ ܙܝܠܢܕ	Neuseeland
ܓܪܒܝܐ	Süden
ܗܢܕܘ	Indien
ܦܪܙܠܐ	Eisen
ܡܥܪܒܐ	Westen
ܡܕܢܚܐ	Osten
ܒܢܙܘܝܠܐ	Venezuela
ܛܠܦܣܢܐ	Schach
ܡܝܢ	Maine
ܣܘܣܝܐ	Hauspferd
ܐܡܣܛܪܕܐܡ	Amsterdam
ܙܝܢܐ	Waffe
ܚܝܘܬܐ	Tier
ܩܘܠܘܡܒܝܐ	Kolumbien
ܢܝܘ ܗܐܡܦܫܪ	New Hampshire
ܠܝܘܢܪܕܘ ܕܗ ܒܢܬܫܝ	Leonardo da Vinci
ܡܐܣܐܬܫܘܣܬܣ	Massachusetts
ܐܘܛܪܝܟܛ (ܗܘܦܪܟܝܐ)	Provinz Utrecht
ܟܘܢܝܬܝܟܬ	Connecticut
ܐܝܪܐܢ	Iran
ܥܝܪܐܩ	Irak
ܐܠܐܣܟܐ	Alaska
ܐܝܣܪܐܝܠ	Israel
ܐܘܛܪܝܟܛ (ܡܕܝܢܬܐ)	Utrecht
ܝܡܢ	Jemen
ܠܫܢܐ ܦܘܠܢܕܝܐ	Polnische Sprache
ܝܘܪܕܢܢ	Jordanien
ܩܝܪܓܝܙܣܛܐܢ	Kirgisistan
ܐܪܝܙܘܢܐ	Arizona
ܟܘܘܝܬ (ܐܬܪܐ)	Kuwait
ܠܒܢܢ	Libanon
ܐܘܪܝܓܘܢ	Oregon
ܐܡܪܝܩܐ	Amerika
ܝܘܬܐ	Utah
ܫܠܡܐ (ܦܬܓܡܐ)	Ciao (Gruß)
ܥܘܡܐܢ	Oman
ܦܐܩܣܛܐܢ	Pakistan
ܩܛܪ	Katar
ܣܥܘܕܝܐ	Saudi-Arabien
ܝܘܣܦ ܣܛܐܠܝܢ	Josef Stalin
ܣܘܪܝܐ	Syrien
ܛܐܓܝܩܣܛܐܢ	Tadschikistan
ܦܪܣ ܩܠܐ	Hörfunk
ܛܘܪܩܡܢܣܛܐܢ	Turkmenistan
ܐܡܝܪܘܬܐ ܥܪܒܝܬܐ ܡܚܝܕܬܐ	Vereinigte Arabische Emirate
ܐܦܓܐܢܣܛܐܢ	Afghanistan
ܕܗܒܐ	Gold
ܡܠܝ	Mali
ܦܝܠܝܦܝܢܝܐ	Philippinen
ܩܘܛܢܝܘܬܐ ܕܐܦܪܝܩܐ ܡܨܥܝܬܐ	Zentralafrikanische Republik
ܐܝܣܚܩ ܢܝܘܛܢ	Isaac Newton
ܫܥܘܬܐ (ܓܘܢܐ)	Gelb
ܬܘܢܣ (ܐܬܪܐ)	Tunesien
ܬܝܡܢܐ ܕܣܘܕܐܢ	Südsudan
ܩܘܛܢܝܘܬܐ ܕܩܘܢܓܘ	Republik Kongo
ܩܘܛܢܝܘܬܐ ܕܩܘܢܓܘ ܕܝܡܘܩܪܛܝܬܐ	Demokratische Republik Kongo
ܦܐܦܐ ܝܘܚܢܢ ܦܘܠܘܣ ܬܪܝܢܐ	Johannes Paul II.
ܛܒܝܠܝܣܝ	Tiflis
ܩܐܡܪܘܢ	Kamerun
ܠܘܒܐ	Libyen
ܡܘܪܝܛܢܝܐ	Mauretanien
ܡܓܪܒ	Marokko
ܢܝܓܪ	Niger
ܣܘܕܐܢ	Sudan
ܩܫܬܐ ܕܡܪܢ	Regenbogen
ܗܐܡܒܘܪܓ	Hamburg
ܝܡܬܐ ܕܐܘܢܛܪܝܘ	Ontariosee
ܝܡܬܐ ܕܣܘܦܝܪܝܘܪ	Oberer See
ܓܐܘܓܪܦܝܐ	Geographie
ܠܒܐ	Herz
ܡܘܚܐ	Gehirn
ܓܠܕܐ	Haut
ܓܘܢܐ	Farbe
ܦܪܐܓ	Prag
ܙܪܩܐ	Blau
ܟܣܦܐ (ܣܐܡܐ)	Silber
ܡܫܝܓܢ	Michigan
ܝܡܬܐ ܕܡܝܫܝܓܢ	Michigansee
ܐܠܝܢܘܝ	Illinois
ܢܘܪܬ ܕܐܟܘܬܐ	North Dakota
ܣܐܘܬ ܕܐܟܘܬܐ	South Dakota
ܡܘܢܬܐܢܐ	Montana
ܘܐܝܘܡܝܢܓ	Wyoming
ܐܘܪܫܠܡ	Jerusalem
ܐܝܕܐܗܘ	Idaho
ܢܝܒܐܕܐ	Nevada
ܐܘܩܝܢܘܣ ܗܢܕܘܝܐ	Indischer Ozean
ܟܘܠܘܪܐܕܘ	Colorado
ܫܝܩܓܘ	Chicago
ܣܬܘܐ	Winter
ܬܕܐܐ	Frühling
ܩܝܛܐ	Sommer
ܬܫܪܝܬܐ	Herbst
ܨܕܐܡ ܚܘܣܝܢ	Saddam Hussein
ܠܫܢܐ ܐܣܦܢܝܐ	Spanische Sprache
ܓܘܓܝ	Webspinnen
ܐܒܐ (ܦܐܪܐ)	Frucht
ܒܪܓܝܢܝܐ	Virginia
ܝܡܬܐ ܕܝܘܪܘܢ	Huronsee
ܢܝܘ ܝܘܪܩ (ܐܘܚܕܢܐ ܡܚܝܕܐ)	New York (Bundesstaat)
ܪܘܕ ܐܝܠܐܢܕ	Rhode Island
ܪܚܫܐ	Insekten
ܡܐܪܝܠܐܢܕ	Maryland
ܕܝܠܐܘܝܪ	Delaware
ܐܘܗܐܝܘ	Ohio
ܦܢܣܝܠܒܐܢܝܐ	Pennsylvania
ܐܝܛܙܢ	Uetersen
ܐܓܘܣܛܘܣ ܩܣܪ	Augustus
ܢܝܘ ܓܝܪܣܝ	New Jersey
ܐܢܕܝܐܢܐ	Indiana
ܪܕܝܬܐ	Automobil
ܓܘܪܓܝܐ (ܐܘܚܕܢܐ ܡܚܝܕܐ)	Georgia
ܣܩܠܝܐ	Autonome Region Sizilien
ܣܢ (ܢܗܪܐ)	Seine
ܛܘܩܝܘ	Präfektur Tokio
ܦܪܕܝܢܢܕ ܡܓܝܠܢ	Ferdinand Magellan
ܢܝܘ ܡܝܟܣܝܟܘ	New Mexico
ܐܬܢܘܣ	Athen
ܡܢܝܣܘܬܐ	Minnesota
ܒܓܕܐܕ (ܡܕܝܢܬܐ)	Bagdad
ܘܝܣܟܘܢܣܢ	Wisconsin
ܐܝܐܘܐ	Iowa
ܢܝܒܪܐܣܟܐ	Nebraska
ܟܐܢܣܐܣ	Kansas
ܡܝܙܘܪܝ	Missouri
ܐܪܟܢܣܐܣ	Arkansas
ܠܫܢܐ ܕܐܘܪܕܘ	Urdu
ܐܘܟܠܐܗܘܡܐ	Oklahoma
ܝܡܐ ܕܓܪܒܝܐ	Nordsee
ܒܝܝܢܐ	Wien
ܩܘܦܢܗܐܓܢ	Kopenhagen
ܣܛܘܩܗܘܠܡ	Stockholm
ܗܠܣܢܩܝ	Helsinki
ܕܒܠܢ	Dublin
ܒܪܛܝܣܠܐܒܐ	Bratislava
ܟܬܒܐ ܩܕܝܫܐ	Bibel
ܥܕܬܐ ܫܪܝܪܬܐ ܕܝܫܘܥ	Wahre Jesus-Kirche
ܠܫܢܐ ܐܢܓܠܝܐ	Englische Sprache
ܩܘܢܣܦܣܝܘܢ (ܬܫܝܠܝ)	Concepción (Chile)
ܐܘܢܛܐܪܝܘ	Ontario
ܡܐܢܝܛܘܒܐ	Manitoba
ܐܠܒܪܛܐ	Alberta
ܢܘܒܐ ܣܩܘܛܝܐ	Nova Scotia
ܩܘܢܣܩܘܒܘܠܐ	Końskowola
ܢܝܘ ܒܪܘܢܙܘܝܩ	New Brunswick
ܩܘܠܘܡܒܝܐ ܒܪܝܛܝܬܐ	British Columbia
ܓܙܪܬܐ ܕܐܡܝܪܐ ܐܕܘܐܪܕ	Prince Edward Island
ܣܐܣܩܐܬܫܘܐܢ	Saskatchewan
2012	2012
2011	2011
2010	2010
2009	2009
ܢܝܘܦܐܘܢܕܠܢܕ ܘܠܐܒܪܐܕܘܪ	Neufundland und Labrador
2008	2008
ܐܘܚܕܢܐ ܓܪܒܝܝܐ-ܡܥܪܒܝܐ	Nordwest-Territorien
ܝܘܩܘܢ	Yukon (Territorium)
2005	2005
2006	2006
ܢܘܢܐܒܘܛ	Nunavut
2007	2007
ܡܐܟܘܠܬܐ	Lebensmittel
ܚܘܝܐ	Schlangen
ܩܘܪܘܦ	Kurów
ܟܝܡܝܐ	Chemie
1968	1968
ܩܛܠܥܡܐ ܝܗܘܕܝܐ	Holocaust
ܡܕܪܝܕ (ܡܕܝܢܬܐ)	Madrid
ܗܘܦܪܟܝܣ ܘܐܘܚܕܢܐ ܕܩܢܕܐ	Provinzen und Territorien Kanadas
ܣܢܛܝܐܓܘ ܕܐ ܬܫܝܠܝ	Santiago de Chile
ܚܐܪܘܬܐ	Freiheit
ܣܝܕܢܝ	Sydney
ܝܪܘܩܐ	Grün
ܡܠܒܘܪܢ	Melbourne
ܣܘܡܩܐ	Rot
ܢܘܪܐ (ܕܠܩܐ)	Feuer
ܢܝܠܘܣ	Nil
ܓܙܐܐܪ (ܡܕܝܢܬܐ)	Algier
ܬܘܢܣ (ܡܕܝܢܬܐ)	Tunis
ܛܗܪܐܢ	Teheran
ܐܢܩܪܐ	Ankara
ܢܝܐܡܝ	Niamey
ܒܡܩܘ	Bamako
ܕܪܡܣܘܩ	Damaskus
ܥܡܐܢ	Amman
ܒܝܪܘܬ	Beirut
ܒܝܬ ܨܘܒܐ	Universität
ܒܝܬܐ (ܒܢܝܢܐ)	Haus
ܐܘܣܛܪܠܝܐ (ܝܒܫܬܐ)	Australien (Kontinent)
ܢܗܪܐ	Fluss
ܪܝܫܐ ܕܣܒܪܐ ܛܒܐ	Kap der Guten Hoffnung
ܫܘܚܡܠܐ	Investition
ܩܘܪܝܛܝܒܐ	Curitiba
ܥܒܐ	Wald
ܩܘܢܦܘܫܝܘܣ	Konfuzius
ܩܢܐ	Nest
ܐܘܪܘ	Euro
ܝܡܐ ܚܘܪܐ ܡܨܥܝܐ	Mittelmeer
ܓܘܪܓܝܐ	Georgia (Begriffsklärung)
ܡܫܝܚܝܘܬܐ	Christentum
ܩܠܒܐ:ܐܘܝܐ	Vorlage:Pro
ܪܘܙܐ	Reis
ܝܒܫܬܐ	Kontinent
ܛܝܪܐ	Vögel
ܐܪܫܟܝܬܐ	Hauptstadt
ܠܫܢܐ ܦܘܪܛܘܓܠܝܐ	Portugiesische Sprache
ܝܪܚܐ	Monat
ܡܘܨܛܦܐ ܟܡܐܠ ܐܛܐܛܘܪܩ	Mustafa Kemal Atatürk
ܐܠܡܐܙܢ	Almazán
ܠܫܢܐ ܝܦܢܝܐ	Japanische Sprache
ܦܐܬܐ ܪܝܫܝܬܐ	Wikipedia:Hauptseite
ܦܪܢܣܝܣܩܘ ܓܘܝܐ	Francisco de Goya
ܝܡܐ ܐܚܪܝܐ	Kaspisches Meer
ܝܡܬܐ ܕܐܝܪܝ	Eriesee
ܣܠܒܐܕܘܪ ܕܐܠܝ	Salvador Dalí
ܒܢܣܢܬ ܦܢ ܟܘܟ	Vincent van Gogh
ܦܪܝܕܐ ܩܐܠܘ	Frida Kahlo
ܗܢܪܝ ܡܐܛܝܣ	Henri Matisse
ܡܝܟܠܐܢܓܠܘ	Michelangelo
ܦܒܠܘ ܦܝܩܐܣܘ	Pablo Picasso
ܪܡܒܪܢܛ	Rembrandt van Rijn
ܐܢܕܝ ܘܘܪܗܘܠ	Andy Warhol
ܢܝܢܘܐ (ܡܕܝܢܬܐ)	Ninive
ܒܒܠ	Babylon
ܐܝܪܝܚܘ	Jericho
ܩܛܠܘܢܝܐ	Katalonien
ܡܕܪܝܕ (ܗܘܦܪܟܝܐ)	Autonome Gemeinschaft Madrid
ܒܝܬ ܠܚܡ	Bethlehem
ܣܕܪܐ:Candidates for speedy deletion	Kategorie:Wikipedia:Schnelllöschen
ܪܫܡܠܘܬܐ	Kapitalismus
ܐܘܡܬܐ	Nation
ܩܪܬܐܓܘ	Karthago
ܣܕܪܐ:ܐܣܛܪܘܢܘܡܝܐ	Kategorie:Astronomie
ܨܚܪܐܐ	Sahara
ܫܐܕܐ	Teufel
ܒܝܬ ܟܬܒܐ	Bibliothek
ܫܘܠܛܢܘܬܐ (ܫܘܬܐܣܐ)	Regierung
ܬܫܝܢ ܫܝ ܗܘܐܢܓ	Qin Shihuangdi
ܡܕܢܚܐ ܡܨܥܝܬܐ	Mittlerer Osten
ܡܠܟܘܬܐ	Monarchie
ܩܘܛܢܝܘܬܐ	Republik
ܐܬܪܐ	Staat
ܓܒܐ	Politische Partei
ܝܗܘܕܝܐ	Juden
ܝܡܡܬܐ ܪܘܪܒܬܐ	Große Seen
ܐܘܩܝܢܘܣ ܬܝܡܢܝܐ	Südlicher Ozean
ܐܕܢܐ (ܝܘܠܦܢ ܨܪܘܝܘܬܐ)	Ohr
ܢܚܝܪܐ	Nase
ܥܝܢܐ (ܝܘܠܦܢ ܨܪܘܝܘܬܐ)	Auge
ܙܡܝܪܬܐ	Lied
ܓܡܠܐ	Altweltkamele
ܫܘܫܡܢܐ	Ameisen
ܕܒܫܬܐ	Bienen
ܠܫܢܐ ܗܘܠܢܕܝܐ	Niederländische Sprache
ܐܡܐ (ܒܝܬܝܘܬܐ)	Mutter
ܐܒܐ (ܒܝܬܝܘܬܐ)	Vater
1847	1847
ܨܦܪܐ (ܙܒܢܐ)	Morgen (Tageszeit)
ܪܡܫܐ	Abend
ܩܛܝܢܬܐ	Minute
ܠܫܢܐ ܪܘܣܝܐ	Russische Sprache
ܩܢܘܢܐ	Recht
ܠܫܢܐ ܨܝܢܝܐ	Chinesische Sprachen
ܕܡܐ	Blut
ܬܓܪܘܡܬܐ	Skelett
ܪܐܬܐ	Lunge
ܠܫܢܐ ܪܘܡܢܝܐ	Rumänische Sprache
ܡܛܪܐ	Regen
ܢܠܣܘܢ ܡܐܢܕܝܠܐ	Nelson Mandela
ܐܒܢܐ	Gestein
ܥܢܢܐ	Wolke
ܩܢܘܢܐ ܕܠܥܙܐ	Grammatik
ܠܫܢܐ ܓܘܪܓܝܐ	Georgische Sprache
ܝܘܠܦܢ ܡܡܫܚܘܬܐ	Wirtschaftswissenschaft
ܙܘܙܐ	Währung
ܡܕܐܬܐ	Steuer
ܐܠܦܒܝܬ ܥܪܒܝܐ	Arabisches Alphabet
ܐܠܦܒܝܬ ܝܘܢܝܐ	Griechisches Alphabet
ܐܠܦܒܝܬ ܠܐܛܝܢܝܐ	Lateinisches Alphabet
ܣܕܪܐ:ܦܪܢܣܐ	Kategorie:Frankreich
ܟܢܫܐ	Gesellschaft (Soziologie)
ܓܒܪܐ	Mann
ܙܘܘܓܐ	Ehe
ܙܕܩܐ ܕܒܪܢܫܐ	Menschenrechte
ܩܪܒܐ ܓܘܝܐ	Bürgerkrieg
ܓܪܡܐ ܕܣܢܘܢܝܬܐ	Brustbein
ܬܪܝܢܐ	Fruchtsaft
ܚܠܒܐ (ܕܝܘܒܐ)	Milch
ܛܘܪܐ	Berg
ܡܕܒܪܐ	Wüste
ܠܫܢܐ ܐܠܒܢܝܐ	Albanische Sprache
ܠܫܢܐ ܐܪܡܢܝܐ	Armenische Sprache
ܝܘܗܐܢ ܓܘܛܢܒܪܓ	Johannes Gutenberg
ܠܫܢܐ ܣܘܝܕܝܐ	Schwedische Sprache
ܢܝܩܘܠܐ ܛܣܠܐ	Nikola Tesla
ܡܘܫܐ	Mose
ܬܕܐ	Weibliche Brust
ܢܘܗܪܐ (ܚܙܝܬܐ)	Licht
ܠܫܢܐ ܝܘܢܝܐ	Griechische Sprache
ܠܫܢܐ ܦܪܣܝܐ	Persische Sprache
ܬܘܕܝܬܐ	Religion
ܐܒܪܗܡ	Abraham
ܣܦܪܐ ܕܒܪܝܬܐ	1. Buch Mose
ܠܫܢܐ ܡܢܕܪܝܢܝܐ	Nordchinesische Dialekte
ܦܘܠܘܣ ܫܠܝܚܐ	Paulus von Tarsus
ܙܝܓܡܘܢܕ ܦܪܘܝܕ	Sigmund Freud
ܙܠܛܐ	Salat (Gericht)
ܝܗܘܕܝܘܬܐ	Judentum
ܠܫܢܐ ܥܒܪܝܐ	Hebräische Sprache
ܟܒܕܐ	Leber
ܛܚܠܐ	Milz
ܟܘܠܝܬܐ	Niere
ܫܠܦܘܚܬܐ	Harnblase
ܐܫܟܐ	Hoden
ܐܘܩܝܢܘܣ	Ozean
ܒܘܕܗܐ	Siddhartha Gautama
ܡܘܚܡܕ	Mohammed
ܟܪܣܐ	Abdomen
ܚܒܠܐ ܟܘܒܝܐ	Rückenmark
ܘܪܝܕܐ	Vene
ܡܪܒܥܐ	Gebärmutter
ܠܫܢܐ (ܗܕܡܐ)	Zunge
ܓܝܕܐ	Nerv
ܨܘܪܐ (ܝܘܠܦܢ ܨܪܘܝܘܬܐ)	Hals
ܦܘܡܐ	Mund
ܓܓܪܬܐ	Kehlkopf
ܡܥܝܐ	Darm
ܫܪܝܬܐ	Gelenk
ܚܕܝܐ	Brust
ܬܝܪܬܐ	Drüse
ܚܠܒܐ (ܝܘܠܦܢ ܨܪܘܝܘܬܐ)	Zwerchfell
ܫܪܝܢܐ	Arterie
A	A
B	B
ܢܘܛܦܬܐ	Sperma
G	G
U	U
Z	Z
F	F
J	J
ܐܠܦܒܝܬ	Alphabet
T	T
C	C
R	R
D	D
Α	Alpha
Ω	Omega
I	I
Μ	My
E	E
H	H
ܗܐܪܠܡ (ܗܘܠܢܕܐ)	Haarlem
K	K
L	L
M	M
N	N
O	O
Q	Q
S	S
V	V
W	W
X	X
Y	Y
ܐܢܫܟܕܐ	Enschede
ܗܢܓܠܘ	Hengelo
Φ	Phi
ܝܘܢܐ	Tauben
ܐܝܠܢܐ	Baum
Λ	Lambda
ܓܒܬܐ	Käse
ܥܢܒܬܐ	Weintraube
ܕܒܫܐ	Honig
ܒܣܪܐ	Fleisch
ܫܟܪ	Zucker
ܣܦܪܙܒܢܐ	Zeitung
ܙܥܘܩܐ	Telefon
ܡܪܕܘܬܐ	Kultur
ܡܥܝܐ ܥܒܝܐ	Dickdarm
ܡܥܝܐ ܩܛܝܢܐ	Dünndarm
ܣܘܪܓܕܐ ܝܘܠܝܝܐ	Julianischer Kalender
ܐܣܝܘܬܐ	Medizin
ܡܠܚܐ (ܐܨܪܐ)	Speisesalz
ܣܕܪܐ:ܒܪܐܙܝܠ	Kategorie:Brasilien
ܙܘܝܬܐ (ܡܚܪܘܬܐ)	Winkel
ܬܘܩܦܐ	Energie
ܣܦܝܢܬܐ	Schiff
ܩܠܐ (ܨܘܬܐ)	Schall
ܙܓܘܓܝܬܐ	Glas
ܫܛܝܚܘܬܐ	Flächeninhalt
ܡܢܝܢܐ	Zahl
ܪܦܦܐ	Sekunde
ܣܥܪܬܐ	Gerste
ܘܘܗܐܢ	Wuhan
ܡܟܬܒܢܘܬܐ ܕܐܬܪܘܬܐ	Liste der Staaten der Erde
ܒܝܬ ܢܗܪܝܢ	Mesopotamien
ܕܒܐ	Bären
ܬܠܗܝܐ	Krebs (Medizin)
ܡܠܟܐ	König
ܚܛܬܐ	Weizen
ܣܘܪܓܕܐ	Kalender
ܟܘܪܗܢܐ	Krankheit
ܣܘܪܓܕܐ ܓܪܝܓܘܪܝܐ	Gregorianischer Kalender
ܟܦܣܐ	Menstruation
ܥܡܐ ܩܪܕܘܝܐ	Kurden
ܓܫܪܐ	Brücke
ܡܓܕܠܐ (ܒܢܝܢܐ)	Turm
ܐܡܪܝܩܐ ܠܐܛܝܢܝܬܐ	Lateinamerika
ܟܗܪܒܐ	Elektrizität
ܡܙܝܥܢܐ ܕܩܝܕܐ ܓܘܝܐ	Verbrennungskraftmaschine
ܣܝܦܐ (ܙܝܢܐ)	Schwert
ܫܡܥܘܢ ܩܢܢܝܐ	Simon Zelotes
ܩܪܩܦܬܐ	Schädel
ܓܘܡܠܐ!	Joomla
ܐܦܫܬܐ	Rosine
ܠܫܢܐ ܕܗܣܝܐܢܓ	Xiang (Sprache)
ܠܫܢܐ ܥܪܒܝܐ	Arabische Sprache
ܠܫܢܐ ܐܦܪܝܩܐܢܝܐ	Afrikaans
Β	Beta
Γ	Gamma
Δ	Delta
Ε	Epsilon
Ζ	Zeta
Η	Eta
Θ	Theta
Ι	Iota
Κ	Kappa
Ν	Ny
Ξ	Xi
Ο	Omikron
Ρ	Rho
Σ	Sigma
Τ	Tau (Buchstabe)
Υ	Ypsilon
Χ	Chi
Ψ	Psi (Buchstabe)
ܐܬܐ	Flagge
ܟܪܦܬܐ	Möbel
ܟܘܪܣܝܐ	Stuhl (Möbel)
ܣܦܬܐ	Lippe
ܦܣܡܐ	Schnurrbart
ܥܩܠܐ	Fuß
1000000000 (ܡܢܝܢܐ)	Milliarde
ܓܪܡܐ ܕܨܕܥܐ	Schläfenbein
ܩܠܝܕܐ (ܓܪܡܐ)	Schlüsselbein
ܟܬܦܐ	Schulter
ܦܟܐ ܬܚܬܝܐ	Unterkiefer
ܥܠܡܐ (ܐܪܥܐ)	Welt
ܘܝܩܝܦܕܝܐ:ܬܪܥܐ ܕܟܢܫܐ	Wikipedia:Projektdiskussion
ܒܝܪܡܘܢܬ	Vermont
ܩܘܣܛܢܛܝܢܘܦܘܠܝܣ	Konstantinopel
ܒܝܬ ܟܪܝܗܐ	Krankenhaus
ܥܕܬܐ	Kirche (Bauwerk)
ܕܝܬܝܩܝ ܚܕܬܐ	Neues Testament
9 (ܡܢܝܢܐ)	Neun
1002	1002
ܦܘܕܘܠܣܟ	Podolsk
ܦܐܦܐ	Papst
5	5
4	4
ܢܝܒܐ	Eckzahn
3	3
2	2
ܒܝܬ ܥܬܩܐ ܕܠܘܒܪ	Louvre
ܓܒܐ ܕܚܐܪܘܬܐ ܕܦܘܐܪܛܘ ܪܝܩܘ	Partido Independentista Puertorriqueño
6	6
ܕܝܬܝܩܝ ܥܬܝܩܬܐ	Altes Testament
ܥܐܕܐ ܕܒܝܬ ܝܠܕܐ	Weihnachten
ܠܫܢܐ ܪܘܡܐܢܣܝܐ	Romanische Sprachen
ܡܬܠܬܐ	Dreieck
ܫܢܬܐ ܟܒܝܫܬܐ	Schaltjahr
ܡܘܥܡܪ ܐܠܩܕܐܦܝ	Muammar al-Gaddafi
ب	Ba (Arabischer Buchstabe)
ܥܐܕܐ ܕܩܝܡܬܐ	Ostern
ܢܝܘ ܝܘܪܩ	New York
ܢܦܛܐ	Erdöl
ܣܐܘܢܐ	Schuh
ܒܝܬ ܥܘܪܦܢܐ	Bank
ܟܪܡܐ	Weinberg
ܐܝܪܠܢܕ (ܓܙܪܬܐ)	Irland (Insel)
1	1
ܠܘ ܫܘܢ	Lu Xun
10	10
20	20
9	9
7	7
8	8
7 (ܡܢܝܢܐ)	Sieben
8 (ܡܢܝܢܐ)	Acht
12	12
ܡܠܐܐ ܘܬܘܒܐ	Gezeiten
ܫܒܘܥܐ	Woche
ܓܠܝܕܐ	Eis
ܨܠܘܬܐ ܡܪܢܝܬܐ	Vaterunser
ܝܡܬܐ	See
ܝܡܐ ܣܘܡܩܐ	Rotes Meer
13	13
ܩܛܘܬܐ (ܝܥܝܬܐ)	Gurke
ܓܙܪܬܐ	Insel
ܚܘܪܐ	Weiß
ܐܘܟܡܐ	Schwarz
6 (ܡܢܝܢܐ)	Sechs
ܠܫܢܐ ܪܘܫܡܝܐ	Amtssprache
11	11
15	15
14	14
17	17
ܣܦܪ ܡܠܐ	Wörterbuch
18	18
19	19
16	16
21	21
ܦܠܣܛܝܢ	Palästina (Region)
10 (ܡܢܝܢܐ)	Zehn
ܡܣܘܪܩܐ (ܡܐܢܐ)	Kamm
ܠܝܠܐ ܕܘܢܤ	Lila Downs
ܝܡܐ ܕܡܠܚܐ	Totes Meer
ܫܘܚܠܦܐ ܕܫܢܬܐ	Jahreszeit
ܠܝܒܪܦܘܠ	Liverpool
ܩܘܦܬܐ (ܛܝܪܐ)	Eulen
ܫܥܬܐ	Stunde
ܢܐܘܝ ܕܘܪ ܟܪܘܠܣܟܝ	Nowy Dwór Królewski
ܐܪܙܦܬܐ	Hammer
ܝܘܢܫܘܦܝܢ	Jönköping
ܥܘܠܐ ܚܝܐ	Fötus
ܐܠܦܒܝܬ ܣܘܪܝܝܐ	Syrisches Alphabet
ܐܠܦܒܝܬ ܐܪܡܝܐ	Aramäische Schrift
ܙܡܪܐ	Gesang
ܫܓܠܐ	Hickelkasten
ܩܠܦܬܐ ܕܒܣܡܐ	Zimt
ܡܙܬܐ	Haar
ܠܫܢܐ ܐܪܡܝܐ	Aramäische Sprachen
ܨܦܪܐ (ܛܝܪܐ)	Sperlinge
ܐܦܣܩܘܦܐ	Bischof
ܨܝܢ (ܐܪܥܐ)	China
ܓܒܐ ܕܝܡܘܩܪܛܝܐ (ܐܘܚܕܢܐ ܡܚܝܕܐ)	Demokratische Partei (Vereinigte Staaten)
ܒܝܐܛܪܝܟܣ ܕܒܝܬ ܗܘܠܢܕܝܐ	Beatrix (Niederlande)
ܡܠܟܘܬܐ ܕܗܘܠܢܕܐ	Königreich der Niederlande
ܐܒܪܝܠ ܠܐܒܝܢ	Avril Lavigne
ܐܪܒܝܐ	Arabische Halbinsel
ܡܪܩܘܣ ܐܘܢܓܠܣܛܐ	Markus (Evangelist)
ܥܘܠܐ	Embryo
ܠܫܢܐ ܕܗܟܐ	Hakka (Sprache)
ܫܘܫܡܢܝܬܐ (ܝܥܝܬܐ)	Grüner Kardamom
ܠܫܢܐ ܕܓܐܢ	Gan (Sprache)
ܒܝܬ ܥܬܩܐ	Museum
ܐܠܦܒܝܬ ܥܒܪܝܐ	Hebräisches Alphabet
ܠܫܢܐ ܣܘܪܝܝܐ	Syrische Sprache
ܒܪܩܐ	Blitz
ܐܝܕܐ	Hand
ܫܡܥܘܢ ܟܐܦܐ	Simon Petrus
ܬܠ ܐܒܝܒ	Tel Aviv-Jaffa
ܒܐܠܦܐܪܐܝܣܘ	Valparaíso
ܛܘܪܝܐ	Turoyo
ܠܫܢܐ ܫܝܡܝܐ	Semitische Sprachen
ܚܘܣܢܝ ܡܘܒܐܪܟ	Husni Mubarak
ܘܐܟܐܩܐ	Oaxaca
ܚܐܘܬܐ	Butter
ܐܘܢܓܠܝܘܢ	Evangelium (Buch)
ܠܫܢܐ ܕܘܘ	Wu (Sprache)
ܪܘܛܪܕܐܡ	Rotterdam
ܩܪܛܐ	Kreta
ܐܘܪܚܐ	Fernstraße
ܩܘܪܨܐ ܚܠܝܨܐ	Compact Disc
ܦܪܬ	Euphrat
ܩܝܘܛܘ	Kyōto
ܥܣܪܐ ܦܘܩܕܢܐ	Zehn Gebote
ܒܪܩܩܐ ܦܪܣܝܐ	Persischer Golf
ܚܠܐ (ܕܚܝܚܐ)	Sand
ܘܪܕܐ	Rosen
ܓܙܪܬܐ ܝܒܫܢܝܬܐ	Halbinsel
ܐܘܪܝܬܐ	Tora
ܟܘܘܝܬ (ܡܕܝܢܬܐ)	Kuwait-Stadt
ܡܚܙܝܬܐ	Spiegel
ܥܡܐ ܥܪܒܝܐ	Araber
ܟܘܬܐ	Fenster
ܠܫܢܐ ܝܘܢܝܐ ܥܬܝܩܐ	Altgriechische Sprache
ܠܫܢܐ ܐܟܕܝܐ	Akkadische Sprache
ܕܩܠܬ	Tigris
ܐܬܪܘܬܐ ܕܐܬܪܘܬܐ ܡܚܝܕܐ ܕܐܡܪܝܩܐ	Bundesstaat der Vereinigten Staaten
ܡܥܡܘܕܝܬܐ	Taufe
ܩܘܢܓܘ	Congo
ܐܝܢܛܪܠܝܢܓܘܐ	Interlingua
ܐܘܪܟܐ	Länge (Physik)
ܚܠܡܐ	Traum
ܠܫܢܐ ܩܪܕܘܝܐ	Kurdische Sprachen
ܩܡܚܐ	Mehl
ܕܢ ܗܐܟ	Den Haag
ܠܫܢܐ ܦܘܢܝܩܝܐ	Phönizisch-punische Sprache
ܣܝܢܝ (ܓܙܪܬܐ ܝܒܫܢܝܬܐ)	Sinai-Halbinsel
ܟܪܘܙܘܬܐ ܕܝܘܚܢܢ	Evangelium nach Johannes
ܬܪܥܐ (ܒܒܐ)	Tür
ܪܝܗܐܢܐ	Rihanna
ܛܦܪܐ	Nagel (Anatomie)
ܐܦܐ	Gesicht
ܨܨܐ (ܨܢܥܬܐ)	Nagel
ܙܝܬܐ	Olivenbaum
ܬܠܝܬܝܘܬܐ	Dreifaltigkeit
ܓܠܠܐ	Welle
ܟܬܒܬܐ	Schreiben
ܪܘܚܐ ܕܩܘܕܫܐ	Heiliger Geist
100 (ܡܢܝܢܐ)	Hundert
ܒܘܪܟܐ	Kniegelenk
ܫܘܩܐ (ܬܐܓܪܘܬܐ)	Markt
ܠܫܢܐ ܥܪܒܝܐ ܝܗܘܕܝܐ	Judäo-Arabisch
ܒܠܛܝ	Bălți
1000000 (ܡܢܝܢܐ)	Million
ܛܐܒܐ	Nachrichten
ܐܫܬܐ (ܐܣܝܘܬܐ)	Fieber
ܩܫܬܐ ܓܪܒܝܝܬܐ ܕܐܪܥܐ	Nordhalbkugel
ܡܡܘܢܐ ܕܡܝܟܪܐ	Mikroökonomie
ܠܝܕܣ	Leeds
ܥܘܩܒܪܐ	Mäuse
ܦܘܪܬܩܠܐ	Orange (Farbe)
ܒܪܩܩܐ	Bucht
ܒܝܬ ܩܒܘܪܐ	Friedhof
ܐܣܝܐ (ܫܕܬܐ)	Arzt
ܡܩܕܘܢܝܐ	Mazedonien (Begriffsklärung)
ܦܢܛܝܩܘܣܛܝ	Pfingsten
ܫܓܕܬܐ	Mandelbaum
ܟܪܘܙܘܬܐ ܕܠܘܩܐ	Evangelium nach Lukas
ܩܘܢܣܦܣܝܘܢ (ܗܘܦܪܟܝܐ)	Provinz Concepción (Chile)
ܢܗܪܐ ܕܝܘܪܕܢܢ	Jordan
ܣܦܪ ܝܡܐ	Strand
ܐܢܛܐܠܝܐ (ܗܘܦܪܟܝܐ)	Antalya (Provinz)
ܦܪܟܣܝܣ ܕܫܠܝܚܐ	Apostelgeschichte des Lukas
ܥܪܘܒܬܐ ܕܚܫܐ	Karfreitag
ܚܒܘܫܝܐ	Gefängnis
ܐܕܢܐ (ܗܘܦܪܟܝܐ)	Adana (Provinz)
ܝܘܚܢܢ ܡܥܡܕܢܐ	Johannes der Täufer
ܨܠܝܒܐ	Kreuz (Symbol)
ܚܙܒܐܠܠܗ	Hisbollah
ܒܝܬ ܓܒܝܢܐ	Stirn
ܡܙܡܘܪܐ	Buch der Psalmen
ܐܬܘܪ	Assyrien
ܒܢܝܢܐ	Gebäude
ܚܠܒ (ܡܕܝܢܬܐ)	Aleppo
ܩܫܬܐ ܬܝܡܢܝܬܐ ܕܐܪܥܐ	Südhalbkugel
ܚܠܐ (ܚܡܪܐ)	Essig
ܒܝܬ ܕܝܢܐ	Gericht
ܚܝܦܐ	Haifa
ܫܛܪܐ ܬܐܒܝܠܝܐ ܕܓܝܢܝܣ	Guinness-Buch der Rekorde
ܟܘܕܢܝܐ	Maultier
ܒܪܩܩܐ ܕܥܕܢ	Golf von Aden
ܓܠܝܢܐ ܕܝܘܚܢܢ	Offenbarung des Johannes
ܐܫܬܐ (ܝܘܠܦܢ ܨܪܘܝܘܬܐ)	Gesäß
ܨܠܘܬܐ ܡܪܝܡܝܬܐ	Ave Maria
ܝܩܕܐ	Brennstoff
ܝܨܝܠܐ	Ellbogengelenk
ܟܗܢܐ	Priester
ܕܩܢܐ	Barthaar
ܢܒܝܐ	Prophetie
ܐܘܪܟܝܣܛܪܐ	Orchester
1000 (ܡܢܝܢܐ)	Tausend
ܣܘܦܝܐ ܪܘܛܐܪܘ	Sofija Rotaru
ܬܫܢܝܬܐ	Versicherung (Kollektiv)
ܛܘܟܣܐ	Organisation
ܣܦܪܓܠܐ	Quitte
ܐܢܕܪܐܘܣ ܫܠܝܚܐ	Andreas (Apostel)
ܬܪܥܣܪ ܫܠܝܚܐ	Apostel
ܢܩܒܬܐ	Weibliches Geschlecht
ܕܪܥܐ (ܗܕܡܐ)	Arm
ܡܬܝ ܡܟܣܐ	Matthäus (Evangelist)
ܬܐܘܡܐ ܫܠܝܚܐ	Thomas (Apostel)
ܦܝܠܝܦܘܣ ܫܠܝܚܐ	Philippus
ܒܘܪܨܐ (ܗܘܦܪܟܝܐ)	Bursa (Provinz)
ܐܝܘܐܢܢܝܣ ܦܘܡܐ ܕܕܗܒܐ	Johannes Chrysostomos
ܒܢܝܡܝܢ ܢܬܢܝܗܘ	Benjamin Netanjahu
ܐܪܬܒܝܢ (ܗܘܦܪܟܝܐ)	Artvin (Provinz)
ܓܒܝܢܐ	Augenbraue
ܫܘܪܬܐ	Bauchnabel
ܐܕܝܐܡܐܢ (ܗܘܦܪܟܝܐ)	Adıyaman (Provinz)
ܝܗܘܕܐ ܫܠܝܚܐ	Judas Thaddäus
ܒܪܬܘܠܡܝ ܫܠܝܚܐ	Bartholomäus (Apostel)
ܝܥܩܘܒ ܒܪ ܙܒܕܝ	Jakobus der Ältere
ܝܘܚܢܢ ܫܠܝܚܐ	Johannes (Apostel)
ܡܬܝܐ ܫܠܝܚܐ	Matthias (Apostel)
ܝܥܩܘܒ ܒܪ ܚܠܦܝ	Jakobus, Sohn des Alphäus
ܕܟܪܐ	Männliches Geschlecht
ܐܝܓܢܐܛܝܘܣ ܢܘܪܢܐ	Ignatius von Antiochien
ܪܕܝܘܗܕ	Radiohead
ܒܫܐܪ ܐܠܐܣܕ	Baschar al-Assad
ܪܚܝܐ	Mühle
ܨܘܡܐ	Fasten
ܕܝܪܐ	Kloster
ܠܡܐܢܐ	Hafen
ܡܠܚܐ (ܢܘܛܐ)	Seemann
ܐܦܝܘܢ (ܗܘܦܪܟܝܐ)	Afyonkarahisar (Provinz)
ܡܝܟܐܝܠ (ܡܠܐܟܐ)	Michael (Erzengel)
ܒܝܠܓܝܟ (ܗܘܦܪܟܝܐ)	Bilecik (Provinz)
ܒܝܬ ܥܬܩܐ ܕܐܣܪܐܝܠ	Israel-Museum
ܒܐܠܝܟܣܝܪ (ܗܘܦܪܟܝܐ)	Balıkesir (Provinz)
ܒܝܬ ܝܠܕܐ	Geburtstag
ܬܘܠܥܐ	Würmer
ܬܘܩܢ ܓܝܕܝܐ ܩܢܛܪܘܢܝܐ	Zentralnervensystem
ܛܘܪܐ ܕܓܠܝܕܐ	Eisberg
ܡܫܠܡܢܐ	Muslim
ܢܢܥܐ	Minzen
ܩܠܒܐ:Commonscat	Vorlage:Commonscat
ܒܨܪܐ (ܡܕܝܢܬܐ)	Basra
ܐܓܪܬܐ ܕܠܘܬ ܪܗܘܡܝܐ	Brief des Paulus an die Römer
ܬܡܪܐ ܕܥܝܢܐ	Augenlid
ܗܘܦܪܟܝܣ ܕܛܘܪܩܝܐ	Liste der Provinzen der Türkei
ܡܪܝ ܓܝܘܪܓܝܣ ܣܗܕܐ	Georg (Heiliger)
ܐܣܘܬܐ ܕܠܐ ܬܚܘܡܐ	Ärzte ohne Grenzen
ܐܪܙܐ (ܡܫܝܚܝܘܬܐ)	Sakrament
ܐܓܪܬܐ ܕܠܘܬ ܦܝܠܝܦܣܝܐ	Brief des Paulus an die Philipper
ܡܫܝܚܐ	Messias
ܚܫܡܝܬܐ ܐܚܪܝܬܐ	Abendmahl Jesu
ܩܢܘܢܐ ܕܗܝܡܢܘܬܐ	Apostolisches Glaubensbekenntnis
ܒܢܝ ܐܝܣܪܐܝܠ	Israeliten
ܡܓܘܫܐ ܬܠܬܐ	Heilige Drei Könige
ܝܘܚܢܢ ܕܪܡܣܘܩܝܐ	Johannes von Damaskus
ܒܒܐ (ܬܪܥܐ)	Tor (Architektur)
ܣܕܪܐ:ܡܠܟܐ	Kategorie:König
ܣܕܪܐ:ܪܘܟܒ ܫܘܠܛܢܘܬܐ	Kategorie:Staatsform
ܠܫܢܐ ܕܡܝܢ	Min (Sprache)
ܥܘܪܡܫܐ	Umweltverschmutzung
ܒܒܠ (ܗܘܦܪܟܝܐ)	Babil
ܫܘܡܪܐ	Ruß
ܐܫܩܠܘܢ	Aschkelon
ܕܘܢܒܐ	Schwanz
ܩܐܕܣܝܐ (ܗܘܦܪܟܝܐ)	Al-Qadisiyya (Gouvernement)
ܡܪܝܡ ܡܓܕܠܝܬܐ	Maria Magdalena
ܡܪܪܬܐ	Gallenblase
ܥܕܬܐ ܟܠܕܝܬܐ ܩܬܘܠܝܩܝܬܐ	Chaldäisch-katholische Kirche
ܥܕܬܐ ܡܪܘܢܝܬܐ	Syrisch-Maronitische Kirche
ܡܪܬܐ	Galle
ܩܘܪܒܢܐ	Eucharistie
ܐܕܡ	Adam
ܐܘܘܫܐ	Ohrenschmalz
ܕܡܥܬܐ	Träne
ܥܡܬܐ (ܒܝܬܝܘܬܐ)	Tante
ܥܡܐ (ܒܝܬܝܘܬܐ)	Onkel
ܝܘܗܐܢ ܐܠܙܪ	Georg Elser
ܒܝܢܓܘܠ (ܗܘܦܪܟܝܐ)	Bingöl (Provinz)
ܥܡܐ ܐܪܡܢܝܐ	Armenier
ܐܝܕܝܢ (ܗܘܦܪܟܝܐ)	Aydın (Provinz)
ܩܛܠܥܡܐ ܐܪܡܢܝܐ	Völkermord an den Armeniern
ܐܡܐܣܝܐ (ܗܘܦܪܟܝܐ)	Amasya (Provinz)
ܦܪܝܙܘܢ ܒܪܝܟ	Prison Break
ܐܓܪܝ (ܗܘܦܪܟܝܐ)	Ağrı (Provinz)
ܒܘܪܕܘܪ (ܗܘܦܪܟܝܐ)	Burdur (Provinz)
ܐܓܪܬܐ ܩܕܡܝܬܐ ܕܠܘܬ ܩܘܪܢܬܝܐ	1. Brief des Paulus an die Korinther
ܝܗܘܕܐ ܣܟܪܝܘܛܐ	Judas Ischariot
ܐܒܪܐ	Feder
ܡܚܪܐ	Ingenieur
ܚܪܛܘܡܢܐ	Kichererbse
ܐܬܪܘܬܐ ܕܫܐܡ	Levante
ܓܒܪܐܝܠ (ܡܠܐܟܐ)	Gabriel (Erzengel)
ܓܪܡܦܝܠܐ	Elfenbein
ܨܘܪ	Tyros
ܒܘܠܘ (ܗܘܦܪܟܝܐ)	Bolu (Provinz)
ܙܢܩܐ	Kinn
ܨܘܡܐ ܕܐܪܒܥܝܢ	Fastenzeit
ܐܓܪܐ ܕܒܢܝܢܐ	Dach
ܒܝܛܠܝܣ (ܗܘܦܪܟܝܐ)	Bitlis (Provinz)
ܓܠܝܠܐ	Galiläa
ܪܥܡܐ	Donner
ܡܘܨܠ	Mossul
ܟܪܬܐ	Daumen
ܥܡܐ ܛܘܪܩܝܐ	Türken
ܦܐܦܐ ܫܢܘܕܐ ܬܠܝܬܝܐ	Schenuda III.
ܒܝܬ ܓܘܣܐ	Bunker
ܒܝܥܬܐ	Hühnerei
ܒܣܕܝܐ	Kissen
ܙܓܐ (ܢܩܘܫܐ)	Glocke
ܫܒܬܐ (ܝܗܘܕܝܘܬܐ)	Sabbat
ܫܡܝܪܡ	Semiramis
ܫܝܓܪܐ	Zahnfleisch
ܝܗ	JHWH
ܡܫܝܚܝܐ	Christ
ܟܪܘܙܘܬܐ ܕܡܪܩܘܣ	Evangelium nach Markus
ܟܟܪܝܬܐ ܕܕܒܫܐ	Bienenwabe
ܐܓܪܬܐ ܕܠܘܬ ܩܘܪܢܬܝܐ ܕܬܪܬܝܢ	2. Brief des Paulus an die Korinther
ܫܥܘܬܐ (ܡܠܘܐܐ)	Wachs
ܛܥܡܐ	Gustatorische Wahrnehmung
ܓܢܬ ܫܒܪܐ	Kindergarten
ܝܡܬܐ ܕܓܠܝܠܐ	See Genezareth
ܕܝܘܬܐ	Tinte
ܡܪܝ ܝܘܣܦ	Josef von Nazaret
ܠܘܩܐ ܐܘܢܓܠܣܛܐ	Lukas (Evangelist)
ܐܓܪܬܐ ܕܠܘܬ ܥܒܪܝܐ	Brief an die Hebräer
ܐܓܪܬܐ ܕܠܘܬ ܓܠܛܝܐ	Brief des Paulus an die Galater
ܡܪܝ ܡܝܟܐܝܠ ܪܒܐ	Michael der Syrer
Ϝ	Digamma
Ϙ	Koppa
ܥܛܡܐ	Oberschenkel
ܬܢܢܐ	Rauch
ܡܘܚܘܢܐ	Kleinhirn
ܐܓܪܬܐ ܕܠܘܬ ܩܘܠܣܝܐ	Brief des Paulus an die Kolosser
ܐܓܪܬܐ ܕܝܥܩܘܒ	Brief des Jakobus
ܐܓܪܬܐ ܩܕܡܝܬܐ ܕܝܘܚܢܢ	1. Brief des Johannes
ܐܓܪܬܐ ܕܠܘܬ ܦܝܠܡܘܢ	Brief des Paulus an Philemon
ܐܓܪܬܐ ܕܠܘܬ ܬܣܠܘܢܝܩܝܐ ܕܬܪܬܝܢ	2. Brief des Paulus an die Thessalonicher
ܐܓܪܬܐ ܩܕܡܝܬܐ ܕܠܘܬ ܬܣܠܘܢܝܩܝܐ	1. Brief des Paulus an die Thessalonicher
ܐܓܪܬܐ ܩܕܡܝܬܐ ܕܦܛܪܘܣ	1. Brief des Petrus
ܐܓܪܬܐ ܕܬܪܬܝܢ ܕܦܛܪܘܣ	2. Brief des Petrus
ܐܓܪܬܐ ܩܕܡܝܬܐ ܕܠܘܬ ܛܝܡܬܐܘܣ	1. Brief des Paulus an Timotheus
Ϛ	Stigma (Buchstabe)
ܡܪܕܝܢ (ܗܘܦܪܟܝܐ)	Mardin (Provinz)
ܚܡܨ (ܡܕܝܢܬܐ)	Homs
Ͳ	Sampi
ܘܐܟܐܩܐ ܕܝ ܟܘܐܪܝܣ	Oaxaca de Juárez
ܐܓܪܬܐ ܕܬܪܬܝܢ ܕܝܘܚܢܢ	2. Brief des Johannes
ܐܓܪܬܐ ܕܬܠܬ ܕܝܘܚܢܢ	3. Brief des Johannes
ܐܓܪܬܐ ܕܝܗܘܕܐ	Brief des Judas
ܐܓܪܬܐ ܕܠܘܬ ܛܝܡܬܐܘܣ ܕܬܪܬܝܢ	2. Brief des Paulus an Timotheus
ܐܓܪܬܐ ܕܠܘܬ ܛܛܘܣ	Brief des Paulus an Titus
ܫܝܪܢܐܟ (ܡܕܝܢܬܐ)	Şırnak
ܐܟܪܐ	Landwirt
ܓܘܣܢܐ	Flüchtling
Ϻ	San (Buchstabe)
ܩܠܝܕܐ (ܡܐܢܐ)	Schlüssel
ܥܕܥܐܕܐ	Festival
ܐܪܒܝܠ (ܡܕܝܢܬܐ)	Erbil
ܚܨܐ	Rücken
ܐܠܝܐ ܢܒܝܐ	Elija
ܙܚܘܪܝܬܐ (ܬܘܠܥܬܐ)	Seidenspinner
ܡܚܛܐ	Nadel
ܥܠܡܐ ܥܪܒܝܐ	Arabische Welt
ܦܓܘܕܬܐ	Zaumzeug
ܩܛܡܐ	Asche
ܢܘܗܕܪܐ (ܡܕܝܢܬܐ)	Dohuk
ܨܒܥܐ ܕܪܓܠܐ	Zehe (Fuß)
ܢܓܪܘܬܐ	Zimmerer
ܠܘܚܐ (ܚܫܘܒܬܐ)	Tabletcomputer
ܪܒܝܬܐ	Wucher
ܡܟܝܪܘܬܐ	Verlöbnis
ܫܘܪܡܐ	Mastdarm
ܐܪܡܝܐ (ܢܒܝܐ)	Jeremia
ܬܐܡܐ	Zwillinge
ܬܠܝܦܐ	Wimper
ܫܥܬܐ ܕܐܪܥܐ	Earth Hour
ܦܪܡܝܬܐ	Knopf
ܟܘܟܒܐ ܕܕܘܝܕ	Davidstern
ܡܪܝ ܐܣܛܦܢܘܣ	Stephanus
ܡܫܡܫܢܐ	Diakon
ܢܓܒ	Negev
ܟܢܥܢ	Kanaan
ܢܘܨܦܐ	Dämmerung
ܒܝܢܐ	Tamarisken
ܬܓܪܝܬ	Tikrit
ܚܠܐ (ܥܦܪܐ)	Staub
ܬܪܥܐ ܕܕܡܐ	Blutung
ܥܪܒܐ ܕܫܡܫܐ	Sonnenuntergang
ܐܡܝܫܐ	Sumpf
ܡܨܥܝܬܐ (ܨܒܥܐ)	Mittelfinger
ز	Zay (Arabischer Buchstabe)
ܣܒܐ (ܒܝܬܝܘܬܐ)	Großeltern
ܩܘܪܨܠܐ	Sprunggelenk
ܒܪ ܐܝܕܐ	Handschuh
ܢܫܒܐ ܕܥܝܢܐ	Netzhaut
ܬܘܩܢ ܓܝܕܝܐ ܡܚܕܘܪܝܐ	Peripheres Nervensystem
ܛܝܢܐ	Schlamm
ܓܓܘܠܬܐ	Golgota
ܗܢܝܢܐ (ܡܡܫܚܘܬܐ)	Zins
ܐܫܘܪ ܒܢܐܦܠ	Aššur-bāni-apli
ܓܕܫܐ	Unfall
ܦܛܪܝܪܟܐ	Patriarch
ا	Alif
ܚܟܐ	Gaumen
ت	Ta (Arabischer Buchstabe)
ث	Tha (Arabischer Buchstabe)
ج	Dschim (Arabischer Buchstabe)
ح	Ḥa
خ	Cha (Arabischer Buchstabe)
د	Dal (Arabischer Buchstabe)
ذ	Dhal (Arabischer Buchstabe)
ر	Ra (Arabischer Buchstabe)
ܪܓܫܐ	Sinn (Wahrnehmung)
س	Sin (Arabischer Buchstabe)
ܟܪܟ ܣܠܘܟ (ܡܕܝܢܬܐ)	Kirkuk
ܒܒܬܐ	Pupille
ܩܒܪܐ	Grab
ܠܒܘܢܬܐ	Weihrauch
ܚܡܬ (ܡܕܝܢܬܐ)	Hama (Syrien)
ܝܫܛܐ	Speiseröhre
ܟܝܣܐ ܕܐܫܟܐ	Hodensack
ܕܒܪܐ	Ländlicher Raum
ܚܪܘܫܬܐ	Luftröhre
ܓܪܡܐ ܕܥܛܡܐ	Oberschenkelknochen
ܫܚܘܪܐ	Holzkohle
ܐܘܟܡܐ ܕܥܝܢܐ	Iris (Auge)
ܫܦܠܘܗܝ ܕܢܝܠܘܣ	Nildelta
ܐܘܪܡܝܐ	Urmia
Ϸ	Scho
ܓܙܪܬܐ ܐܝܘܠܝܬܐ	Liparische Inseln
ܓܒܐ ܕܒܥܬ	Baath-Partei
ܦܩܪܐ	Wirbel (Anatomie)
ܒܪ ܩܠܐ	Echo
ܟܝܡܪܐ	Chimäre (Mythologie)
ܠܘܓܡܐ	Oberkiefer
ܬܝܒܘܬܐ	Beichte
ܡܛܘܚܬܐ	Zeigefinger
ܩܒܠܘܬܐ	Hebamme
ܐܪܙܝܪܐ	Stare
ܣܦܪܐ (ܩܢܘܢܝܐ)	Jurist
Ͱ	Heta
ܥܡܐ ܐܪܡܝܐ	Aramäer (Volk)
ܟܢܘܢܬܐ (ܫܪܝܬܐ)	Handgelenk
ܐܒܐ (ܐܠܗܐ)	Gott der Vater
ܐܢܒܐܪ (ܗܘܦܪܟܝܐ)	Al-Anbar
ܡܪܕܝܢ (ܡܕܝܢܬܐ)	Mardin
ܣܪܛܢܐ	Cancer
ܡܘܪܘܢ	Firmung
ܚܠܡܬܐ	Brustwarze
ܢܘܠܐ ܕܓܘܓܝ	Spinnennetz
ܐܫܥܝܐ	Jesaja
ܒܝܬ ܟܬܒܐ ܐܬܪܝܐ ܕܐܣܪܐܝܠ	Israelische Nationalbibliothek
ܥܪܫܐ	Molar (Zahn)
ܢܝܢܘܐ (ܗܘܦܪܟܝܐ)	Ninawa
ܢܘܗܕܪܐ (ܗܘܦܪܟܝܐ)	Dahuk (Gouvernement)
ܘܐܣܛ (ܗܘܦܪܟܝܐ)	Al-Wasit (Gouvernement)
ܨܠܐܚ ܐܠܕܝܢ (ܗܘܦܪܟܝܐ)	Salah ad-Din (Gouvernement)
ܟܢܘܫܝܐ ܕܠܫܢܐ ܥܒܪܝܐ	Akademie für die hebräische Sprache
ܥܘܕ	Oud
ܒܓܕܐܕ (ܗܘܦܪܟܝܐ)	Bagdad (Gouvernement)
ܣܪܓܐ	Reitsattel
ܒܨܪܐ (ܨܒܥܐ)	Ringfinger
ܩܛܝܣܦܘܢ	Seleukia-Ktesiphon
ܟܒܘܫܐ	Albtraum
ܢܓܦ (ܗܘܦܪܟܝܐ)	Nadschaf (Gouvernement)
ܟܪܟ ܣܠܘܟ (ܗܘܦܪܟܝܐ)	Kirkuk (Gouvernement)
ܕܢܚܐ ܕܫܡܫܐ	Sonnenaufgang
ܬܐܪܬܐ	Gewissen
ܒܨܪܐ (ܗܘܦܪܟܝܐ)	Basra (Gouvernement)
ܡܫܚܐ ܕܟܪܝܗܐ	Krankensalbung
ܦܠܫܬ	Philister
ܐܠܥܐ (ܝܘܠܦܢ ܨܪܘܝܘܬܐ)	Rippe
ܥܕܬܐ ܐܝܓܘܦܛܝܬܐ	Koptische Kirche
ܐܢܛܝܘܟܝܐ	Antiochia am Orontes
ܐܦܪܝܡ ܣܘܪܝܝܐ	Ephräm der Syrer
ܐܝܙܝܕܝܐ	Jesiden
ܪܝܫܘܢ ܠܬܣܝܘܢ	Rischon LeZion
ܟܢܪܐ	Lyra (Zupfinstrument)
ܥܕܬܐ ܕܡܕܢܚܐ ܕܐܬܘܪܝܐ	Assyrische Kirche des Ostens
ܬܠܐ ܕܚܕ ܐܝܠܢ	One Tree Hill
ܡܘܪܐ	Myrrhe
ܦܕܪܠܝܐ	Föderalismus
ܐܠܝܫܥ	Elischa (Prophet)
ܗܟܐܪܝ (ܡܕܝܢܬܐ)	Hakkâri
ܣܢܚܪܝܒ	Sîn-aḫḫe-eriba
ܩܘܪܝܐܠܝܣܘܢ	Kyrie eleison
ܟܢܘܫܝܐ ܕܐܣܪܐܝܠ ܕܝܘܠܦܢܐ ܘܐܢܫܝܬܐ	Israelische Akademie der Wissenschaften
ܣܘܟܢܐ	Ruder
ܥܕܬܐ ܣܘܪܝܝܬܐ ܐܪܬܘܕܟܣܝܬܐ	Syrisch-Orthodoxe Kirche von Antiochien
ܟܣܬܐ	Futtermittel
ܩܡܫܠܝ	Qamischli
ܡܘܬܢܐ (ܗܘܦܪܟܝܐ)	Al-Muthanna (Gouvernement)
ܡܝܫܢ (ܗܘܦܪܟܝܐ)	Maisan (Gouvernement)
ܣܘܠܝܡܐܢܝܐ (ܗܘܦܪܟܝܐ)	As-Sulaimaniyya (Gouvernement)
ܐܪܒܝܠ (ܗܘܦܪܟܝܐ)	Erbil (Gouvernement)
ܚܠܒ (ܗܘܦܪܟܝܐ)	Gouvernement Aleppo
ܟܪܒܠܐܐ (ܗܘܦܪܟܝܐ)	Kerbela (Gouvernement)
ܦܪܨܘܦܐ	Person
ܕܝ ܩܐܪ (ܗܘܦܪܟܝܐ)	Dhi Qar (Gouvernement)
ܐܢܕܪܢܝܩ ܡܐܪܓܐܪܝܐܢ	Andranik Markarjan
ܡܡܠܠܘܬ ܐܠܗܘܬܐ	Christliche Theologie
ܓܘܙܐ	Walnussgewächse
ܕܝܐܠܐ (ܗܘܦܪܟܝܐ)	Diyala
ܟܒܒ	Khabab
ش	Schin (Arabischer Buchstabe)
ܩܪܫܬܐ	Decke (Bauteil)
ص	Sad (Arabischer Buchstabe)
ض	Dad (Arabischer Buchstabe)
ظ	Za (Arabischer Buchstabe)
ع	Ain (Arabischer Buchstabe)
غ	Ghain (Arabischer Buchstabe)
ف	Fa (Arabischer Buchstabe)
ق	Qaf
ܚܨܪܐ	Kleiner Finger
ܐܡܬܐ (ܝܘܠܦܢ ܨܪܘܝܘܬܐ)	Unterarm
ܣܝܢܝ	Sinai
ܬܐܘܡܐ	Thomas (Begriffsklärung)
ܐܝܒܪܝܐ	Iberia
ܚܡܬ (ܗܘܦܪܟܝܐ)	Gouvernement Hama
ܟܢܘܢܬܐ ܕܐܝܕܐ	Handwurzelknochen
ܐܝܣܪܐܝܠ (ܬܘܚܡܐ ܐܚܪܢܐ)	Israel (Begriffsklärung)
ܡܠܐܟܐ	Engel
ܫܢܬܐ ܦܫܝܛܬܐ	Gemeinjahr
ܡܣܘܪܩܐ ܕܐܝܕܐ	Mittelhandknochen
ܡܠܟܘܬܐ ܕܒܝܬ ܥܣܪ ܥܝܢܐ	Osrhoene
ܕܪܥܐ (ܡܕܝܢܬܐ)	Darʿā
ܨܕܥܐ	Schläfe
ܣܘܣܝܐ ܐܝܣܠܢܕܝܐ	Islandpferd
ܩܠܐ	Note (Musik)
ܛܘܘܝܐ	Grillen
ܓܪܡܐ	Knochen
ܒܪܝܐܢܝ	Biryani
ܠܒܠܒܬܐ	Uvula
ܙܓܐ ܕܣܦܝܢܬܐ	Schiffsglocke
ك	Kaf (Arabischer Buchstabe)
ل	Lam (Arabischer Buchstabe)
م	Mim (Arabischer Buchstabe)
ن	Nun (Arabischer Buchstabe)
ه	Ha (Arabischer Buchstabe)
و	Waw (Arabischer Buchstabe)
ي	Ya (Arabischer Buchstabe)
ܥܪܒܝܐ	Arab
ܓܝܕܐ ܕܓܢܫܝܐ	Ischiasnerv
ܚܣܟܗ (ܡܕܝܢܬܐ)	Al-Hasaka
ܒܝܬ ܢܗܪܝܢ ܥܠܝܬܐ	Al-Dschazira (Mesopotamien)
ܛܐܪܩ ܥܙܝܙ	Tariq Aziz
ܡܣܘܪܩܐ ܕܪܓܠܐ	Mittelfußknochen
ܥܪܩ	Arak (Spirituose)
ܫܠܦܐ	Klinge
ܛܘܪ ܠܒܢܢ	Libanon (Gebirge)
ܐܙܟ	İdil
ܐܘܛܪܝܟܛ	Utrecht (Begriffsklärung)
ܩܪܕܘܝܐ	Kurdisch
ܟܝܢܐ	Nature (Begriffsklärung)
ܡܪܝ ܐܕܝ ܬܪܝܢܐ	Addai II.
ܪܗܘܡܐ	Rum (Begriffsklärung)
ܓܐܝܘܣ	Gaius
ܩܝܒܩ	Quebec (Begriffsklärung)
ܩܕܠܐ	Nacken
ܥܡܐ ܐܬܘܪܝܐ/ܣܘܪܝܝܐ	Assyrer (Gegenwart)
ܛܘܪܐ ܕܣܝܢܝ	Sinai (Berg)
ܬܐܘܡܐ ܐܘܕܘ	Thomas Audo
ܦܘܪܬܥܢܐ	Flöhe
ܫܡܣܕܝܢ	Şemdinli
ܟܪܘܙܘܬܐ ܕܡܬܝ	Evangelium nach Matthäus
ܡܕܝܢܬܐ ܡܝܬܬܐ	Tote Städte
ܐܬܘܪܝܐ	Assyrisch
ܐܓܪܬܐ ܕܠܘܬ ܐܦܣܝܐ	Brief des Paulus an die Epheser
ܚܡܬ	Hama
ܒܢܦܫܐ	Violett
ܢܨܪܬ	Nazareth
ܥܕܬܐ ܥܬܝܩܬܐ ܕܡܕܢܚܐ	Alte Kirche des Ostens
ܟܬܒܐ ܕܡܘܪܡܘܢ	Buch Mormon
ܠܝܢܕܐ ܓܘܪܓ	Linda George
ܐܝܓܢܐܛܝܘܣ ܡܘܫܐ ܩܕܡܝܐ ܕܐܘܕ	Ignatius Moussa I. Daoud
ܒܫܐܪܐ ܦܛܪܘܣ ܐܠܪܐܥܝ	Béchara Pierre Raï
ܡܪܝ ܦܘܠܝܩܪܦܘܣ ܐܘܓܝܢ ܐܝܕܝܢ	Polycarpus Augin Aydın
ܥܡܢܘܐܝܠ ܬܠܝܬܝܐ ܕܠܝ	Emmanuel III. Delly
ܥܡܘ ܒܒܐ	Ammo Baba
ܥܡܘܕܐ ܦܩܪܝܐ	Wirbelsäule
ܒܝܬ ܫܥܝܐ	Stadion
ܓܘܕ ܫܪܠܘܛ	Good Charlotte
ܒܪ ܨܘܪܐ	Kragen (Kleidung)
ܚܣܚܘܣܐ	Knorpel
ܛܘܪ ܥܒܕܝܢ	Tur Abdin
ܡܪܝ ܩܘܪܝܩܘܣ ܣܗܕܐ ܘܕܝܘܠܝܛܐ ܝܡܗ	Quiricus und Julitta
ܐܝܣܛܢܒܘܠ (ܗܘܦܪܟܝܐ)	Istanbul (Provinz)
ܝܘܢܝܐ	Griechen
ܥܢܟܒܐ	Ankawa
ܓܗܢܐ	Gehinnom
ܝܥܩܘܒ ܒܘܪܕܥܢܐ	Jakob Baradai
ܐܓܢܛܝܘܣ ܝܘܣܦ ܬܠܝܬܝܐ ܝܘܢܢ	Ignatius Joseph III. Younan
ܡܪܝ ܕܢܚܐ ܪܒܝܥܝܐ	Dinkha IV.
ܬܠܫܝܬܐ ܕܩܛܠܐ ܕܐܕܘܠܦ ܗܝܛܠܪ	Liste der Attentate auf Adolf Hitler
ܬܐܓܘܪܬܐ	Handel
ܡܛܟܣܬܐ ܐܬܘܪܝܬܐ ܕܝܡܩܪܛܝܬܐ	Assyrische Demokratische Organisation
ܡܪܝ ܐܦܪܝܡ	Aprem Mooken
ܐܪܕܢ	Aradin
ܡܬܐ	Heimat
ܫܝܪܢܐܟ (ܗܘܦܪܟܝܐ)	Şırnak (Provinz)
ܥܘܩܣܐ	Giftstachel
ܟܗܢܘܬܐ	Weihesakrament
ܚܒܘܪ	Chabur
ܗܕܡܐ ܓܘܝܐ	Organ (Biologie)
ܚܡܬܐ (ܒܝܬܝܘܬܐ)	Schwiegermutter
ܡܥܠܘܠܐ	Maalula
ܐܘܪܘܦܐ	Europa (Begriffsklärung)
ܡܕܝܕ	Midyat
ܙܘܥܐ ܕܝܡܘܩܪܛܝܐ ܐܬܘܪܝܐ	Assyrische Demokratische Bewegung
ܐܣܝܪܝܣܩܐ	Assyriska Föreningen
ܥܕܬܐ ܣܘܪܝܝܬܐ ܩܬܘܠܝܩܝܬܐ	Syrisch-katholische Kirche
ܡܘܕܟܐ	Würzen
ܐܘܣܛܪܠܝܐ	Australia
ܡܦܩܬܐ ܦܫܝܛܬܐ	Peschitta
ܐܪܚܘܬܐ	Gastfreundschaft
ܫܪܓܐ ܕܢܦܛܐ	Öllampe
ܩܛܠܥܡܐ ܐܬܘܪܝܐ	Völkermord an den Assyrern und Aramäern
ܒܝܬ ܟܬܒܐ ܕܐܫܘܪ ܒܢܐܦܠ	Bibliothek des Aššurbanipal
ܣܪܦܝܘܢ	Serapion von Thmuis
ܒܕܘܩܐ	Pfadfinder
ܥܘܕܪܢܐ:ܚܒܝܫܬ̈ܐ	Hilfe:Übersicht
ܓܦܬܐ	Kletterpflanze
ܡܝܟܐܝܠ	Michael (Begriffsklärung)
ܙܒܐ	Kleiner Zab
ܐܝܓܢܐܛܝܘܣ ܙܟܝ ܩܕܡܝܐ ܥܝܘܐܨ	Ignatius Zakka I. Iwas
ܐܣܛܘܡܟܐ	Magen
ܓܢܬܐ	Garten
ܕܪܓܘܫܬܐ	Wiege
ܒܪܐ (ܐܠܗܐ)	Gott der Sohn
ܚܝܠܐ ܠܒܢܝܐ	Forces Libanaises
ܐܠܩܘܫ	Alqosh
ܢܩܘܫܐ	Semantron
ܘܝܩܝܦܕܝܐ:ܐܝܙܓܕܘܬܐ	Wikipedia:Botschaft
ܫܠܝܬܐ	Plazenta
ܕܘܢܝ ܓܘܪܓ ܝܘܚܢܢ	Donny George Youkhanna
ܒܝܬ ܛܘܣܐ	Flughafen
ܒܝܬ ܫܡܪܝܐ	Samarien
ܐܓܢܣ ܡܘ	Agnes Monica
ܡܪܝ ܝܘܣܦ ܚܢܢܝܫܘܥ	Yosip Khnanisho
ܪܘܦܐܝܠ ܩܕܡܝܐ ܒܝܬ ܕܘܝܕ	Raphael I. Bidawid
ܦܪܢܣܘ ܗܪܝܪܝ	Franso Hariri
ܣܕܪܐ:ܓܪܡܢ	Kategorie:Deutschland
ܣܕܪܐ:ܐܝܛܠܝܐ	Kategorie:Italien
ܣܕܪܐ:ܐܬܪܘܬܐ ܡܚܝܕܐ ܕܐܡܪܝܩܐ	Kategorie:Vereinigte Staaten
ܣܕܪܐ:ܪܘܣܝܐ	Kategorie:Russland
ܣܕܪܐ:ܩܢܕܐ	Kategorie:Kanada
ܣܕܪܐ:ܐܝܣܪܐܝܠ	Kategorie:Israel
ܣܕܪܐ:ܛܘܪܩܝܐ	Kategorie:Türkei
ܣܕܪܐ:ܡܨܪܝܢ	Kategorie:Ägypten
ܣܕܪܐ:ܐܝܪܐܢ	Kategorie:Iran
ܕܝܪܐ ܕܡܪܝ ܓܒܪܐܝܠ	Kloster Mor Gabriel
ܥܐܕܐ	Feiertag
ܣܕܪܐ:ܥܝܪܐܩ	Kategorie:Irak
ܣܕܪܐ:ܗܘܠܢܕܐ	Kategorie:Niederlande
ܣܕܪܐ:ܦܘܠܢܕ	Kategorie:Polen
ܣܕܪܐ:ܛܝܪܐ	Kategorie:Vögel
ܣܕܪܐ:ܝܥܝܬܐ	Kategorie:Pflanzen
ܣܕܪܐ:ܬܘܕܝܬܐ	Kategorie:Religion
ܣܕܪܐ:ܝܕܥܬܐ	Kategorie:Wissenschaft
ܩܘܠ ܬܘܪܗ	Kol Torah
ܦܪܡܬܐ ܕܣܡܠܐ	Massaker von Semile
ܓܪܫܘܢܝ	Garschuni
ܕܝܢܐ (ܡܬܐ)	Soran
ܨܘܒܐ	Nusaybin
ܕܪܥܐ (ܗܘܦܪܟܝܐ)	Gouvernement Darʿā
ܢܥܘܡ ܦܐܝܩ	Naum Faiq
ܣܕܪܐ ܕܦܛܪܝܪܟܐ ܕܥܕܬܐ ܕܡܕܢܚܐ	Liste der Patriarchen der Assyrischen Kirche des Ostens
ܕܝܪܐ ܕܟܘܪܟܡܐ	Kloster Zafaran
ܚܝܠܐ	Kraft (Sport)
ܡܪܝ ܢܪܣܝ ܕܒܙ	Mar Narsai De Baz
ܡܪܝܡ (ܚܬܗ ܕܡܘܫܐ)	Mirjam (Prophetin)
ܨܡܘܪܬܐ	Fangzahn
ܡܪܝ ܬܐܘܡܐ ܕܪܡܘ	Thomas Darmo
ܣܕܪܐ:ܬܘܚܡܐ ܐܚܪܢܐ	Kategorie:Begriffsklärung
ܣܕܪܐ:ܡܫܝܚܝܘܬܐ	Kategorie:Christentum
ܣܕܪܐ:ܐܣܠܐܡ	Kategorie:Islam
ܣܕܪܐ:ܝܗܘܕܝܘܬܐ	Kategorie:Judentum
ܦܩܥܬܐ ܕܢܝܢܘܐ	Ninive-Ebene
ܠܩܐ ܕܣܦܝܢܬܐ	Riemen (Schifffahrt)
ܝܘܚܢܢ ܕܘܠܒܢܝ	Philoxenos Yuhanon Dolabani
ܫܡܥܘܢ ܒܪܨܒܥܐ	Simon bar Sabbae
ܫܩܠܒܕ	Schaqlawa
ܐܢܩܪܐ (ܗܘܦܪܟܝܐ)	Ankara (Provinz)
ܐܢܕܪܐܘܣ	Andre
ܐܝܪܠܢܕ	Irland (Begriffsklärung)
ܬܠ ܟܐܦܐ	Tel Keppe
ܐܨܪܐ	Würzmittel
ܕܝܪܝܟ	Al-Malikiya
ܐܓܐ ܦܛܪܘܣ	Agha Petros
ܫܘܫܡܬܐ	Sesam
ܣܕܪܐ:ܘܝܩܝܦܕܝܐ	Kategorie:Kategorie:
ܣܕܪܐ:ܝܒܫܬܐ	Kategorie:Kontinent
ܒܓܕܝܕܐ	Bakhdida
ܝܙܦܬܐ	Schulden
ܟܠܕܝܐ	Chaldo-Assyrer
ܦܨܝܕܐ	Teich
ܐܪܓܘܢܐ	Purpur (Farbe)
ܢܘܪܢܝܐ	Pyramide (Geometrie)
ܘܝܩܝܦܕܝܐ:HotCat	Wikipedia:Helferlein/HotCat
ܗܝܟܠܐ ܕܫܠܝܡܘܢ	Jerusalemer Tempel
ܠܘܝܣ ܪܘܦܐܝܠ ܩܕܡܝܐ ܣܟܘ	Louis Raphaël I. Sako
ܩܠܒܐ:ܓܕܫܐ ܗܫܝܐ	Wikipedia:Hauptseite/Aktuelles
ܘܝܩܝܦܕܝܐ:ܡܕܒܪܢܐ	Wikipedia:Administratoren
ܣܕܪܐ:ܫܕܬܐ	Kategorie:Beruf
ܘܝܩܝܦܕܝܐ:ܒܘܬ̈ܐ	Wikipedia:Bots
ܣܕܪܐ:ܙܒܢܐ	Kategorie:Zeit
ܣܕܪܐ:ܝܘܠܦܢ ܨܪܘܝܘܬܐ	Kategorie:Anatomie
ܣܕܪܐ:ܐܣܝܘܬܐ	Kategorie:Medizin
ܫܡܥܘܢ (ܫܡܐ)	Simon (Vorname)
ܓܒܪܐܝܠ ܐܣܥܕ	Gabriel Asaad
ܡܨܪܝܢ	Ägypten
ܩܠܒܐ:Bot	Vorlage:Bot
ܩܢܕܐ	Kanada
ܣܕܪܐ:ܝܘܢ	Kategorie:Griechenland
ܣܕܪܐ:ܣܘܝܕ	Kategorie:Schweden
ܐܡܪܐ	Lamm
ܩܠܒܐ:ܐܫܛܪܘܬܐ	Vorlage:Dokumentation
ܣܕܪܐ:User languages	Kategorie:Benutzer:nach Sprache
ܐܫܘܪ ܝܘܣܦ	Ashour Yousef
ܦܘܠܚܢܐ	Unternehmen
ܩܠܒܐ:Softredirect	Vorlage:Interwiki redirect
ܩܠܒܐ:Delete	Vorlage:Löschen
ܡܓܕܠܐ (ܩܪܝܬܐ)	Migdal
ܣܕܪܐ:ܛܟܢܘܠܘܓܝܐ	Kategorie:Technologie
ܓܒܪܐܝܠ (ܫܡܐ)	Gabriel (Name)
ܡܝܟܐܝܠ (ܫܡܐ)	Michael
ܣܕܪܐ:ܠܫܢܐ	Kategorie:Einzelsprache als Thema
ܣܕܪܐ:ܩܢܘܢܐ ܕܠܥܙܐ	Kategorie:Grammatik
ܘܝܩܝܦܕܝܐ:General disclaimer	Wikipedia:Impressum
ܘܝܩܝܦܕܝܐ:ܕܘܒܪܐ	Wikipedia:Formatierung
ܩܠܒܐ:Navbox	Vorlage:Erweiterte Navigationsleiste
ܐܝܓܢܐܛܝܘܣ ܐܦܪܝܡ ܬܪܝܢܐ	Ignatius Ephrem II. Karim
ܩܠܒܐ:Clear	Vorlage:Absatz
ܘܝܩܝܦܕܝܐ:ܡܟܬܒܘܬܐ ܕܡܓܠܐ ܠܟܠ ܘܝܩܝܦܕܝܐ	Wikipedia:Artikel, die es in allen Wikipedias geben sollte
ܣܕܪܐ:ܐܠܝܩܛܪܘܢܝܘܬܐ	Kategorie:Elektronik
ܣܕܪܐ:ܝܪܚܐ ܕܫܢܬܐ	Kategorie:Monat
ܩܠܒܐ:Babel	Vorlage:Babel
ܩܠܒܐ:Commons	Vorlage:Commons
ܩܠܒܐ:User ar-1	Vorlage:User ar-1
ܩܠܒܐ:User az	Vorlage:User az
ܩܠܒܐ:See also	Vorlage:Siehe auch
ܩܠܒܐ:User de	Vorlage:User de
ܩܠܒܐ:User es	Vorlage:User es
ܩܠܒܐ:User en-3	Vorlage:User en-3
ܩܠܒܐ:User en-1	Vorlage:User en-1
ܩܠܒܐ:User en-2	Vorlage:User en-2
ܩܠܒܐ:User en-4	Vorlage:User en-4
ܩܠܒܐ:User en-0	Vorlage:User en-0
ܩܠܒܐ:User en	Vorlage:User en
ܩܠܒܐ:User fa	Vorlage:User fa
ܩܠܒܐ:User fr-1	Vorlage:User fr-1
ܩܠܒܐ:User he-2	Vorlage:User he-2
ܩܠܒܐ:User he-1	Vorlage:User he-1
ܩܠܒܐ:User sk	Vorlage:User sk
ܩܠܒܐ:User tr	Vorlage:User tr
ܩܠܒܐ:User ja	Vorlage:User ja
ܩܠܒܐ:User fr	Vorlage:User fr
ܩܠܒܐ:User he	Vorlage:User he
ܣܕܪܐ:ܐܣܝܐ	Kategorie:Asien
ܣܕܪܐ:ܕܪܐ ܕܥܣܪܝܢ ܘܚܕ	Kategorie:21. Jahrhundert
ܩܠܒܐ:Mod	Vorlage:Modulo
ܩܠܒܐ:User sv	Vorlage:User sv
ܩܠܒܐ:User it	Vorlage:User it
ܣܕܪܐ:ܝܘܡܐ ܕܫܒܘܥܐ	Kategorie:Wochentag
ܣܕܪܐ:ܐܨܪܐ	Kategorie:Würzmittel
ܩܠܒܐ:Edit	Vorlage:Bearbeiten
ܩܠܒܐ:Sidebar	Vorlage:Seitenleiste
ܩܠܒܐ:ܐܬܪܐ	Vorlage:Infobox Staat
ܩܠܒܐ:/box-header	Portal:Box-header
ܣܕܪܐ:User en	Kategorie:User en
ܣܕܪܐ:User zh	Kategorie:User zh
ܩܠܒܐ:ܐܠܦܒܝܬ ܥܪܒܝܐ	Vorlage:Navigationsleiste Arabisches Alphabet
ܣܕܪܐ:User zh-N	Kategorie:User zh-M
ܩܠܒܐ:ܨܢܕܘܩ ܪܡܙܐ2	Vorlage:Infobox
ܩܠܒܐ:User zh	Vorlage:User zh
ܣܕܪܐ:ܦܐܦܐ	Kategorie:Papst
ܩܠܒܐ:User nl-1	Vorlage:User nl-1
ܩܠܒܐ:User nl-2	Vorlage:User nl-2
ܣܕܪܐ:ܪܝܫܝ ܩܘܛܢܝܘܬܐ	Kategorie:Staatspräsident
ܩܠܒܐ:User ru	Vorlage:User ru
ܩܠܒܐ:IPA	Vorlage:IPA-Text
ܣܕܪܐ:ܗܪܘܡܐ	Kategorie:Gewürz
ܣܕܪܐ:ܦܠܫܬ	Kategorie:Palästina
ܣܕܪܐ:ܡܠܐܟܐ	Kategorie:Angelologie
ܣܕܪܐ:ܢܒܝܐ	Kategorie:Prophet
ܩܠܒܐ:Sortname	Vorlage:SortKeyName
ܩܠܒܐ:GUA	Vorlage:GTM
ܩܠܒܐ:User nl	Vorlage:User nl
ܩܠܒܐ:ܡܣܦܩ ܩܐܫ	Vorlage:Purge
ܩܠܒܐ:ܡܦܠܚܢܐ	Vorlage:Benutzer
ܣܕܪܐ:ܬܘܢܣ	Kategorie:Tunesien
ܩܠܒܐ:Oppose	Vorlage:Kontra
ܩܠܒܐ:COL	Vorlage:COL
ܩܠܒܐ:PER	Vorlage:PER
ܩܠܒܐ:ܨܢܕܘܩ ܡܕܥܐ ܕܝܒܫܬܐ	Vorlage:Infobox Kontinent
ܩܠܒܐ:User ar-2	Vorlage:User ar-2
ܩܠܒܐ:User ar-3	Vorlage:User ar-3
ܩܠܒܐ:User ar	Vorlage:User ar
ܩܠܒܐ:ܝܘܡܐ ܕܫܒܘܥܐ	Vorlage:Navigationsleiste Wochentage
ܣܕܪܐ:ܡܕܝܢܬܐ ܒܐܘܚܕܢܐ ܡܚܝܕܐ	Kategorie:Ort in den Vereinigten Staaten
ܩܠܒܐ:ܬ.ܐ.	Vorlage:Begriffsklärung
ܩܠܒܐ:No	Vorlage:Nein-Feld
ܣܕܪܐ:ܩܠܒܐ ܨܢܕܘܩܐ	Kategorie:Vorlage:Infobox
ܩܠܒܐ:Partial	Vorlage:Teilweise-Feld
ܩܠܒܐ:ܩܘܕܝܟܘܣ ܕܣܕܪܐ	Vorlage:TOC Kategorie
ܩܠܒܐ:?	Vorlage:?
ܣܕܪܐ:User yue	Kategorie:User zh-yue
ܣܕܪܐ:User az	Kategorie:User az
ܣܕܪܐ:User sk	Kategorie:User sk
ܣܕܪܐ:User fr	Kategorie:User fr
ܣܕܪܐ:User ja	Kategorie:User ja
ܣܕܪܐ:User la	Kategorie:User la
ܣܕܪܐ:User pt	Kategorie:User pt
ܣܕܪܐ:User ro	Kategorie:User ro
ܣܕܪܐ:User sv	Kategorie:User sv
ܣܕܪܐ:User ko-N	Kategorie:User ko-M
ܩܠܒܐ:User yue	Vorlage:User zh-yue
ܣܕܪܐ:ܗܘܦܪܟܝܣ ܕܥܝܪܐܩ	Kategorie:Irakisches Gouvernement
ܣܕܪܐ:User ar	Kategorie:User ar
ܣܕܪܐ:User da	Kategorie:User da
ܣܕܪܐ:User sk-N	Kategorie:User sk-M
ܣܕܪܐ:User de	Kategorie:User de
ܣܕܪܐ:User el	Kategorie:User el
ܣܕܪܐ:User en-N	Kategorie:User en-M
ܣܕܪܐ:User es	Kategorie:User es
ܣܕܪܐ:User fa	Kategorie:User fa
ܣܕܪܐ:User fi	Kategorie:User fi
ܣܕܪܐ:User he	Kategorie:User he
ܩܠܒܐ:N/a	Vorlage:N/A-Feld
ܣܕܪܐ:User hy	Kategorie:User hy
ܣܕܪܐ:ܠܫܢܐ ܥܒܪܝܐ	Kategorie:Hebräisch
ܣܕܪܐ:ܡܕܝܢܬܐ ܒܐܝܣܪܐܝܠ	Kategorie:Ort in Israel
ܣܕܪܐ:User it	Kategorie:User it
ܣܕܪܐ:User ko	Kategorie:User ko
ܣܕܪܐ:ܒܬܫܪܝܢ ܐܚܪܝ	Kategorie:November
ܣܕܪܐ:ܝܡܡܐ	Kategorie:Meer
ܩܠܒܐ:ܐܠܦܒܝܬ ܝܘܢܝܐ	Vorlage:Infobox Griechischer Buchstabe
ܣܕܪܐ:ܦܛܪܝܪܟܘ ܕܥܕܬܐ ܣܘܪܝܝܬܐ ܩܬܘܠܝܩܝܬܐ	Kategorie:Syrisch-katholischer Patriarch
ܩܠܒܐ:ܡܢܝܢܐ ܕܡܡܪܐ ܦܪܝܫܐ	Vorlage:EA-Anzahl
ܣܕܪܐ:ܒܝܬܝܘܬܐ	Kategorie:Verwandtschaft
ܬܪܥܐ:ܬܘܕܝܬܐ	Portal:Religion
ܣܕܪܐ:User ru	Kategorie:User ru
ܣܕܪܐ:User ru-3	Kategorie:User ru-3
ܣܕܪܐ:User tl	Kategorie:User tl
ܣܕܪܐ:User tr	Kategorie:User tr
ܣܕܪܐ:ܙܡܪܐ	Kategorie:Musiker
ܩܠܒܐ:Lang	Vorlage:Lang
ܣܕܪܐ:ܪܫܘܡܐ	Kategorie:Maler
ܩܠܒܐ:ܫܠܝܚܐ ܕܡܫܝܚܐ	Vorlage:Navigationsleiste Jünger Jesu und Apostel
ܩܠܒܐ:ܚܡܫܐ ܐܘܩܝܢܘ	Vorlage:Navigationsleiste Ozeane
ܩܠܒܐ:CHI	Vorlage:CHL
ܣܕܪܐ:ܡܕܝܢܬܐ ܒܐܢܓܠܢܕ	Kategorie:Ort in England
ܣܕܪܐ:ܢܝܓܪ	Kategorie:Niger
ܣܕܪܐ:ܝܘܠܦܢ ܩܢܘܢܝܐ	Kategorie:Rechtswissenschaft
ܣܕܪܐ:ܣܥܪܐ	Kategorie:Frisur
ܩܠܒܐ:User ar-4	Vorlage:User ar-4
ܣܕܪܐ:ܢܗܪܘܬܐ	Kategorie:Fluss
ܩܠܒܐ:User he-3	Vorlage:User he-3
ܩܠܒܐ:User he-4	Vorlage:User he-4
ܩܠܒܐ:User ko	Vorlage:User ko
ܩܠܒܐ:User pt	Vorlage:User pt
ܣܕܪܐ:User nl	Kategorie:User nl
ܣܕܪܐ:User no	Kategorie:User no
ܣܕܪܐ:ܣܘܪܝܐ	Kategorie:Syrien
ܣܕܪܐ:ܕܪܐ ܩܕܡܝܐ	Kategorie:1. Jahrhundert
ܣܕܪܐ:ܓܙܪܬܐ ܝܒܫܢܝܬܐ	Kategorie:Halbinsel
ܣܕܪܐ:ܗܘܦܪܟܝܣ ܕܗܘܠܢܕܐ	Kategorie:Niederländische Provinz
ܣܕܪܐ:ܡܢܝܢܐ	Kategorie:Ganze Zahl
ܣܕܪܐ:ܡܕܝܢܬܐ ܕܥܝܪܐܩ	Kategorie:Ort im Irak
ܣܕܪܐ:ܥܝܢܐ (ܨܪܘܝܘܬܐ)	Kategorie:Auge
ܣܕܪܐ:ܓܘܪܓܝܐ	Kategorie:Georgien
ܣܕܪܐ:ܟܘܘܝܬ	Kategorie:Kuwait
ܣܕܪܐ:ܠܒܢܢ	Kategorie:Libanon
ܣܕܪܐ:ܪܝܫܝ ܩܘܛܢܝܘܬܐ ܕܐܬܪܘܬܐ ܡܚܝܕܐ ܕܐܡܪܝܩܐ	Kategorie:Präsident der Vereinigten Staaten
ܣܕܪܐ:ܝܘܪܕܢܢ	Kategorie:Jordanien
ܣܕܪܐ:ܦܐܪܐ	Kategorie:Obst
ܣܕܪܐ:ܝܘܠܦܢ ܟܘܪܗܢܐ	Kategorie:Pathologie
ܣܕܪܐ:ܓܒܐ	Kategorie:Politische Partei
ܣܕܪܐ:ܕܝܬܝܩܝ ܚܕܬܐ	Kategorie:Neues Testament
ܣܕܪܐ:ܕܝܬܝܩܝ ܥܬܝܩܬܐ	Kategorie:Altes Testament
ܣܕܪܐ:ܐܘܩܝܢܘ	Kategorie:Ozean
ܣܕܪܐ:ܓܪܡܐ	Kategorie:Knochen
ܣܕܪܐ:ܗܘܦܪܟܝܣ ܘܐܘܚܕܢܐ ܕܩܢܕܐ	Kategorie:Kanada nach Provinz oder Territorium
ܣܕܪܐ:ܚܝܘܬܐ	Kategorie:Vielzellige Tiere
ܣܕܪܐ:ܛܘܪܐ	Kategorie:Gebirge
ܣܕܪܐ:ܣܘܥܪܢܐ	Kategorie:Veranstaltung
ܣܕܪܐ:ܟܘܪܗܢܐ	Kategorie:Krankheit
ܣܕܪܐ:User pl	Kategorie:User pl
ܣܕܪܐ:ܩܣܪ	Kategorie:Kaiser
ܣܕܪܐ:ܡܕܒܪܐ	Kategorie:Wüste
ܣܕܪܐ:ܝܡܡܬܐ	Kategorie:See
ܩܠܒܐ:ܨܢܕܘܩ ܡܚܡܝܬܐ ܡܨܥܝܐ	Vorlage:Infobox Speichermedium
ܩܠܒܐ:ܨܢܕܘܩ ܪܡܙܐ ܕܠܫܢܐ	Vorlage:Infobox Sprache
ܣܕܪܐ:ܩܛܠܥܡܐ	Kategorie:Massaker
ܣܕܪܐ:ܡܠܟܘܬܐ ܕܗܘܠܢܕܐ	Kategorie:Königreich der Niederlande
ܨܝܢ	China (Begriffsklärung)
ܛܪܘܝܐܢܝ	Trojany (Woiwodschaft Masowien)
ܫܪܓܐ	Lamp
ܫܩܐ	Unterschenkel
ܣܕܪܐ:ܦܛܪܝܪܟܘ ܕܥܕܬܐ ܟܠܕܝܬܐ ܩܬܘܠܝܩܝܬܐ	Kategorie:Chaldäisch-katholischer Patriarch
ܣܕܪܐ:ܦܛܪܝܪܟܘ	Kategorie:Patriarch
ط	Ṭa (Arabischer Buchstabe)
ܣܕܪܐ:ܒܝܬ ܟܬܒܐ	Kategorie:Bibliothek
ܣܕܪܐ:ܫܢܬܐ ܥܕܬܢܝܬܐ	Kategorie:Kirchenjahr
ܣܕܪܐ:ܐܪܙܐ	Kategorie:Sakrament
ܣܕܪܐ:ܒܝܬ ܢܗܪܝܢ	Kategorie:Mesopotamien
ܣܕܪܐ:ܕܝܪ̈ܬܐ ܣܘܪ̈ܝܝܬܐ	Kategorie:Syrisch-orthodoxes Kloster
ܣܕܪܐ:ܦܣܩܐ ܕܝܘܡܐ	Kategorie:Tageszeit
ܩܠܒܐ:ܣܘܪܓܕܐ ܚܘܫܒܢܐ	Vorlage:Linkbox Andere Kalender
ܣܕܪܐ:ܩܕܝܫܐ	Kategorie:Heiliger
ܩܪܕܐ (ܪܚܫܐ)	Zecken
ܩܠܒܐ:User nl-4	Vorlage:User nl-4
ܩܠܒܐ:User nl-3	Vorlage:User nl-3
ܬܪܥܐ:ܐܘܩܝܢܘܣܝܐ	Portal:Ozeanien
ܐܪܡܝܐ	Aramäer
ܟܘܕܐ	Wochenfluss
ܕܝܠܢܝܐ:ܫܘܚܠܦ̈ܐ ܚܕ̈ܬܐ	Spezial:Letzte Änderungen
