非洲	Afrika
日本	Japan
南美洲	Südamerika
Nò-vî	Norwegen
Sû-kak-làn	Schottland
Vî-ngì-sṳ̂	Wales
Pet Oi-ngì-làn	Nordirland
Hiûng-ngà-li	Ungarn
Sî-pân-ngà	Spanien
Mî-koet	Vereinigte Staaten
Pí-li-sṳ̀	Belgien
Lù-sêm-pó	Luxemburg
Yî-chhiu	Universum
Thi-khiù	Erde
Sâng-miang	Leben
Ngìn-lui	Mensch
George Washington	George Washington
Fûn-làn	Finnland
Shuì-tién	Schweden
Tan-ma̍k	Dänemark
Pô-làn	Polen
Li̍p-thâu-vón	Litauen
Yi-thai-li	Italien
Shuì-sṳ	Schweiz
O-thi-li	Österreich
Hî-lia̍p	Griechenland
Thú-ngí-khì	Türkei
Phù-thò-ngà	Portugal
歐洲	Europa
亞洲	Asien
北美洲	Nordamerika
南極洲	Antarktika
Vì-kî Pak-khô	Wikipedia
Hò-làn	Niederlande
Néu-yok-sṳ	New York City
Fà-sṳ̀n-tun Kô-lùn-pí-â Thi̍t-khî	Washington, D.C.
Khiu-kîm-sân	San Francisco
Pak-lìm	Berlin
Lo̍k-chhám-kî	Los Angeles
Thien-nó	Computer
Mióng-chi-mióng-lu	Internet
Barack Obama	Barack Obama
Vû-lâ-kûi	Uruguay
Lùn-tûn	London
Pâ-lì-sṳ	Paris
Â-pak-lâ-hón Lìm-khén	Abraham Lincoln
Google	Google Inc.
Me̍t-sî-kô	Mexiko
Thai-sî-yòng	Atlantischer Ozean
Thai-phìn-yòng	Pazifischer Ozean
Kâ-li-fuk-nì-â	Kalifornien
Pô-sṳ-tun	Boston
Fó-sên	Mars (Planet)
Âi-set-ngò-pí-â	Äthiopien
Sṳ̂-é	Löwe
Fap-koet	Frankreich
Sṳ-kie-ngî	Esperanto
Kiéu-è	Haushund
Yîn-koet	Vereinigtes Königreich
Meu-é	Hauskatze
中華人民共和國	Volksrepublik China
Fap-ngî	Französische Sprache
Ǹg-è	Fische
Pâ-sî	Brasilien
François Hollande	François Hollande
Ngò-lò-sṳ̂	Russland
Kîn-ǹg	Wale
Chang-fông-hìn	Quadrat
Tô-lùn-tô	Toronto
Â-lâ-pâ-mâ	Alabama
Québec-sén	Québec
Boeing 747	Boeing 747
Jimmy Wales	Jimmy Wales
Tet-koet	Deutschland
Pha̍k-ngò-lò-sṳ̂	Weißrussland
Tet-ngî	Deutsche Sprache
Pên-tó	Island
Song-ti	Gott
Oi-sâ-nì-â	Estland
David Cameron	David Cameron
Thú-sên	Saturn (Planet)
Ku-thin-yi̍t Fî-kî	Flugzeug
1	Eins
2	Zwei
3	Drei
4	Vier
5	Fünf
George W. Bush	George W. Bush
Lâ-thot-vì-â	Lettland
Vû-khiet-làn	Ukraine
Tshia̍p-khiet	Tschechien
Sṳ̂-lo̍k-vì-nì-â	Slowenien
Lò-mâ-nì-â	Rumänien
Pó-kâ-li-â	Bulgarien
Lò-mâ	Rom
Mâ-khì-tun	Mazedonien
Â-ngì-pâ-nì-â	Albanien
Khiet-lò-âi-sî-â	Kroatien
Pô-sṳ-nì-â lâu Het-set-kô-vì-ná	Bosnien und Herzegowina
Â-set-pai-kiông	Aserbaidschan
Set-phû-lu-sṳ̂	Republik Zypern
Kak-lû-kit-â	Georgien
Hâ-sat-khiet-sṳ̂-thán	Kasachstan
Mí-li-thai	Malta
Mô-na̍p-kô	Monaco
Mùng-thi̍t-nui-kô-lò	Montenegro
Sṳn Mâ-li-nok	San Marino
Kú-pâ	Kuba
Eiffel Thiet-thap	Eiffelturm
Yin-thu-nì-sî-â	Indonesien
Wolfgang Amadeus Mozart	Wolfgang Amadeus Mozart
Pi-tô-fûn	Ludwig van Beethoven
Thú-ngí-khì-ngî	Türkische Sprache
Nàm-fî	Südafrika
Vû-tsṳ̂-phe̍t-khiet-sṳ̂-thán	Usbekistan
Pô-tsṳ-nàm	Posen
Fà-sâ	Warschau
Súi	Wasser
Thien-sṳ	Fernsehen
Chṳ-li	Chile
Yâ-sû	Jesus Christus
Súi-sên	Merkur (Planet)
Li̍t-sṳ́	Geschichte
Phìn-kó Kûng-sṳ̂	Apple
Kîm-sên	Venus (Planet)
Ngî-ngièn	Sprache
Muk-sên	Jupiter (Planet)
Thiên-vòng-sên	Uranus (Planet)
Hói-vòng-sên	Neptun (Planet)
Thiên-vùn-ho̍k	Astronomie
Sîn-kâ-po	Singapur
Khô-ho̍k	Wissenschaft
Montréal	Montreal
Lie̍t-kî-tûn-sṳ-tên	Liechtenstein
Kiam-khiâu	Cambridge
Thi-ngi-chhṳ Sṳ-kie Thai-chan	Zweiter Weltkrieg
Cologne	Köln
Kak-tên-nì-â	Gdynia
Sṳ̍p-chhiet-chhiâng	Stettin
Sṳ-ho̍k	Mathematik
Lâ-tên-ngî	Latein
Pâ-lìm	Bahrain
Â-mî-nì-â	Armenien
Set-ngì-vì-â	Serbien
Ngie̍t-khiù	Mond
Àu-thai-li-â	Australien
Vu̍t-lî-ho̍k	Physik
Â-kîn-thìn	Argentinien
Pi-lû	Peru
Sâng-vu̍t-ho̍k	Biologie
Tsêu-siên Mìn-tsú Tsú-ngi Ngìn-mìn Khiung-fò-koet	Nordkorea
Kán-pu-chhài	Kambodscha
Khiúng-liùng	Dinosaurier
Yî-sṳ̂-làn-kau	Islam
Lech Wałęsa	Lech Wałęsa
Lin-é	Rad
Lyon	Lyon
Êu-chû Lièn-mèn	Europäische Union
Rhône-Alpes	Rhône-Alpes
Chhiòn-khiù Chṳ̂-sín Mióng	World Wide Web
Ńg-ngìn	Frau
Fâ	Blüte
Mâ-lî-â-na̍p-hói	Marianengraben
Chû-mu̍k-lòng-mâ-fûng	Mount Everest
Sàng-sṳ	Stadt
Nâ-pho-lùn yit-sṳ	Napoleon Bonaparte
Ngit-tèu	Sonne
Pâ-sṳ-tet	Louis Pasteur
大洋洲	Ozeanien
Thai-yòng Hì	Sonnensystem
Pô-lò-tit-hói	Ostsee
Ngâ-chhṳ	Zahn
Khîn	Wasserstoff
Hoi (氦)	Helium
Angela Merkel	Angela Merkel
Lî	Lithium
Phì	Beryllium
Si	Buch
Ngit	Tag
Ngièn	Jahr
Sṳ-ki	Jahrhundert
Lò-tsṳ (Pô-làn)	Łódź
Khà-thok-vì-chṳ	Katowice
Ngie̍t-sû-fû	Rzeszów
Phìn	Bor
Thàn	Kohlenstoff
Tham	Stickstoff
Yòng	Sauerstoff
Hàng-sên	Planet
Yîm-ngo̍k	Musik
Rennes	Rennes
Mo̍k-sṳ̂-khô	Moskau
Fuk	Fluor
Yi-thai-li-ngî	Italienische Sprache
Nái	Neon
Sṳn Pí-tet-páu	Sankt Petersburg
Na̍p	Natrium
北	Norden
Mî	Magnesium
Lî (鋁)	Aluminium
Néu Sî-làn	Neuseeland
南	Süden
Yin-thu	Indien
Si̍t	Silicium
Fap	Francium
Lìn	Phosphor
Thiet	Eisen
Tûng-kâ	Tonga
西	Westen
Liù-vòng	Schwefel
東	Osten
Liu̍k	Chlor
Pâ-pu-â Néu-kí-nui-â	Papua-Neuguinea
Vî-lièn Sâ-sṳ-pí-â	William Shakespeare
Â (氬)	Argon
Kap	Kalium
Koi	Calcium
Yèn	Blei
Mùng-kú-koet	Mongolei
Khong (鈧)	Scandium
Thai	Titan (Element)
Genghis Khan	Dschingis Khan
Fàm	Vanadium
Mien-yîn	Maine
Kok	Chrom
Mâ	Hauspferd
Thûng-vu̍t	Tier
Sû-li-nàm	Suriname
Màng	Mangan
Pâ-lâ-kûi	Paraguay
Koi-â-nâ	Guyana
Ngi-su̍t	Kunst
Lòi	Rhenium
Kô-lùn-pí-â	Kolumbien
Kû	Cobalt
Vû	Wolfram
Ngiap (鎳)	Nickel
Fu̍t-kau	Buddhismus
Pô-li-vì-â	Bolivien
Tshṳ̀-nì-tha̍t lâu Tô-pâ-kô	Trinidad und Tobago
Chhṳ̍t-vu̍t	Pflanzen
Sîn	Zink
Néu Hàn-pu-ha	New Hampshire
Pí-â-vùi-sṳ̂-thok-khiet	Białystok
Ngà-mâi-kâ	Jamaika
Mà-sat-chû-set	Massachusetts
Drenthe-sén	Provinz Drente
Overijssel-sén	Provinz Overijssel
Kûa-thi-mâ-là	Guatemala
Gelderland-sén	Provinz Gelderland
Pâ-hâ-mâ	Bahamas
Không-nái-tí-khiet-chû	Connecticut
Kiê-é	Haushuhn
Ha-vî-yî	Hawaii
Fùng-tû-lâ-sṳ̂	Honduras
Tô-mí-nì-kâ	Dominica
Tô-mí-nì-kâ Khiung-fò-koet	Dominikanische Republik
Kâ-chû (Thung-vu̍t)	Hausschwein
Hói-thi	Haiti
Sat-ngì-ngá-tô	El Salvador
Yî-lóng	Iran
Yî-là-khiet	Irak
Â-lâ-sṳ̂-kâ	Alaska
Kô-sṳ̂-tha̍t Lì-kâ	Costa Rica
Yî-set-lie̍t	Israel
Pâ-nâ-mâ	Panama
Ya̍p-mùn	Jemen
Phiang-thu̍k	Viren
Pô-làn-ngî	Polnische Sprache
Yok-tan	Jordanien
Nì-kâ-lâ-kûa	Nicaragua
Fu-lò-lî-tha̍t	Florida
Kit-ngí-kit-sṳ̂-thán	Kirgisistan
Â-li-sông-ná	Arizona
Khô-vî-thi̍t	Kuwait
Liàu-koet	Laos
Lì-pâ-nun	Libanon
O-le̍t-kông	Oregon
Gi-tuk-gaau zung geh sin	Gott (Christentum)
Mâ-ngì-thoi-fû	Malediven
Yù-thâ	Utah
Mâ-lòi-sî-â	Malaysia
Mién-thien	Myanmar
Nì-pok	Nepal
Â-man	Oman
Pâ-kî-sṳ̂-thán	Pakistan
Khà-tha̍t	Katar
Mióng-khiù	Tennis
Sâ-vû-thi Â-lâ-pak	Saudi-Arabien
Sṳ̂-lî-làn-khà	Sri Lanka
Si-li-â	Syrien
Kâ	Gallium
Thap-kit-khiet-sṳ̂-thán	Tadschikistan
中華民國	Republik China (Taiwan)
YouTube	YouTube
Châ	Germanium
Thai-koet	Thailand
Sṳ̂n	Arsen
Thú-khû-man-sṳ̂-thán	Turkmenistan
Abakan	Abakan (Stadt)
Sî	Selen
Yî	Iridium
Â-lâ-pak Lièn-ha̍p Thai-kûng-koet	Vereinigte Arabische Emirate
Tshiù (溴)	Brom
Pha̍k (鉑)	Platin
Ye̍t-nàm	Vietnam
Thai-hòn Mìn-koet	Südkorea
Khiet	Krypton
Â-fu-hon	Afghanistan
J. R. R. Tolkien	J. R. R. Tolkien
Lù	Rubidium
Kîm	Gold
Men-kâ-lâ-koet	Bangladesch
Ufa	Ufa (Stadt)
Ôn-kô-lâ	Angola
Vùn-lòi	Brunei
Kúng	Quecksilber
Fî-li̍t-pîn	Philippinen
Thò	Thallium
Ngie-sat-khiet Ngiù-tun	Isaac Newton
Albert Einstein	Albert Einstein
Sṳ̂	Strontium
Yet	Yttrium
Pit	Bismut
Vòng-set	Gelb
Tsan-pí-â	Sambia
Sîn-pâ-pu-vî	Simbabwe
北京	Peking
Tuva Khiung-fò-koet	Tuwa
Pok-tshṳ-ngá-na̍p	Botswana
Pho (釙)	Polonium
Bayern	Bayern
Baden-Württemberg	Baden-Württemberg
Ngo (砈)	Astat
Lòi-sò-thok	Lesotho
Mâ-tha̍t-kâ-sṳ̂-kâ	Madagaskar
Mâ-là-vî	Malawi
Stuttgart	Stuttgart
Màu-li-thap-nì-â	Mauretanien
Pô-làn-ngìn	Polen (Ethnie)
Mo̍k-sông-pí-khiet	Mosambik
Na̍p-mí-pí-â	Namibia
Nai-khi̍p-li-â	Nigeria
Ko	Zirconium
Nì	Niob
Yû-li-vû-sṳ̂ Khái-sat	Gaius Iulius Caesar
Sṳ̂-vî-sṳ-làn	Swasiland
Muk	Molybdän
Thap	Technetium
Hamburg	Hamburg
Thoi-chhia	Stoffwechsel
Miên-yi̍t Hì-thúng	Immunsystem
Lièn-ha̍p-koet	Vereinte Nationen
Sîm-chhong	Herz
Thèu-nó	Gehirn
Phì-fû	Haut
Ló	Rhodium
Làm-set	Blau
Pâ	Palladium
Ngiùn	Silber
Kak	Cadmium
Yîn	Indium
Siak	Zinn
Yu	Uran
Thi (銻)	Antimon
Ti	Tellur
Pu	Plutonium
Tièn	Iod
Nai	Neptunium
Set	Caesium
Phù	Protactinium
Pi	Barium
Thú	Thorium
Kap (鉿)	Hafnium
Than (鉭)	Tantal
Luì	Radium
Tûng	Radon
Alsace	Elsass
Auvergne	Auvergne
Ôn-tet-là-pâng	Andhra Pradesh
Me̍t-hiet-kîn	Michigan
Burgundy	Burgund
Aquitaine	Aquitanien
Schleswig-Holstein	Schleswig-Holstein
Hâ Saxony	Niedersachsen
Pet Rhine-Westphalia	Nordrhein-Westfalen
Saxony	Sachsen
Yî-li-nò	Illinois
Thuringia	Thüringen
Saxony-Anhalt	Sachsen-Anhalt
Pet Tha̍t-khô-thâ	North Dakota
Brandenburg	Brandenburg
Bremen-chû	Freie Hansestadt Bremen
Nàm Tha̍t-khô-thâ	South Dakota
Mùng-thai-nâ	Montana
Fài-ngò-mìn	Wyoming
Yâ-lu-sat-lâng	Jerusalem
Oi-tha̍t-hòt	Idaho
Fà-sṳn-tun	Washington (Staat)
Lù (鑪)	Rutherfordium
Nui-fà-tha̍t	Nevada
Hàn (𨧀)	Dubnium
Hí (𨭎)	Seaborgium
Yin-thu-yòng	Indischer Ozean
Khô-sò-vok	Kosovo
Kâ-le̍t-pí-hói	Karibisches Meer
Pô (𨨏)	Bohrium
Het (𨭆)	Hassium
Phan Kî-vùn	Ban Ki-moon
Ma̍k (䥑)	Meitnerium
Khô-lò-là-tô	Colorado
Tha̍t	Darmstadtium
Siau-pâng	Frédéric Chopin
Lùn	Roentgenium
Kô (鎶)	Copernicium
分類:Chú-yeu fûn-lui	Kategorie:!Hauptkategorie
Chi-kâ-kô	Chicago
Arnhem	Arnhem
Tûng-kui	Winter
Sî-pân-ngà-ngî	Spanische Sprache
Fî-là-thiet-fî	Philadelphia
Tî-tû	Webspinnen
Kîm-tshièn	Geld
Vì-kit-nì-â	Virginia
Sî Vì-kit-nì-â	West Virginia
Tshiâng-tséu	Spanischer Pfeffer
Néu-yok-chû	New York (Bundesstaat)
Sṳ (鈰)	Cer
Phú	Praseodym
Lò-tet-tó	Rhode Island
Ńg	Neodym
Khûn-chhùng	Insekten
Mâ-lî-làn	Maryland
Thi̍t-lâ-ngá	Delaware
Yû (銪)	Europium
Ngò-hài-ngò	Ohio
Vì-kit-ngì	Vergil
Machiavelli	Niccolò Machiavelli
Pîn-sé-fap-nì-â	Pennsylvania
Uetersen	Uetersen
O-kú-sṳ̂-tû	Augustus
Néu Chhe̍t-sî-chû	New Jersey
Fûn-làn-ngî	Finnische Sprache
Yin-thi-ôn-na̍p	Indiana
Vì-sṳ̂-pha-siên	Vespasian
Thù-là-chṳ̂n	Trajan
Hâ-tet-liòng	Hadrian (Kaiser)
Khièu-tshṳ-â	Georgia
Mâ-khù-sṳ̂ O-lie̍t-lî-vû-sṳ̂	Mark Aurel
Zagreb	Zagreb
Tet-khiet-sat-sṳ̂	Texas
Thai-mí-ngì-na̍p-tet-pâng	Tamil Nadu
Pet Khà-lò-lòi-na̍p	North Carolina
Nàm Khà-lò-lòi-na̍p	South Carolina
Loire-sén	Loire
Pâ-set-lò-nâ	Barcelona
Vòng-lî	Ananas
Me̍t-sî-sî-pí	Mississippi (Staat)
Thièn-na̍p-sî	Tennessee
Néu Me̍t-sî-kô	New Mexico
Mìn-nì-sû-tha̍t	Minnesota
Vî-sṳ̂-không-sîn	Wisconsin
Oi-hò-fà	Iowa
Nui-pu-lâ-sṳ̂-kâ	Nebraska
Khâm-sat-sṳ̂	Kansas
Yin-thi-ngî	Hindi
Me̍t-sû-lî	Missouri
Lu-yi-sṳ̂-ôn-ná	Louisiana
Khén-thap-kî	Kentucky
Â-khén-set	Arkansas
Neil Armstrong	Neil Armstrong
O-khiet-lâ-hò-mâ	Oklahoma
Pet-hói	Nordsee
Mo̍k-sṳ̂-khô-chû	Oblast Moskau
Kiel	Kiel
Schwerin	Schwerin
Potsdam	Potsdam
Hanover	Hannover
Düsseldorf	Düsseldorf
Mainz	Mainz
Wiesbaden	Wiesbaden
Saarbrücken	Saarbrücken
Mu-nì-het	München
Erfurt	Erfurt
Dresden	Dresden
Kaliningrad-chû	Oblast Kaliningrad
Murmansk-chû	Oblast Murmansk
Kak-than-sṳ̂-khiet	Danzig
Fap-làn-khiet-fuk	Frankfurt am Main
Fut-lò-tshṳ-ngá-fû	Breslau
Làn	Lanthan
Ki (鉕)	Promethium
Sân	Samarium
Â-chhè Thi̍t-phe̍t Hàng-chṳn-khî	Aceh
Nga̍t (釓)	Gadolinium
Thi̍t (鋱)	Terbium
Tit (鏑)	Dysprosium
Sṳn-kîn	Bibel
Fó	Holmium
Ngí (鉺)	Erbium
Tiû	Thulium
Yi	Ytterbium
Liu	Lutetium
Hò-nui-sṳ	Hanoi
Chṳ̂n Yâ-sû Kau-fi	Wahre Jesus-Kirche
Yîn-ngî	Englische Sprache
Màn-kuk	Bangkok
Kit-lùng-po	Kuala Lumpur
Pâng-kâ Vú-lî-thung-sén	Bangka-Belitung
Thòi-pet-sṳ	Taipeh
Mî (鋂)	Americium
Arkhangelsk-chû	Oblast Archangelsk
Khiu̍k	Curium
Thùng-hói-sṳ	Đồng Hới
Concepción	Concepción (Chile)
Pet (鉳)	Berkelium
Khà (鉲)	Californium
Mìn-kú-lû-sén	Bengkulu (Provinz)
Oi	Einsteinium
Fi	Fermium
Mùn	Mendelevium
Na	Nobelium
Ontario-sén	Ontario
Lò	Lawrencium
Karelia Khiung-fò-koet	Republik Karelien
Końskowola	Końskowola
2002-ngièn	2002
2008-ngièn	2008
Charles de Gaulle	Charles de Gaulle
Cham-pî-sén	Jambi (Provinz)
Komi Khiung-fò-koet	Republik Komi
Nâm-póng-sén	Lampung (Provinz)
Pet Sû-mùn-tap-lia̍p-sén	Sumatera Utara
Syktyvkar	Syktywkar
Québec-sṳ	Québec (Stadt)
Nenets Chhṳ-chhṳ-khî	Autonomer Kreis der Nenzen
Liàu-nui-sén	Riau
Leningrad-chû	Oblast Leningrad
Pskov-chû	Oblast Pskow
Liàu-nui Khiùn-tó-sén	Kepulauan Riau
Nizhny Novgorod-chû	Oblast Nischni Nowgorod
Nàm Sû-mùn-tap-lia̍p-sén	Sumatera Selatan
Lò-mâ Ti-koet	Römische Kaiserzeit
Mì-ngiôn Kûng-sṳ̂	Microsoft
Tver-chû	Oblast Twer
Khù-lû-fû	Kurów
Fa-ho̍k	Chemie
Smolensk-chû	Oblast Smolensk
Yaroslavl-chû	Oblast Jaroslawl
Kostroma-chû	Oblast Kostroma
Ivanovo-chû	Oblast Iwanowo
Arnold Schwarzenegger	Arnold Schwarzenegger
Chiuk-khiù	Fußball
Ryazan-chû	Oblast Rjasan
IPhone	IPhone
Sî Sû-mùn-tap-lia̍p-sén	Sumatera Barat
Tula-chû	Oblast Tula
IPad	IPad
Mâ-tet-lî	Madrid
Bryansk-chû	Oblast Brjansk
Michael Jackson	Michael Jackson
Kaluga-chû	Oblast Kaluga
Loire-Atlantique-sén	Département Loire-Atlantique
Ain-sén	Département Ain
Allier-sén	Département Allier
Khâm-phì-là	Canberra
Sông Alpes-sén	Département Hautes-Alpes
Oryol-chû	Oblast Orjol
Sit-nì	Sydney
Alpes-de-Haute-Provence-sén	Département Alpes-de-Haute-Provence
Liu̍k-set	Grün
Alpes-Maritimes-sén	Département Alpes-Maritimes
Hâ-tet-sùn-hò	Hudson River
Me̍t-ngì-pún	Melbourne
Fùng-set	Rot
Ardèche-sén	Département Ardèche
Jena	Jena
Kursk-chû	Oblast Kursk
Ariège-sén	Département Ariège
Aude-sén	Département Aude
Aveyron-sén	Département Aveyron
Sîn Nàm Vî-ngì-sṳ̂-chû	New South Wales
Bouches-du-Rhône-sén	Département Bouches-du-Rhône
Àu-thai-li-â Sú-tû Liâng-thi	Australian Capital Territory
Cantal-sén	Département Cantal
Belgorod-chû	Oblast Belgorod
Côte-d'Or-sén	Département Côte-d’Or
Côtes-d'Armor-sén	Département Côtes-d’Armor
Drôme-sén	Département Drôme
Finistère-sén	Département Finistère
Voronezh-chû	Oblast Woronesch
Sû-mùn-tap-lia̍p	Sumatra
Lipetsk-chû	Oblast Lipezk
Van-tan-sén	Banten
Chûng Cháu-ôa-sén	Jawa Tengah
Fùi-sên	Komet
Rostov-chû	Oblast Rostow
Tûng Cháu-ôa-sén	Jawa Timur
Ngâ-kâ-tha̍t Sú-tû Thi̍t-khî	Jakarta
Sî Cháu-ôa-sén	Jawa Barat
Adygea Khiung-fò-koet	Adygeja
Ngit-ngiâ Thi-fông Thi̍t-khî	Yogyakarta
Gera	Gera
Maykop	Maikop
Cháu-ôa-tó	Java (Insel)
Kâ-lî-man-tân-chû	Kalimantan
Séu Sùn-thâ Khiùn-tó	Kleine Sundainseln
Sû-lâ-vî-sî-tó	Sulawesi
Mô-lu̍k-kâ Khiùn-tó	Molukken
Chûng Kâ-lî-man-tân-sén	Kalimantan Tengah
Tûng Kâ-lî-man-tân-sén	Kalimantan Timur
Nàm Kâ-lî-man-tân-sén	Kalimantan Selatan
Kâ-li-sî-â	Galicien
Sî Kâ-lî-man-tân-sén	Kalimantan Barat
Thai-ho̍k	Universität
Pretoria	Pretoria
Chok-khiù	Tischtennis
Â-sṳ̂-thù-lî-â-sṳ̂	Asturien
Wikipedia:Sandbox	Wikipedia:Spielwiese
Astrakhan-chû	Oblast Astrachan
Kham-thap-pu-lî-â	Kantabrien
Kalmykia Khiung-fò-koet	Kalmückien
Weimar	Weimar
Osasco	Osasco
Â-là-kung	Aragonien
Kak-là-sṳ̂-kô	Glasgow
Thùng-hói Kî-chhòng	Flughafen Dong Hoi
Vú-lîn-ngièn Fûng-kín Miàng-sṳn-khî	Wulingyuan
分類:Thòi-vân li̍t-sṳ́	Kategorie:Taiwanische Geschichte
Curitiba	Curitiba
Chloë Grace Moretz	Chloë Grace Moretz
Khûng-chṳ́	Konfuzius
Corbin Bleu	Corbin Bleu
分類:Sṳ-ho̍k	Kategorie:Mathematik
分類:Ngìn-kûng ngî-ngièn	Kategorie:Konstruierte Sprache
Pâ-lî-sén	Bali
Mî-kîm	US-Dollar
Thi-chûng-hói	Mittelmeer
Hông-chû-sṳ	Hangzhou
Kî-tuk-kau	Christentum
Tûng Nú-sâ Tên-kâ-là-sén	Nusa Tenggara Timur
Sî Nú-sâ Tên-kâ-là-sén	Nusa Tenggara Barat
Chûng Sû-lâ-vî-sî-sén	Sulawesi Tengah
Kô-lùn-tá-lo̍k-sén	Gorontalo
Pet Sû-lâ-vî-sî-sén	Sulawesi Utara
Tûng-nàm Sû-lâ-vî-sî-sén	Sulawesi Tenggara
Nàm Sû-lâ-vî-sî-sén	Sulawesi Selatan
Sî Sû-lâ-vî-sî-sén	Westsulawesi
Vò-é	Reis
Mâ-lû-kú-sén	Maluku
Pet Mâ-lû-kú-sén	Nordmolukken
Pâ-pu-â-sén	Papua (Provinz)
Sî Pâ-pu-â-sén	Papua Barat
Dagestan Khiung-fò-koet	Dagestan
Sú-tû	Hauptstadt
Monzón	Monzón
Phù-thò-ngà-ngî	Portugiesische Sprache
Ngie̍t	Monat
Mustafa Kemal Atatürk	Mustafa Kemal Atatürk
Makhachkala	Machatschkala
Chechnya Khiung-fò-koet	Tschetschenien
Grozny	Grosny
Almazán	Almazán
Vòng Hien-fàm	Huang Xianfan
Ingushetia Khiung-fò-koet	Inguschetien
Magas	Magas (Inguschetien)
Pet Ossetia–Alania Khiung-fò-koet	Nordossetien-Alanien
Kabardino-Balkaria Khiung-fò-koet	Kabardino-Balkarien
Tson-sa̍k	Diamant
Bill Gates	Bill Gates
Ngi̍t-ngî	Japanische Sprache
Pak-khô-chhiòn-sû	Enzyklopädie
頭頁	Wikipedia:Hauptseite
Karachay-Cherkessia Khiung-fò-koet	Karatschai-Tscherkessien
Saratov	Saratow
Saratov-chû	Oblast Saratow
Orenburg-chû	Oblast Orenburg
Mordovia Khiung-fò-koet	Mordwinien
Saransk	Saransk
Yâ-khiù	Baseball
Làm-khiù	Basketball
Kirov-chû	Oblast Kirow
Udmurtia Khiung-fò-koet	Udmurtien
Sî-pak-li-â	Sibirien
Mari El Khiung-fò-koet	Mari El
Yoshkar-Ola	Joschkar-Ola
Stellenbosch	Stellenbosch
Sverdlovsk-chû	Oblast Swerdlowsk
Cape Town	Kapstadt
Chuvash Khiung-fò-koet	Tschuwaschien
Durban	Durban
Cheboksary	Tscheboksary
Tat-tat-sṳ̂-thán Khiung-fò-koet	Tatarstan
Penza-chû	Oblast Pensa
Là-fî-ngì	Raffael
Pí-tet Lû-pún-sṳ̂	Peter Paul Rubens
Ulyanovsk-chû	Oblast Uljanowsk
Gung-gung-hi-tsaa	Omnibus
Kâ-thai-lò-nì-â	Katalonien
Bashkortostan Khiung-fò-koet	Baschkortostan
Chelyabinsk-chû	Oblast Tscheljabinsk
Pâ-lùn-sî-â Chhṳ-chhṳ-khî	Valencianische Gemeinschaft
Khà-sṳ̂-tì-li-â lâu Lòi-ngong	Kastilien und León
Kurgan-chû	Oblast Kurgan
Mô Chhe̍t-tûng	Mao Zedong
Tyumen-chû	Oblast Tjumen
Omsk-chû	Oblast Omsk
Thai-mí-ngì-ngî	Tamil
Chet-ho̍k	Philosophie
分類:Candidates for speedy deletion	Kategorie:Wikipedia:Schnelllöschen
Altai Khiung-fò-koet	Republik Altai
Kòng-khìm	Klavier
Gorno-Altaysk	Gorno-Altaisk
Kemerovo-chû	Oblast Kemerowo
Hebe Camargo	Hebe Camargo
Chṳ̂-pún chú-ngi	Kapitalismus
Mìn-chhu̍k	Nation
Khanty-Mansi Chhṳ-chhṳ-khî	Autonomer Kreis der Chanten und Mansen/Jugra
Yamalo-Nenets Chhṳ-chhṳ-khî	Autonomer Kreis der Jamal-Nenzen
Montpellier	Montpellier
分類:Thiên-vùn-ho̍k	Kategorie:Astronomie
Khakassia Khiung-fò-koet	Chakassien
Irkutsk-chû	Oblast Irkutsk
Sakha Khiung-fò-koet	Sacha
Khiet-lò-âi-sî-â-ngî	Kroatische Sprache
Hon-pó	Hamburger
Buryatia Khiung-fò-koet	Burjatien
Vû-làn Vû-tet	Ulan-Ude
Amur-chû	Oblast Amur
Ngi-sṳ̍p Sṳ-ki	20. Jahrhundert
Gotha	Gotha
Dijon	Dijon
Kâ-thai-lò-nì-â-ngî	Katalanische Sprache
Nordhausen	Nordhausen
Kit-lò-na̍p-sén	Girona
Eisenach	Eisenach
Se-pâu Sâng-vu̍t-ho̍k	Zellbiologie
Sṳ-kie Ngiùn-hòng Si̍p-thòn	Weltbank
A-la-pak Liên-mên	Arabische Liga
Mìn-tsú Tsú-ngi	Demokratie
Chhîn-chhèu (秦朝)	Qin-Dynastie
Pet Thai-sî-yòng Kûng-yok Chû-chṳt	NATO
Chhìn Sṳ Fòng	Qin Shihuangdi
Hon-chhèu	Han-Dynastie
Hon Vú-ti Liù Chha̍t	Han Wudi
Sâng-vu̍t	Lebewesen
Kiûn-chú-chṳ	Monarchie
Khiung-fò-koet	Republik
Yí-mô-khiù	Badminton
Ngièn-chhèu	Yuan-Dynastie
Nazi Tet-koet	Deutsches Reich 1933 bis 1945
Yù-thai-ngìn	Juden
Chang Fò	Zheng He
Chìn-chhèu	Jin-Dynastie (265–420)
Ngí	Ohr
Phi	Nase
Ngién	Auge
Mûn-é	Stechmücken
Mièn-yòng	Hausschaf
Lo̍k-thò	Altweltkamele
Phú-nen thung-vu̍t	Säugetiere
Ngie-kûng	Ameisen
Phûng-é	Bienen
Hò-làn-ngî	Niederländische Sprache
Fà-thi̍t Thit-sṳ-nì Kûng-sṳ̂	The Walt Disney Company
Thot-yong Fu̍t-thông Fu̍t-son	Desoxyribonukleinsäure
Khiô	Aubergine
Siet	Schnee
Â-pâ	Vater
Fûn	Minute
Yù-thai Chhṳ-chhṳ-chû	Jüdische Autonome Oblast
Ngò-lò-sṳ̂-ngî	Russische Sprache
Tûng-nàm-â Koet-kâ Lièn-mèn	ASEAN
Sakhalin-chû	Oblast Sachalin
Mien-pâu	Brot
Sṳ-kie Mo-yi Chû-chṳt	Welthandelsorganisation
漢語	Chinesische Sprachen
Se-pâu	Zelle (Biologie)
Hiet-yi̍t	Blut
Hi	Lunge
Lò-mâ-nì-â-ngî	Rumänische Sprache
Pó-kâ-li-â-ngî	Bulgarische Sprache
Magadan-chû	Oblast Magadan
Chhṳ-yèn Khô-ho̍k	Naturwissenschaft
Het-chhe̍t Mìn	Akira Kurosawa
Franklin D. Roosevelt	Franklin D. Roosevelt
Thi-khiù Khô-ho̍k	Geowissenschaften
Sa̍k-thèu	Gestein
Yùn	Wolke
Kí-hò-ho̍k	Geometrie
Tet-lu-kú-ngî	Telugu
Thai-hì-chhèn	Atmosphäre (Astronomie)
Kak-lû-kit-â-ngî	Georgische Sprache
Kîn-chi-ho̍k	Wirtschaftswissenschaft
Pîn-kóng	Pangkal Pinang
漢字	Chinesische Schrift
Sî-lî-ngì Sṳ-mû	Kyrillisches Alphabet
Lâ-tên sṳ-mû	Lateinisches Alphabet
Vùn-ho̍k	Literatur
分類:Fap-koet	Kategorie:Frankreich
分類:Yîm-ngo̍k	Kategorie:Musik
分類:Vùn-ho̍k	Kategorie:Literatur
Fù-lì	Fuchs (Säugetier)
La̍p-pá	Trompete
Â-li̍t-sân-thai sâm-sṳ	Alexander der Große
Kiûn-sṳ-thán-tên Yit-sṳ	Konstantin der Große
Set-lû-sṳ thai-ti	Kyros II.
Vùn-mìn	Zivilisation
Kau-yuk	Bildung
Kâ-thìn	Familie
Nàm-ngìn	Mann
Fûn-yîn	Ehe
Kiûn-sṳ	Militär
Kâ-pî	Kaffee
Ngiù-nen	Milch
Sûn Chûng-sân	Sun Yat-sen
Â-yuk-vòng	Ashoka
香港	Hongkong
Thai-yîn Ti-koet	Britisches Weltreich
Sú-ngì	Seoul
Kâm-nái-thit Koet-chi Kî-chhòng	John F. Kennedy International Airport
上海	Shanghai
Lùn-tûn Hî-sṳ̂-lu Kî-chhòng	Flughafen London Heathrow
Lùn-tûn Kak-vet Kî-chhòng	Gatwick Airport
Set-vì-li-â	Sevilla
Chhîn-chhèu	Qing-Dynastie
Â-ngì-pâ-nì-â-ngî	Albanische Sprache
Pâ-sṳ̂-khiet-ngî	Baskische Sprache
Â-lâ-kung-ngî	Aragonesische Sprache
Yîn-koet Hòng-khûng	British Airways
Â-mî-nì-â-ngî	Armenische Sprache
Vû-khiet-làn-ngî	Ukrainische Sprache
Pâ-lùn-sî-â	Valencia
Shuì-tién-ngî	Schwedische Sprache
Tan-ma̍k-ngî	Dänische Sprache
Nò-vî-ngî	Norwegische Sprache
Kô-thi̍t-fu̍t-lòi-tet Vî-liâm Lòi-pu-nì-tsṳ	Gottfried Wilhelm Leibniz
Tshia̍p-khiet-ngî	Tschechische Sprache
Sṳ̂-lo̍k-phat-khiet-ngî	Slowakische Sprache
Sṳ̂-lo̍k-vì-nì-â-ngî	Slowenische Sprache
Hiûng-ngà-li-ngî	Ungarische Sprache
Oi-sâ-nì-â-ngî	Estnische Sprache
Là-thot-vì-â-ngî	Lettische Sprache
Li̍p-thâu-vón-ngî	Litauische Sprache
Pha̍k-ngò-lò-sṳ̂-ngî	Weißrussische Sprache
Kui-mí-thi̍t-lî Mùn-tet-lie̍t-fû	Dmitri Iwanowitsch Mendelejew
Ngièn-chṳ́	Atom
Lâ-set-fuk	Ernest Rutherford
Hî-lia̍p-ngî	Griechische Sprache
Oi-ngì-làn-ngî	Irische Sprache
Pô-sṳ̂-ngî	Persische Sprache
Chûng-kau	Religion
Chêu-sién-ngî	Koreanische Sprache
Chhóng-sṳ-ki	1. Buch Mose
Chhut-âi-khi̍p-ki	2. Buch Mose
Ye̍t-nàm-ngî	Vietnamesische Sprache
Pó-lò	Paulus von Tarsus
Kô-mièn-ngî	Khmer-Sprache
Thai-ngî	Thailändische Sprache
Mâ-lòi-ngî	Malaiische Sprache
Mùng-kú-ngî	Mongolische Sprache
Hâ-sat-khiet-ngî	Kasachische Sprache
Vû-tsṳ̂-phe̍t-khiet-ngî	Usbekische Sprache
Thú-khù-màn-ngî	Turkmenische Sprache
Yù-thai-kau	Judentum
Hî-pak-lói-ngî	Hebräische Sprache
Â-set-pai-kiông-ngî	Aserbaidschanische Sprache
Mâ-khì-tun-ngî	Mazedonische Sprache
Set-ngì-vì-â-ngî	Serbische Sprache
Set-ngì-vì-â Khiet-lò-thi-â-ngî	Serbokroatische Sprache
Pô-sṳ-nì-â-ngî	Bosnische Sprache
Kâ-lî-sî-â-ngî	Galicische Sprache
Vî-ngì-sṳ̂-ngî	Walisische Sprache
Sû-kak-làn Koi-ngì-ngî	Schottisch-gälische Sprache
Siak-khiet-kau	Sikhismus
John Maynard Keynes	John Maynard Keynes
Lufthansa Hòng-khûng	Lufthansa
Ló-chṳ́	Laozi
Kôn-chhóng	Leber
Shìn	Niere
Thu-é	Kaninchen
Sṳ̀n-kîn Ne-thúng	Nervensystem
Sîm-lî-ho̍k	Psychologie
Sṳt-kâ-mèu-nì	Siddhartha Gautama
Mâ-tên Lu-tet	Martin Luther
Yî-kâ	Konfuzianismus
Thiên-chú-kau	Römisch-katholische Kirche
Tho-kau	Daoismus
Chit-siói	Rückenmark
Sa̍t	Zunge
Yî-tshóng	Bauchspeicheldrüse
Hèu-thèu	Kehlkopf
Fuk-khiet-làn khiùn-tó	Falklandinseln
Vàng-kak-mo̍k	Zwerchfell
Lân-mî	Appendix vermiformis
Elizabeth Ngi-sṳ	Elisabeth II.
Thòng-chhèu	Tang-Dynastie
John F. Kennedy	John F. Kennedy
Mìn-chhèu	Ming-Dynastie
Dwight D. Eisenhower	Dwight D. Eisenhower
Ronald Reagan	Ronald Reagan
Sat-là-kô-sat	Saragossa
Kîm Tsang-ngit	Kim Jong-il
Ngièn-su Chû-khì-péu	Periodensystem
Chû-su̍k	Sus (Schweine)
Mariano Rajoy	Mariano Rajoy
Se-khiûn	Bakterien
Phù-thò	Weintraube
Phûng-thòng	Honig
Thông	Zucker
Vòng-theu	Sojabohne
Kûng-chhàng-ho̍k	Ingenieurwissenschaften
Vùn-fa	Kultur
Fan-vun	Sanskrit
Sùn-fàn Hì-thúng	Blutkreislauf
Sôn	Säuren
Yî-ho̍k	Medizin
Néu-Yok Sṳ-kie Mo-yi Chûng-sîm	World Trade Center
Hâ Màn-hâ-tun	Lower Manhattan
Yàm	Speisesalz
分類:Pâ-sî	Kategorie:Brasilien
Màn-hâ-tun	Manhattan
Ngièn-su	Chemisches Element
Kâ-suk-thu	Beschleunigung
Li̍t	Kraft
Kú	Trommel
Tsṳt-liông	Masse (Physik)
Thien-yáng	Film
Kîm-su̍k	Metalle
Nùng-ngia̍p	Landwirtschaft
Sâng-yîm	Schall
Sṳ̀-kiên	Zeit
Mien-chit	Flächeninhalt
Kûng-kîn	Kilogramm
Kûng-tshak	Meter
Miéu	Sekunde
Pâu-siuk	Mais
Kûng-sṳ̂n	Liter
Fà-ngì-kiê	Wall Street
Tûng-nàm-â	Südostasien
Tshùng-khin	Chongqing
Thiên-tsîn	Tianjin
Vú-hon-sṳ	Wuhan
Kú Hî-lia̍p	Antikes Griechenland
Thomas Jefferson	Thomas Jefferson
Vùi-sṳ̂-khà	Huesca
Tychy	Tychy
El Masnou	El Masnou
Pu-lie̍t-thap-nì-ngî	Bretonische Sprache
Brittany	Bretagne
Lóng	Gehörlosigkeit
Chhi̍t-phiang	Krankheit
Khien-không	Gesundheit
Sok-lî-â	Soria
Màn-tó-ngî	Manx (Sprache)
Chhiâng-môi-su	Penicilline
Nantes	Nantes
Pot-thâm-fó	Tuberkulose
Mà-chiông	Mah-Jongg
模板:Location map Taiwan	Vorlage:Positionskarte Taiwan
Detroit	Detroit
Van-lî Tshòng-sàng	Chinesische Mauer
Gard-sén	Département Gard
Gers-sén	Département Gers
Sông Garonne-sén	Département Haute-Garonne
Sṳ̀n-sṳn Lò-mâ Ti-koet	Heiliges Römisches Reich
Ille-et-Vilaine-sén	Département Ille-et-Vilaine
Isère-sén	Département Isère
Chûng-kau Kói-kiet	Reformation
Sông Loire-sén	Département Haute-Loire
Lot-sén	Département Lot
Lozère-sén	Département Lozère
Maine-et-Loire-sén	Département Maine-et-Loire
Nì-pu-kap-nì-sat ngi-sṳ	Nabû-kudurrī-uṣur II.
Mayenne-sén	Département Mayenne
Morbihan-sén	Département Morbihan
Nièvre-sén	Département Nièvre
Nord-sén	Département Nord
Calais Hói-hia̍p-sén	Département Pas-de-Calais
Puy-de-Dôme-sén	Département Puy-de-Dôme
Sông Pyrénées-sén	Département Hautes-Pyrénées
Pyrénées-Orientales-sén	Département Pyrénées-Orientales
Hâ Rhin-sén	Département Bas-Rhin
Sông Rhin-sén	Département Haut-Rhin
Saône-et-Loire-sén	Département Saône-et-Loire
Sarthe-sén	Département Sarthe
Sông Savoie-sén	Département Haute-Savoie
Tarn-sén	Département Tarn
Tarn-et-Garonne-sén	Département Tarn-et-Garonne
Var-sén	Département Var
Vaucluse-sén	Département Vaucluse
Vendée-sén	Département Vendée
Yonne-sén	Département Yonne
Yî-pí-li-â Pan-tó	Iberische Halbinsel
Lai-kî	Litschibaum
Yâ-è	Kokospalme
Sa̍k-liù	Granatapfel
Chong-fa	Zhuang (Sprache)
Sông-sok-pu-ngî	Obersorbische Sprache
Na̍p-ngá-thi̍t-ngî	Nahuatl
Mí-nàm-kâ-pó-ngî	Minangkabauische Sprache
Mirandés-ngî	Mirandés
Harvard Thai-ho̍k	Harvard University
Néu-yok Chṳn-khèn Kâu-yi-só	New York Stock Exchange
Lie̍t-yî-tha̍t-sén	Provinz Lleida
Â-lâ-pak-ngî	Arabische Sprache
Kiú-chiu	Kyūshū
Si-koet	Shikoku
O-khiet-ngî	Okzitanische Sprache
Nàm-fî Hò-làn-ngî	Afrikaans
Lí Mìn-pok	Lee Myung-bak
Lû Vú-hién	Roh Moo-hyun
Kâ Mà-chiok	Haussperling
Kô-thiet	Mass Transit Railway
澳門	Macau
Suhl	Suhl
Mühlhausen	Mühlhausen/Thüringen
Sâ-thièn-khî	Sha Tin District
Fù Kím-Thàu	Hu Jintao
Si̍p Khiûn-phìn	Xi Jinping
Chhòng-kiáng-lu̍k	Giraffe
Phì-âi-mùng-thi̍t-ngî	Piemontesische Sprache
Thap-là-kô-na̍p	Tarragona
Provence-Alpes-Côte d'Azur	Provence-Alpes-Côte d’Azur
Chhṳ̂m-chun-sṳ	Shenzhen
Kóng-tûng	Guangdong
Kóng-sî Chong-chhu̍k Chhṳ-chhṳ-khî	Guangxi
Mô-kài	Der Herr der Ringe
Borredà	Borredà
Hiông-kóng Thai-ho̍k	Universität Hongkong
Badajoz	Badajoz
Lu̍k-yì-tó-yen	Präfektur Kagoshima
Kiok	Fuß
Sit-thit	Echsen
Altenburg	Altenburg
Kiên	Schulter
Midi-Pyrénées	Midi-Pyrénées
Wikipedia:Chhâm-siòng	Wikipedia:Projektdiskussion
Fu-mùng-thi̍t	Vermont
Hiû-sṳ̂-tûn	Houston
Kóng-chiu-sṳ	Guangzhou
Chiông Kie-sa̍k	Chiang Kai-shek
Vûn Kâ-pó	Wen Jiabao
Nàm-kîn-sṳ	Nanjing
Phiang-yèn	Krankenhaus
Kông-sû	Jiangsu
Chet-kông-sén	Zhejiang
Thèn Séu-phìn	Deng Xiaoping
Pet-phu Calais Hói-hia̍p	Nord-Pas-de-Calais
Pays de la Loire	Pays de la Loire
Languedoc-Roussillon	Languedoc-Roussillon
Thiap-sat-lò-nì-kâ	Thessaloniki
西藏自治區	Autonomes Gebiet Tibet
Hàng-thung Thien-fa	Mobiltelefon
Thò-niâu	Afrikanischer Strauß
Manchester	Manchester
Pu-lû-khiet-lìm	Brooklyn
Fòng-heu-khî	Queens
Liùng-yìn-sṳ	Yongin
Lòng	Wolf
Mâ-lòi Pan-tó	Malaiische Halbinsel
Sîn-yok Sṳn-kîn	Neues Testament
9	Neun
Zung-gok Thaai-liuk	Festlandchina
Het-liùng-kông	Heilongjiang
Mâ Yîn-kiú	Ma Ying-jeou
Piên-fò-sṳ	Biên Hòa
Hiông-kóng-tó	Hong Kong Island
Ngà-tsông-sṳ	Nha Trang
Podolsk	Podolsk
Pô-tô Lì-kok Thu̍k-li̍p-tóng	Partido Independentista Puertorriqueño
Lì-è	Hausesel
Si-chhôn-sén	Sichuan
Khiu-yok Sṳn-kîn	Altes Testament
Sṳn-tan-chiet	Weihnachten
Lò-màn Ngî-chhu̍k	Romanische Sprachen
Sâm-kok-hìn	Dreieck
Steve Jobs	Steve Jobs
Yin-Êu Ngî-ne	Indogermanische Sprachen
Breinigerberg	Breinigerberg
Lo-fú	Tiger
Fù-ôn Khà-lo̍k-sṳ̂ Yit-sṳ	Juan Carlos I.
Súi-ngièn-sṳ	Suwon
Sâm-sên Si̍p-thòn	Samsung
Louis Couturat	Louis Couturat
Thai-thièn Kóng-vet-sṳ	Daejeon
Kîn-ki-tho	Gyeonggi-do
Sṳ̂-khâm-tit-nâ-vì-â	Skandinavien
Fu̍k-fa̍t-chiet	Ostern
Thien-nó Khô-ho̍k	Informatik
Koet-chi Yîm-phiêu	Internationales Phonetisches Alphabet
Hò-pet	Hebei
Phú-lìm-sṳ̂-tun Thai-ho̍k	Princeton University
Fôn-hìn-muk	Schreitvögel
Chhṳ̀n Súi-pién	Chen Shui-bian
台灣	Taiwan (Insel)
Chṳ-fi-hîn Sú-kî	Smartphone
Sa̍k-yù	Erdöl
Hài-è	Schuh
Ngiùn-hòng	Bank
Ngièn-lun Chhṳ-yù	Meinungsfreiheit
Oi-ngì-làn	Irland (Insel)
Cheshire	Cheshire
Cumbria	Cumbria
Lancashire	Lancashire
Northumberland	Northumberland
Tyne and Wear	Tyne and Wear
County Durham	County Durham
Pet Yorkshire	North Yorkshire
Lincolnshire	Lincolnshire
Nottinghamshire	Nottinghamshire
Derbyshire	Derbyshire
Merseyside	Merseyside
Leicestershire	Leicestershire
Rutland	Rutland
Lû-sùn	Lu Xun
Northamptonshire	Northamptonshire
Devon	Devon (England)
Oxfordshire	Oxfordshire
Wiltshire	Wiltshire
Hampshire	Hampshire
Buckinghamshire	Buckinghamshire
Surrey	Surrey
West Sussex	West Sussex
East Sussex	East Sussex
Kent	Kent
Thai Lùn-tûn	Greater London
7	Sieben
8	Acht
Lu̍k-é	Hirsche
Pên	Eis
Chú ke Khì-tó-vùn	Vaterunser
Ngìn-lui-ho̍k	Anthropologie
Fùng-hói	Rotes Meer
Oi-tên-páu	Edinburgh
Pha̍k-set	Weiß
Marseille	Marseille
Thai-chhûng-thèu	Zwiebel
6	Sechs
Kôn-fông ngî-ngièn	Amtssprache
Kháu-kú-ho̍k	Archäologie
George H. W. Bush	George H. W. Bush
Pâ-ngì-kòn pan-tó	Balkanhalbinsel
Dmitry Medvedev	Dmitri Anatoljewitsch Medwedew
Entrena	Entrena
Sîn-kau	Protestantismus
Selena	Selena Quintanilla-Pérez
Mî-koet Thai-khûng Chúng-shu	NASA
Thai Put-lie̍t-tiên-tó	Großbritannien (Insel)
Pâ-le̍t-sṳ̂-thán	Palästina (Region)
10	Zehn
Lila Downs	Lila Downs
Lia̍p-pau	Gepard
Cleveland (Yîn-koet)	Cleveland (England)
Liverpool	Liverpool
Bremen	Bremen
Sîn Nò-vî-ngî	Nynorsk
Meu-thèu-tiâu	Eulen
Sṳ̀	Stunde
Fap-lò-ngî	Färöische Sprache
Kîm-eu-sṳ	Cà Mau
Meu-khô	Katzen
Koet-chi Thai-khûng Chhàm	Internationale Raumstation
Tà-la-sṳ	Đà Lạt
Tat-tat-ngî	Tatarische Sprache
Tshûng-liông	Gewichtskraft
Tsûng-su	Echte Dattelpalme
Fan-tshiet-sṳ	Phan Thiet
Sî Fut-lî-sî-ngî	Friesische Sprachen
Séu Vòng-chṳ́	Der kleine Prinz
Phiàng-fông kûng-tshak	Quadratmeter
Fó-yam-chhùng	Leuchtkäfer
Li̍p-fông kûng-tshak	Kubikmeter
Fàn-chiet-thûng-vu̍t-mùn	Ringelwürmer
Chhú-khô	Langschwanzmäuse
Lû-sêm-nì-â-ngî	Russinische Sprache
Ede (Hò-làn)	Ede (Niederlande)
Sông-ngia̍p	Kommerz
Fú-kîn	Schwertwal
Sâ-thi̍t-fut-lî-sî-ngî	Saterfriesische Sprache
Liû-khiù-koet	Königreich Ryūkyū
Pet-fut-lî-sî-â-ngî	Nordfriesische Sprache
Â-mê-ha̍p-lâ-ngî	Amharische Sprache
蝠婆	Fledertiere
Tarnobrzeg	Tarnobrzeg
Vòng Ti	Huangdi
Tiau-ǹg-thòi Lie̍t-yí	Senkaku-Inseln
Khiung-fò-tóng (Mî-koet)	Republikanische Partei
Â-sṳ̂-thù-lî-â-sṳ̂-ngî	Asturische Sprache
中國	China
O-thi-li Pâ-vî-li-â-ngî	Bairische Dialekte
Mìn-chú-tóng (Mî-koet)	Demokratische Partei (Vereinigte Staaten)
Tsuk-pet-sṳ	Zhubei
Sàng-tû-sṳ	Chengdu
Âi-sṳ̂-thi̍t-lùi-mâ-thu-lâ-ngî	Extremadurische Sprache
Sàng-fà-khî	Chenghua (Chengdu)
Séu-su mìn-chhu̍k	Minderheit
Pô-lòi-kú	Plei Cu
Â-ha̍p-sṳ̂-vòng	Ahas
Chûng-chû-sṳ	Chungju
Yòng-suk-yen	Yangshuo
Khiet-là-khô-fû	Krakau
臺灣省	Taiwan (Provinz)
Pet-kîn Sú-tû Koet-chi Kî-chhòng	Flughafen Peking
Sîn-kâ-po Hòng-khûng Kûng-sṳ̂	Singapore Airlines
Thien-nó Thôn-chhèn Só-mèu	Computertomographie
Vî-nî-sṳ̂-ngî	Venetische Sprache (romanisch)
Vû-lòi-khî	Wulai
Koet-li̍p Thòi-vân Thai-ho̍k	Nationaluniversität Taiwan
Vì-phú-sêm-ngî	Wepsische Sprache
Fu̍t-lò-ngî	Võro
Pân-mâ	Zebra
Valery Leontiev	Waleri Jakowlewitsch Leontjew
Khô-sî-kâ-ngî	Korsische Sprache
Buryat-ngî	Burjatische Sprache
Sùn-tho-chûng	Methodistische und Wesleyanische Kirchen
Suk-vú-ngî	Cebuano
Chavacano-ngî	Chabacano
Tha̍t-lò-phî-thû Ngî-hì	Dravidische Sprachen
Ló-kiê-sṳ	Lào Cai
客家語	Hakka (Sprache)
Pet-nèn-sṳ	Bắc Ninh
Hiuk-tsin-sṳ	Sóc Trăng (Ort)
Mî-tshiu-sṳ	Mỹ Tho
Fut-liù-li-ngî	Furlanische Sprache
Pâng-mî-tsuk	Buôn Ma Thuột
Kàm-ngî	Gan (Sprache)
Pok-vu̍t-kón	Museum
Yin-thu Yî-lóng Ngî-chhu̍k	Indoiranische Sprachen
Thai-yùng-meu	Großer Panda
Kalmyk-ngî	Kalmückische Sprache
Mân-ngî	Mandschurische Sprache
Kû-li̍p ngî-ngièn	Isolierte Sprachen
Kit-là-kî-ngî	Gilaki
Khà-sû-pí-ngî	Kaschubische Sprache
Karachay-Balkar-ngî	Karatschai-balkarische Sprache
Lùn-pâ-tí-ngî	Lombardische Sprache
Sú	Hand
Thu fú	Du Fu
O-lî-â-ngî	Oriya
Ngìn-khiéu	Bevölkerung
Nò-man-thi-ngî	Normannische Sprache
Pâng-â-sî-nâm-ngî	Pangasinensische Sprache
Nèn-phìn-sṳ	Ninh Bình
Pet-sat-mí-ngî	Nordsamische Sprache
O-set-thôi-ngî	Ossetische Sprache
Sî-sî-lî-ngî	Sizilianische Sprache
Sat-tên-nî-â-ngî	Sardische Sprache
Nì-ngá-ngì-ngî	Newari
Valparaíso	Valparaíso
Kóng-ngi-sṳ	Quảng Ngãi
Yên-yèn	Schauspieler
Thap-kâ-lo̍k-ngî	Tagalog
Thùng	Bronze
Vlaams-ngî	Flämische Dialekte
Fà-liùng-ngî	Wallonische Sprache
Sú-ngî	Gebärdensprache
Międzyrzec Podlaski	Międzyrzec Podlaski
Phiêu-chún Chhông-ngî	Tibetische Sprache
Ngá-shuì-ngá-shuì-ngî	Wáray-Wáray
Yì-ku-tshu̍k	Yugur
N̂g-ngî	Wu (Sprache)
Woodrow Wilson	Woodrow Wilson
Fu̍t-sân-sṳ	Foshan
Ngiù-chîn Thai-ho̍k	University of Oxford
Sṳ̍p-thiàu Kie-min	Zehn Gebote
Yok-hon-nì-sṳ̂-páu	Johannesburg
Kî-tuk Kau-fi	Kirche (Organisation)
Pau-é	Leopard
Sîn-kiông	Xinjiang
Muk-kôa	Papaya
Pu-lî-sṳ̂-pân	Brisbane
Â-mî-ngî	Amisisch
Vî-liâm Lùn-khìm	Wilhelm Conrad Röntgen
Chû-chhèu	Zhou-Dynastie
Ido-ngî	Ido (Sprache)
Brad Pitt	Brad Pitt
Pa̍k-kiûng	Weißes Haus
Tha̍t-mâ-thai-ngî	Dalmatische Sprache
Tat-tat-chhu̍k	Tataren
Thai-fán-sṳ	Ōsaka
Sên-khiù-ngî	Lingwa de Planeta
Kiam-khiâu Thai-ho̍k	University of Cambridge
Kûng-khín	Hektar
Sé-lî	Taufe
Pông-hâ	Asthma bronchiale
Chuk	Bambuseae
Hiligaynon-ngî	Hiligaynon
Fù Tsṳ-mìn	Hồ Chí Minh
Thièn-piên-fú	Điện Biên Phủ
Khûn-sṳ-làn-chû	Queensland
Kûi-yìn-sṳ	Quy Nhơn
Mìn-nì-â-pô-li-sṳ̂	Minneapolis
Li̍t-ka-sṳ	Rach Gia
Li-kú-lî-â-ngî	Ligurische Sprache (Romanisch)
Phô-lò-chû	Borneo
Khà-phién-phién-kâm-ngî	Kapampangan
Vù-fâ-kó	Echte Feige
Sun-fa-sṳ	Huế
Tshòng-thu	Länge (Physik)
Sṳ̂-chhù-chṳ̂-lu	Seidenstraße
Mô-li-ngî	Maorische Sprache
Mên-tûng-ngî	Min Dong
Mên-pet-ngî	Min Bei
Tô-se-pâu sâng-vu̍t	Vielzeller
Mên-nàm-ngî	Min Nan
Tshiên-ngièn	Jahrtausend
Ho̍k-miàng	Binäre Nomenklatur
Vì-tô-li-â-chû	Victoria (Australien)
Chong-chhu̍k	Zhuang
Sông-hói-fa	Shanghai-Dialekt
Aung San Suu Kyi翁山蘇姬	Aung San Suu Kyi
Tshèu-chû-fa	Teochew
Yok-hon-fuk-yîm	Evangelium nach Johannes
William Vòng-chṳ́	William, Duke of Cambridge
Chhṳ̀n Kóng-sâng	Jackie Chan
12	Zwölf
Vok-là-phú-khiet-ngî	Volapük
Toshiro Mifune	Toshirō Mifune
Kám-lám-su	Olivenbaum
Só-lò-mùn-vòng	Salomo
O-khiet-làn	Auckland
Chhṳ̍t-sien	Gerade
11	Elf
13	Dreizehn
Sûn-chṳ́	Sunzi
Sṳn-lìn	Heiliger Geist
Lû-pu-lìm	Lublin
Thì-thèu	Erdnuss
100	Hundert
Tshit-thèu	Kniegelenk
Tô-piên-hìn	Polygon
Nàm Chûng-koet Hói	Südchinesisches Meer
Campora San Giovanni	Campora San Giovanni
Pien-set-liùng	Chamäleons
Bloemfontein	Bloemfontein
Ngiam-set-thí	Chromosom
O-khiet-làn Vùn-fap Ho̍k-káu	Auckland Grammar School
Ngióng-kông	Rangun
Ma̍k-tông-lò Kûng-sṳ̂	McDonald’s
1000000	Million
Meu-miàng-sṳ	Maoming
Liú-chiu-sṳ	Liuzhou
Pet-pan-khiù	Nordhalbkugel
Ló-chhú	Mäuse
Thí-tsit	Volumen
Het-tsṳ̂	Hertz (Einheit)
Pak-pân-khiet	Burbank (Los Angeles County)
Sien-lia̍p-thí	Mitochondrium
Yî-sên	Arzt
Ki-sa̍k-chhṳn	Stonehenge
Chúng-thí Kîn-chi-ho̍k	Makroökonomie
Ágreda	Ágreda
Lu-kâ-fuk-yîm	Evangelium nach Lukas
Sîn Kí-nui-â	Neuguinea
Sṳ́-thù-hàng-chhon	Apostelgeschichte des Lukas
Mô-hái	Krabben
PH	PH-Wert
Khì-tó	Gebet
Ôn-fui-sén	Anhui
Chûng-chhîn Pet-tho	Chungcheongbuk-do
Chûng-chhîn Nàm-tho	Chungcheongnam-do
Kông-ngièn-tho (Hôn-koet)	Gangwon-do
Nui Mùng-kú	Innere Mongolei
Kîm Ngit-sṳ̀n	Kim Il-sung
Pí-tet-kô-sṳ̍p	Bydgoszcz
Nottingham	Nottingham
Thai-ví-vòng	David (Israel)
Li-vi-ki	3. Buch Mose
Sṳ̂-thán-fuk Thai-ho̍k	Stanford University
Fuk-kian	Fujian
Kûng-khiet	Gramm
Mùng-kú-tshu̍k	Mongolen
Khí-sṳ-liu̍k	Offenbarung des Johannes
Kong-lîn-sṳ	Gangneung
Kô-yòng-sṳ	Goyang
Kó-chhôn-sṳ	Gwacheon
Kông-mìn-sṳ	Gwangmyeong
Kóng-chû-sṳ (Hôn-koet)	Gwangju (Gyeonggi-do)
Kiú-lî-sṳ	Guri
Kiûn-phú-sṳ	Gunpo
Kîm-phú-sṳ	Gimpo
Nàm-yòng-chû-sṳ	Namyangju
Lun-sân-sṳ	Nonsan
Tûng-theu-chhôn-sṳ	Dongducheon
Tûng-hói-sṳ (Hôn-koet)	Donghae
Fu-chhôn-sṳ	Bucheon
Sâm-chit-sṳ	Samcheok
Shuì-sân-sṳ	Seosan
Sàng-nàm-sṳ	Seongnam
Suk-chhó-sṳ	Sokcho
Sṳ́-hîn-sṳ	Siheung
Ngà-sân-sṳ	Asan (Südkorea)
Ôn-sân-sṳ	Ansan
Ôn-sàng-sṳ (Hôn-koet)	Anseong
Ôn-yông-sṳ	Anyang (Südkorea)
Ngièn-chû-sṳ	Wonju
Ngi-chṳn-fú-sṳ	Uijeongbu
Li-chhôn-sṳ (Hôn-koet)	Icheon
Thî-chhôn-sṳ	Jecheon
Thiên-ôn-sṳ	Cheonan
Chhîn-chû-sṳ	Cheongju
Chhûn-chhôn-sṳ	Chuncheon
Thai-pha̍k-sṳ	Taebaek
Po-chû-sṳ	Paju
Phìn-tshe̍t-sṳ	Pyeongtaek
Fà-sàng-sṳ	Hwaseong
Buckingham Kiûng	Buckingham Palace
Hói-nàm	Hainan
Yén-tûng	Ferner Osten
Ngiên-kiu	Forschung
Kâm-suk	Gansu
Pha̍k Se-pâu	Leukozyt
York	York
Tsiú	Ellbogengelenk
Sṳ̂n-min-ki	5. Buch Mose
Sû-chû-sṳ	Suzhou (Jiangsu)
Vûn-chû-sṳ	Wenzhou
Windsor Sàng-páu	Windsor Castle
Hòn-chhu̍k	Han-Chinesen
Nèn-pô-sṳ	Ningbo
Tet-koet-ngìn	Deutsche
Ko-men	Allergie
Fù-khì	Egel
Kîm-yùng	Finanzen
1000	Tausend
Mìn-su-ki	4. Buch Mose
Liu̍k Khiet-vùn	Kevin Rudd
Ngo̍k-ǹg	Echte Krokodile
Yùn-nàm	Yunnan
Vû-â	Raben und Krähen
Plymouth	Plymouth
Sân-tûng	Shandong
Pí	Arm
Derby-sṳ	Derby (Derbyshire)
Thàn-khîn Fa-ha̍p-vu̍t	Kohlenwasserstoffe
Hò-nàm	Henan
Montehermoso	Montehermoso
Liâu-nèn	Liaoning
El Cid	El Cid
Jim Morrison	Jim Morrison
Kóng-khiéu	Hafen
Thòi-vân Thò-yèn Koet-chi Kî-chhòng	Flughafen Taiwan Taoyuan
Kit-lìm	Jilin
Fù-nàm	Hunan
Chhiâng-hói	Qinghai
Vì-ngâ-ngì-tshu̍k	Uiguren
Rhône-sén	Département Rhône
Koet-kâ Kûng-yèn	Nationalpark
Pâ-lì Charles-de-Gaulle Koet-chi Kî-chhòng	Flughafen Paris-Charles-de-Gaulle
Chṳ̂-sán	Aktiva
O-le̍t-liòng	Aurelian
Fù-pet	Hubei
Sân-sî	Shanxi
Hòng-khûng Kûng-sṳ̂	Fluggesellschaft
Hò-khiéu-vân	Ästuar
Chûng-set	Braun
Kui-chû	Guizhou
Berkelland	Berkelland
Chûng-khi Sṳ̀n-kîn Ne-thúng	Zentralnervensystem
Yî-fut-só	Ephesos
Ôn-tha̍t-màn Hói	Andamanensee
Yok-sû-â-ki	Buch Josua
Sî-pet Yîn-kak-làn	North West England
Shám-sî-sén	Shaanxi
Tûng-pet Yîn-kak-làn	North East England
Tûng Midlands	East Midlands
Tûng Yîn-kak-làn	East of England
Tûng-nàm Yîn-kak-làn	South East England
Sî-nàm Yîn-kak-làn	South West England
模板:Commonscat	Vorlage:Commonscat
Sî Midlands	West Midlands (Region)
Yorkshire lâu Humber	Yorkshire and the Humber
Kòn Se-pâu	Stammzelle
Lò-mâ-sû	Brief des Paulus an die Römer
Mâ-liuk-kap Hói-hia̍p	Straße von Malakka
Yù-thai Vòng-koet	Juda (Reich)
Fî-yí Mî-koet Het-ngìn	Afroamerikaner
Mà-sat-chû-set Lî-kûng Ho̍k-yen	Massachusetts Institute of Technology
Pô-sṳ-tun Thai-ho̍k	Boston University
Yâ-lû Thai-ho̍k	Yale University
Nàm-pet-chêu	Südliche und Nördliche Dynastien
Liû-Sùng	Frühere Song-Dynastie
Fûn-lî	Hochzeitsfeier
Pan Chúng-thúng-chṳ	Semipräsidentielles Regierungssystem
Yîm-sàng-khiùn	Eumseong
Thiet-ngièn-khiùn	Cheorwon
Fùng-chhôn-khiùn	Hongcheon
Fà-chhôn-khiùn	Hwacheon
Fî-li̍p-pí-sû	Brief des Paulus an die Philipper
Thiên-koet Pat-fuk	Seligpreisungen
Mî-koet Lièn-pâng Chún-phi Ne-thúng	Federal Reserve System
Kúai-é	Froschlurche
Hâ Sî-lî-sî-â-sén	Woiwodschaft Niederschlesien
Khù-â-vì - Pô-mî-là-nì-â-sén	Woiwodschaft Kujawien-Pommern
Lû-pu-lìm-sén	Woiwodschaft Lublin
Lû-pu-sṳ̂-khà-sén	Woiwodschaft Lebus
Lò-tsṳ-sén	Woiwodschaft Łódź
Séu Pô-làn-sén	Woiwodschaft Kleinpolen
Mâ-tsó-fû-sá-sén	Woiwodschaft Masowien
O-pô-lòi-sén	Woiwodschaft Opole
Khak-ngì-pâ-yèn-sân-sén	Woiwodschaft Karpatenvorland
Pô-tet-là-chhia-sén	Woiwodschaft Podlachien
Pô-mî-là-nì-â-sén	Woiwodschaft Pommern
Sî-lî-sî-â-sén	Woiwodschaft Schlesien
Sṳn-sṳ̍p-sṳ-sén	Woiwodschaft Heiligkreuz
Sî Pô-mî-là-nì-â-sén	Woiwodschaft Westpommern
Pâ-lùn-sî-â-sén	Provinz Valencia
Sat-là-kô-sat-sén	Provinz Saragossa
Vùi-sṳ̂-khà-sén	Provinz Huesca
Baak-gaa-seng	Hundert Familiennamen (Song-Dynastie)
Sok-lî-â-sén	Provinz Soria
Hien-thoi Khì-chhâ	Hyundai Motor Company
Sûng-hâi-khî	Shuangxi (Neu-Taipeh)
Kîm Tsang-ên	Kim Jong-un
Kông-sî	Jiangxi
Wernher von Braun	Wernher von Braun
Nèn-ha	Ningxia
Lí Hién-liùng	Lee Hsien Loong
Kîm-fà-sṳ	Jinhua
Thòi-chû-sṳ	Taizhou (Zhejiang)
Phòng-châ-phú-ngî	Panjabi
Phú-sṳ̍p-thok-ngî	Paschtunische Sprache
Yâ-chû	Wildschwein
Chû-hói-sṳ	Zhuhai
Sân-thèu-sṳ	Shantou
Shâu-kûan-sṳ	Shaoguan
Kông-mùn-sṳ	Jiangmen
Chhám-kông-sṳ	Zhanjiang
Shàu-khin-sṳ	Zhaoqing
Fi-chiu-sṳ	Huizhou
Mòi-chiu-sṳ	Meizhou (Guangdong)
San-mî-sṳ	Shanwei
Hò-ngièn-sṳ	Heyuan
Yòng-kông-sṳ	Yangjiang
Chhîn-yén-sṳ	Qingyuan
Tûng-kôn-sṳ	Dongguan
Chûng-sân-sṳ	Zhongshan
Chhèu-chiu-sṳ	Chaozhou
Thiên-tén-yen	Tiandeng
Liùng-chiu-yen	Longzhou
Nèn-mìn-yen	Ningming
Thai-sîn-yen	Daxin
Mâ-liuk-kap-sṳ	Malakka
Khiâu-chhṳ-sṳ	George Town (Penang)
IPhone 5	IPhone 5
Nàm-Chhî	Südliche Qi-Dynastie
Mèu-li̍t-yen	Landkreis Miaoli
Sṳn-chhôn-lî	Eucharistie
Fuk-chiu-sṳ	Fuzhou
Nàm-phìn-sṳ	Nanping
Phû-thièn-sṳ	Putian
Sâm-mìn-sṳ	Sanming
Tshièn-chiu-sṳ	Quanzhou
Hà-mûn-sṳ	Xiamen
Chông-chiu-sṳ	Zhangzhou
Liùng-ngâm-sṳ	Longyan
Nèn-tet-sṳ	Ningde
Sî-pak-li-â Fú	Sibirischer Tiger
Thiên-ngô-yen	Tian’e
Nàm-tan-yen	Nandan
Fung-sân-yen	Fengshan (Hechi)
Tûng-làn-yen	Donglan
Buren	Buren (Gelderland)
Pat-tet-sṳ	Bade (Taoyuan)
Sîn-chuk-yen	Landkreis Hsinchu
Thông Ngiâ-mong	Adam Schall von Bell
Yáng-chhiong Chín-thôn-ho̍k	Radiologie
Rumia	Rumia
Kluczbork	Kluczbork
La̍p-tsuk	Kerze
Hiet-chiong	Blutplasma
Southampton	Southampton
Lu-tet-ki	Buch Rut
Hâ-sat-khiet-chhu̍k	Kasachen
Yòng-mî	Großlibellen
Kô-lìm-tô-chhièn-sû	1. Brief des Paulus an die Korinther
Sî-pân-ngà Ti-koet	Spanisches Kolonialreich
Pha̍k-yùn-khî (Kóng-chiu-sṳ)	Baiyun
Sṳ-sṳ̂-ki	Buch der Richter
Po-lîn-chhòi	Spinat
Pâ-set-lò-nâ-sén	Provinz Barcelona
Nàm-thèu-yen	Landkreis Nantou
Liuk-piên-hìn	Sechseck
Thòi-pet 101	Taipei 101
Lùn-tûn Thap-khiâu	Tower Bridge
Luì-kûng	Donner
Siù-li Yún-kòn-sien-chhùng	Caenorhabditis elegans
O-pô-lòi	Opole
Sopot	Sopot
Â-sṳ̂-thù-lî-â-sṳ̂-sén Chhṳ̍t-hot-sṳ	Liste der Comarcas und Gemeinden Asturiens
Kám-lám-yù	Olivenöl
Chim-sin-fi	Baptisten
Lie̍t-yî-tha̍t-sén Chhṳ̍t-hot-sṳ	Liste der Gemeinden in der Provinz Lleida
Vú-yî-sân-sṳ	Wuyishan
Set-vì-li-â-sén	Provinz Sevilla
Thap-là-kô-na̍p-sén	Provinz Tarragona
Provence-sén	Provence
Kî-hài Kûng-chhàng	Maschinenbau
Apeldoorn	Apeldoorn
Lìm-pó-ngî	Limburgisch
Khái-ngì-chhái	Kielce
Bytom	Bytom
Ôn-sit-ngit	Sabbat
Khìm-sṳ̂-thok-khok-ngá	Częstochowa
Zabrze	Zabrze
Ôn-sit-ngit-fi	Siebenten-Tags-Adventisten
Jean Michel Jarre	Jean Michel Jarre
Thai Pô-làn Thi-khî Kô-yî-fû	Gorzów Wielkopolski
Là-tô-mê	Radom
Lo̍k-chham-ki-yen	Los Angeles County
Słupsk	Słupsk
Sosnowiec	Sosnowiec
Gliwice	Gliwice
Yo̍k-sṳ̂	Apotheker
Hi-kôn Yì-chhṳ̍t	Transplantation
Pâ-lùn-sî-â-sén Chhṳ̍t-hot-sṳ	Liste der Gemeinden in der Provinz Valencia
Bielsko-Biała	Bielsko-Biała
Rybnik	Rybnik
Tân-fu̍t Se-pâu	Monozyt
Mâ-khó-fuk-yîm	Evangelium nach Markus
Ruda Śląska	Ruda Śląska
Yok-thán-vòng	Jotam
Thò-yèn-yen	Taoyuan
Nò-mí	Klebreis
Kîn-tû-fú	Präfektur Kyōto
Kau-su	Professur
Thai-fán-fú	Präfektur Ōsaka
Fuk-kông-yen	Präfektur Fukuoka
Oi-yèn-yen	Präfektur Ehime
Kô-lìm-tô-heu-sû	2. Brief des Paulus an die Korinther
Khien-mî	Bodybuilding
Port Elizabeth	Port Elizabeth
Kimberley (Nàm-fî)	Kimberley (Südafrika)
Yok-sâ-fap-vòng	Joschafat (Juda)
Thòi-vân Hói-hia̍p	Formosastraße
Sî Khôi-phú-sén	Westkap
Yamaguchi-yen	Präfektur Yamaguchi
Khiâu-chhṳ Sâm-sṳ	Georg III. (Vereinigtes Königreich)
Chûng-koet Thi-fông	Chūgoku
Mî-koet Thu̍k-li̍p Siên-ngièn	Unabhängigkeitserklärung der Vereinigten Staaten
Sâm-tshûng-yen	Präfektur Mie
Yù-mu̍k mìn-chhu̍k	Nomade
Hiông-pak-su	Zedern
Hî-pak-lòi-sû	Brief an die Hebräer
Kâ-lâ-thai-sû	Brief des Paulus an die Galater
Màn-é	Aalartige
Sông-chhèu	Shang-Dynastie
Thai-thúi	Oberschenkel
Pîn-khù-yen	Präfektur Hyōgo
Kiûng-khì-yen	Präfektur Miyazaki
Yùng-pún-yen	Präfektur Kumamoto
Stamford Raffles	Thomas Stamford Raffles
Sha̍m-é	Singzikaden
Tûng Khôi-phú-sén	Ostkap
Fap-koet Hòng-khûng	Air France
Lie̍t-vòng-ki-song	1. Buch der Könige
Kô-lò-sî-sû	Brief des Paulus an die Kolosser
Ngâ-kok-sû	Brief des Jakobus
Yok-hon-yit-sû	1. Brief des Johannes
Fî-li-mùn-sû	Brief des Paulus an Philemon
Thiap-sat-lò-nì-kâ-heu-sû	2. Brief des Paulus an die Thessalonicher
Thiap-sat-lò-nì-kâ-chhièn-sû	1. Brief des Paulus an die Thessalonicher
Pí-tet-chhièn-sû	1. Brief des Petrus
Thì-mô-thai-chhièn-sû	1. Brief des Paulus an Timotheus
Lí Kông-yeu	Lee Kuan Yew
Chṳ̂-kâ-kô Thai-ho̍k	University of Chicago
Tsṳ̂-fo-yen	Präfektur Shiga
Mu-nì-het Kî-chhòng	Flughafen München
Yok-hon-ngi-sû	2. Brief des Johannes
Thì-mô-thai-heu-sû	2. Brief des Paulus an Timotheus
Thì-tô-sû	Brief des Paulus an Titus
Yî-sṳ̂-lâ-ki	Buch Esra
Nì-hî-mí-ki	Nehemia
Pietersburg	Polokwane
Séu Pha̍k-Lù	Seidenreiher
Chhòn-ngiam-phiang	Infektionskrankheit
Kôn-yàm	Hepatitis
Chhûn-chiet	Chinesisches Neujahrsfest
Shinzō Abe	Shinzō Abe
Mpumalanga-sén	Mpumalanga
Pet Khôi-phú-sén	Nordkap (Provinz)
Tó-kîn-yen	Präfektur Shimane
Kông-sân-yen	Präfektur Okayama
Gauteng-sén	Gauteng
Thung-fûng	Gicht
Chông-fa-yen	Landkreis Changhua
Thai-fûn-yen	Präfektur Ōita
Tiâu-tshí-yen	Präfektur Tottori
Nùng-la̍k	Chinesischer Kalender
Kô-tî-yen	Präfektur Kōchi
Pha̍k-hèu	Diphtherie
Exeter	Exeter
Saint Lawrence-hò	Sankt-Lorenz-Strom
Limpopo-sén	Limpopo (Provinz)
Kô-tén Kau-yuk	Höhere Bildung
Sân-tá-kîn	Sandakan
Â-pí	Kota Kinabalu
Ngi̍t-pún thúng-tshṳ sṳ̀-thoi (Thòi-vân)	Taiwan unter japanischer Herrschaft
Phok Kiún-fi	Park Geun-hye
Lévis	Lévis
Thòi-fûng	Taifun
Thòi-nàm-sṳ	Tainan
Laval (Québec)	Laval (Québec)
Charlemagne, Québec	Charlemagne (Québec)
Mâ-lòi Pô-lî-nì-sî-â Ngî-chhu̍k	Malayo-polynesische Sprachen
Fên-yòng-sṳ	Hengyang
Pet-lûn-khî	Beilun
Mân-chiu-tshu̍k	Mandschu
Zambrów	Zambrów
Doetinchem	Doetinchem
Zamość	Zamość
Malbork	Malbork
Mì-chit-fûn-ho̍k	Infinitesimalrechnung
Mì-fûn	Differentialrechnung
Ngo̍k-yòng-sṳ	Yueyang
BP	BP
Sú-thiàu	Pommes frites
Yùn-lìm-yen	Landkreis Yunlin
Kiok-tsṳ́	Zehe (Fuß)
Vî-liâm Â-li̍t-sân-thai (Hò-làn)	Willem-Alexander
Krasnystaw	Krasnystaw
Sî-fù-khî (Hông-chû-sṳ)	Xihu (Hangzhou)
Vì-tô-li-â Kóng	Victoria Harbour
Mâ-nâ-sî-vòng	Manasse (König)
Kî-kîm-fi	Stiftung
A-hîn Kôn-yàm	Hepatitis A
Yù-tsiâm-vong-khî	Yau Tsim Mong
Fûng-sái	Kaki
Tshṳ̍t-tshòng	Mastdarm
Chhṳ-yù Pâng-sén	Freistaat (Provinz)
Tsó-fo-yen	Präfektur Saga
Tet-tó-yen	Präfektur Tokushima
Sî-pân-ngà-ngìn	Kastilier
Fu̍t-chhṳ̂ Khiung-chṳn Sṳ̀n-siong	Magnetresonanztomographie
Hiông-tshon-yen	Präfektur Kagawa
Reading, Berkshire	Reading
Kâ-chû Lî-kûng Ho̍k-yen	California Institute of Technology
Vì-ngì-tshṳ-páu Thai-ho̍k	Julius-Maximilians-Universität Würzburg
Fên-yòng-yen	Hengyang (Kreis)
Êu-kí-lî-tet Kí-hò	Euklidische Geometrie
Si̍t-kuk	Silicon Valley
Barneveld	Barneveld
Khiu Tha̍t-sîn	Thaksin Shinawatra
Thòi-sân-sṳ	Taishan (Jiangmen)
Lièn-phìn-yen	Lianping
Thai Sùn-thâ Khiùn-tó	Große Sundainseln
Elburg	Elburg
Doesburg	Doesburg
Sî-pet-sén	Nordwest (Südafrika)
Sien-thon	Strecke (Geometrie)
Kâ-ngi-yen	Landkreis Chiayi
Vûn-tai	Gemäßigte Zone
Â-kûng	Großeltern
Thai-khi̍t-khièn	Taijiquan
Kiok-khwá	Sprunggelenk
Hò-làn Tâi-thi Sat-khiet-sùn-ngî	Niedersächsisch
Pân-kiêu-é	Turteltaube
Tshòng-khì-yen	Präfektur Nagasaki
Hà-chhèu	Xia-Dynastie
Chû-vì Sṳ̀n-kîn Ne-thúng	Peripheres Nervensystem
Lùn-tûn Thai-ho̍k	Universität London
Kip-sú	Reihe (Mathematik)
Nelspruit	Mbombela
Sâ-là-ye̍t-chû	Sarawak
Â-chû Thai-phìn-yòng Kîn-tsi Ha̍p-tsok Fi-ngi	Asiatisch-Pazifische Wirtschaftsgemeinschaft
Kôan-chiet-yàm	Arthritis
Geldermalsen	Geldermalsen
Ngò-piên Yì-chhu̍k Chhṳ-chhṳ-yen	Ebian
Chûng-la̍k-sṳ	Zhongli
Montauban	Montauban
Chhòng-sâ-sṳ	Changsha
Thai Put-lie̍t-tiên lâu Oi-ngì-làn Lièn-ha̍p Vòng-koet	Vereinigtes Königreich Großbritannien und Irland
Kiok-kiên	Ferse
Kûng-fûn	Zentimeter
Lièn-ha̍p Hòng-khûng	United Airlines
Yen-thèu	Pharynx
Hò-mí	Millimeter
Tsûng-tsang-khî (Thòi-pet-sṳ)	Zhongzheng (Taipeh)
Mì-mí	Mikrometer (Einheit)
Pâ-mâ Yâu-chhu̍k Chhṳ-chhṳ-yen	Bama (Hechi)
Theu-fú	Tofu
Phù-sat	Bodhisattva
Chóng-ló Kau-fi	Presbyterianische Kirchen
Hien-thoi Veloster	Hyundai Veloster
Nai-mí	Nanometer
Berlanga de Duero	Berlanga de Duero
Pâ-chûng-sṳ	Bazhong
Fu̍t-kông-yen	Fogang
Sâ-pâ-chû	Sabah
Nàm-nèn-sṳ	Nanning
Ngâ-li-ôn-ngìn	Arier
Yù-sṳn-mî-thi Koet-kâ Kûng-yèn	Yosemite-Nationalpark
Chhiâng-set	Cyan
Ho̍k-yen	Fakultät (Hochschule)
Kô-hiùng-sṳ	Kaohsiung
Pet-mî Chhṳ-yù Mo-yi Hia̍p-ngi	Nordamerikanisches Freihandelsabkommen
Sû-kak-làn-ngìn	Schotten (Ethnie)
Rustenburg	Rustenburg
Yen-tsong-fui	Konzert (Veranstaltung)
Yù-fu̍t-chû	Johor
Fì-tshu̍k	Hui-Chinesen
Sha̍k-sṳ	Master
Preston, Lancashire	Preston
Sî-tí-kâ-vòng	Zedekia
Sâm-koet	Zeit der Drei Reiche
Chhûn-chhiû Sṳ̀-khì	Zeit der Frühlings- und Herbstannalen
Chan-koet Sṳ̀-khì	Zeit der Streitenden Reiche
Mâ-liuk-kap-chû	Malakka (Bundesstaat)
Pietermaritzburg	Pietermaritzburg
Sú-vón	Handgelenk
Kit-làn-tan-chû	Kelantan
Tshông-tshu̍k	Tibeter
Pîn-sàng-chû	Penang
Blackburn	Blackburn
Chûng-sin Pha̍k-hiet-khiû	Neutrophiler Granulozyt
Pâng-kâ-tó	Bangka
Phìn-chhông-khiùn	Pyeongchang
Thai-koet Koet-chi Hòng-khûng Kûng-sṳ̂	Thai Airways International
Thai Ngi̍t-pún Ti-koet	Japanisches Kaiserreich
Hiûng-nù	Xiongnu
Phit-li̍t-chû	Perak
Lùn-tûn Ti-koet Ho̍k-yen	Imperial College London
Tsen-sàng-sṳ	Zengcheng
Kui-lìm-sṳ	Guilin
Siet-làn-ngô-chû	Selangor
Tui-kok-sien	Diagonale (Geometrie)
Fi-li-phi Liuk-sṳ	Felipe VI.
Kûng-tún	Tonne (Einheit)
Phàng-hên-chû	Pahang
中國象棋	Xiangqi
Pit-sṳn-hak	Pizza Hut
Yim-suk Siáu-tsṳ́	Sonic (Computerspielfigur)
Ngo̍k-vûn-khiet-tshu̍k	Ewenken
Nàm-kîn Thai-thù-sat	Massaker von Nanking
Yún Chṳ-Hau	Yun Chi-ho
Phì-mí	Pikometer
Chûng-koet 2010-ngièn Sông-hói Sṳ-kie Pok-lám-fi	Expo 2010
Ngiù-ngiuk	Rindfleisch
Carlisle, Cumbria	Carlisle
Sandomierz	Sandomierz
Ngit-tèu-kông	Sonnenstrahlung
Khwon-kûan-tsiet	Hüftgelenk
Fûn-kî-hon-khiûn	Mykobakterien
Chàu-yòng-sṳ	Shaoyang
Phìn-tûng-yen	Landkreis Pingtung
Chông-fa-sṳ	Changhua
Hién-mì-kiang	Mikroskop
Chông-phìn-sṳ	Zhangping
Chông-kâ-kie-sṳ	Zhangjiajie
Tsàu-ôn-yen	Zhao’an
Chau-phìn-yen	Zhaoping
Chṳ Sṳ̀n-kûng	Zheng Chenggong
Tsṳn-fò-yen	Zhenghe
Chin-siong-khî	Zhengxiang
Chṳ́n-hói-khî (Nèn-pô-sṳ)	Zhenhai
Tsà-yùng-yen	Zherong
Chûng-fò-khî	Zhonghe
Chûng-kông-yen	Zhongjiang
Chung-sân-yen	Zhongshan (Hezhou)
Tsû-nèn-yen	Zhouning
Chon-hiuk	Zhuanxu
Chu-chû-sṳ	Zhuzhou
Phàng-fù-yen	Landkreis Penghu
Nàm-sâ-khî	Nansha
Kûng-tshun	Dezimeter
McGill Thai-ho̍k	McGill University
Sâm-fòng Ńg-ti	Urkaiser Chinas
Sanok	Sanok
Tsṳ́-kîm-yen	Zijin
Chhṳ-liù-chiáng-khî	Ziliujing
Mâ-tshâ	Streitwagen
Milton Keynes	Milton Keynes
Â-mî-tshu̍k	Amis
Ên-tién	Gnade
Hiong-sàng-khî	Xiangcheng (Zhangzhou)
Hî-lìn-tên-khî	London Borough of Hillingdon
Chṳ̂-hîn-sṳ	Zixing
Chṳ̂-yòng-sṳ	Ziyang
Chṳ̂-ngièn-yen	Ziyuan
Sṳ̀n-chhùng	Imago (Zoologie)
Chang Thien-chṳ́ Fat-sa Kie-son-kî Thôn-chhèn Só-mèu	Positronen-Emissions-Tomographie
Przemyśl	Przemyśl
Chhiòn-khiû Sàng-sṳ	Global City
Pî-mí	Femtometer
Burnley	Burnley
Tûng Lùn-tûn, Tûng Khôi-phú-sén	East London (Ostkap)
Sat-mû-ngí-ki-ha	2. Buch Samuel
Li̍t-thoi-chṳ-ha	2. Buch der Chronik
Lie̍t-vòng-ki-ha	2. Buch der Könige
Biała Podlaska	Biała Podlaska
Mèu-tshu̍k	Miao
Pet-hói-sṳ	Beihai (Guangxi)
Mafikeng	Mahikeng
Mí-sâ-yên Khiùn-tó	Visayas
Lò-pô-ôn-vòng	Rehabeam
Slough	Slough
Thì-mô-thai	Timotheus (Bischof)
Chho̍k-sṳ̂-lia̍p	Centromer
Tûng-hò, Néu-yok-sṳ	East River (New York)
Chhêu-fông-hìn	Hyperwürfel
Sêm-mî-làn-chû	Negeri Sembilan
Brzeg	Brzeg
Fidel Valdez Ramos	Fidel Ramos
Łomża	Łomża
Siong-thâm-sṳ	Xiangtan
Thûng-tshu̍k	Dong (Volk)
Pak-fo Kûng-sṳ̂	Kaufhaus
Thòi-vân Ngièn-tshu-mìn	Indigene Völker Taiwans
騷靈現象	Poltergeist
Tha̍t-vat-ngì-tshu̍k	Daur
Na̍p-sî-tshu̍k	Naxi
Kô-hiùng-yen	Landkreis Kaohsiung
Khiu-lîn	Hügelland
Outaouais	Outaouais
Kuî-é	Schildkröten
Pak-sâ-sat	Bel-šarru-uṣur
Tshièn-pí	Unterarm
Yî-set-lie̍t Vòng-koet	Nordreich Israel
Tshòn-fì Yâ-lu-sat-lâng Yun-thung	Zurück nach Jerusalem
Sîn-sân-sṳ	Johor Bahru
Khiu-kîm-sân Vân	Bucht von San Francisco
Li Mâ-teu	Matteo Ricci
Tshài Yîn-vùn	Tsai Ing-wen
Chełm	Chełm
Pha̍k-ngìn	Europid
Â-ha̍p-vòng	Ahab (König)
Suwałki	Suwałki
Ngì-làn-yen	Landkreis Yilan
Sî-làn-ngî	Seeländisch
Epe	Epe (Niederlande)
Maidenhead	Maidenhead
Chû Khiet-lùn	Jay Chou
Winburg	Winburg
Kiú-liùng	Kowloon
Nâ-pô-nì-tha̍t	Nabonid
Kiap-kông-yen	Jiajiang
Hâ-phú-yen	Xiapu
Ngie-mí-li-ôn Lò-mâ-nok-ngî	Emilianische Sprache
Sîn-pet-sṳ	Neu-Taipeh
Hî-sî-kâ-vòng	Hiskija
Thòi-chûng-sṳ	Taichung
IPhone 4S	IPhone 4s
Jędrzejów	Jędrzejów
Fâ-lièn-yen	Landkreis Hualien
Kîm-mùn-yen	Kinmen
Thòi-tûng-yen	Landkreis Taitung
Sîn-chuk-sṳ	Hsinchu
Kâ-ngi-sṳ	Chiayi
Kî-lùng-sṳ	Keelung
Pet-thèu-khî (Thòi-pet-sṳ)	Beitou
Thai-ôn-khî (Thòi-pet-sṳ)	Da’an (Taipeh)
Sṳ-lìm-khî (Thòi-pet-sṳ)	Shilin (Taipeh)
Busko-Zdrój	Busko-Zdrój
Àu-thai-li-â Ngièn	Australischer Dollar
Thùng-lû-yen	Tonglu
Fuk-tshîn-sṳ	Fuqing
Nyèn-sân-khî	Yanshan (Guilin)
Kroonstad	Kroonstad
Ngo̍k-thòng-khî	Yuetang
Hon-ho̍k	Sinologie
Thai-thùng-khî (Thòi-pet-sṳ)	Datong (Taipeh)
Nàm-kóng-khî (Thòi-pet-sṳ)	Nangang (Taipeh)
Van-fà-khî (Thòi-pet-sṳ)	Wanhua
Vùn-sân-khî (Thòi-pet-sṳ)	Wenshan (Taipeh)
Sin-ngi-khî (Thòi-pet-sṳ)	Xinyi (Taipeh)
Yî-pó-sṳ	Ipoh
Ná-pô-pha-lâ-sâ-ngì	Nabopolassar
Â-pí-ngâ-vòng	Abija
Sûn N̂g	Wu-Dynastie
Pha̍k-chhu̍k	Bai
Pińczów	Pińczów
Aalten	Aalten
Xuxa	Xuxa
Hajnówka	Hajnówka
Phiâng-sân-sîn-khî	Pingshan (Shenzhen)
Chàu-tûng-yen	Shaodong
Lai-phú-yen	Lipu
Lubartów	Lubartów
Hâu-kông-khî	Haojiang
Yòng-sân-yen	Yangshan (Qingyuan)
Kông-mìn-sîn-khî	Guangming
Lucélia Santos	Lucélia Santos
Montréal-tó	Île de Montréal
IPhone 3GS	IPhone 3GS
IPhone 4	IPhone 4
IPhone 3G	IPhone 3G
Alan Dawa Dolma	Alan Dawa Dolma
Tûng-Chìn	Östliche Jin-Dynastie
Tûng-Chû	Östliche Zhou-Dynastie
Mâ-lòi-sî-â Hòng-khûng	Malaysia Airlines
Lì-tshu̍k	Li (Volk)
Chûng-sî-khî (Hiông-kóng)	Central and Western
Mí-nâ-hien-vòng	Menahem
Â-ha̍p-chhia-vòng (Yî-set-lie̍t)	Ahasja (Israel)
Â-ha̍p-chhia-vòng (Yù-thai)	Ahasja (Juda)
Yok-làn-vòng (Yù-thai)	Joram (Juda)
Â-sat-li-ngâ	Asarja
Peter Nalitch	Pjotr Andrejewitsch Nalitsch
Yâ-lò-pô-ôn yit-sṳ	Jerobeam I.
Am-li-vòng	Omri
Nâ-tap-vòng	Nadab (König)
Pâ-sâ-vòng	Bascha
Yâ-fu-vòng	Jehu
Yok-sî-â-vòng	Joschija
Yok-â-sṳ̂-vòng (Yù-thai)	Joas
Sîm-li-vòng	Simri (König)
Yâ-lò-pô-ôn ngi-sṳ	Jerobeam II.
Yî-vi-mí-lò-tha̍t	Amēl-Marduk
Â-mâ-chhia-vòng	Amazja (König)
Yî-sṳ̂-pô-sat-vòng	Isch-Boschet
N̂g Chok-tùng	Goh Chok Tong
Â-sat-vòng	Asa (König)
Â-mùn-vòng	Amon (Juda)
Chong Koet-yùng（Chong Fat-chûng）	Leslie Cheung
Lí Tên-Fî	Lee Teng-hui
Yî-lâ-vòng	Ela
Yok-ngâ-kin-vòng	Jojakim
Hò-se-â-vòng	Hoschea
Yok-ngâ-kîn-vòng	Jojachin
Biłgoraj	Biłgoraj
Chhî Chai-Phit	Philip Jaisohn
Puławy	Puławy
Chuk Hon	Shu Han
Chhâu Ngùi	Wei-Dynastie
Abitibi-Témiscamingue	Abitibi-Témiscamingue
Staszów	Staszów
Mò-tóng-sit	Parteiloser
Iwakuni-sṳ	Iwakuni
Kâu-thûng kûng-khí	Verkehrsmittel
Phok Hièn-yún	Pak Hon-yong
Sat-kâ-li-ngâ-vòng	Secharja
Yok-ha̍p-sṳ̂-vòng	Joahas (Israel)
Fùng Siù-chhiòn	Hong Xiuquan
Yok-â-sṳ̂-vòng (Yî-set-lie̍t)	Joasch (Israel)
Yok-làn-vòng (Yî-set-lie̍t)	Joram (Israel)
Pí-kâ-vòng	Pekach
Sâ-liùng-vòng	Schallum
Pí-kâ-hot-vòng	Pekachja
Khiu Sṳ̀n-thûng	Shing-Tung Yau
Fùng Puk-kím Kiê	Goldfasan
Grajewo	Grajewo
Sat-lâ-tshu̍k	Salar
Yok-ha̍p-sṳ-vòng	Joahas (Juda)
Sîn-tiam-khî	Xindian (Neu-Taipeh)
Łapy	Łapy
Pâ-set-fi	Basler Mission
Chhiâng-pa̍k-kông-khî	Qingbaijiang
Mî-yî-mî-fi	Bischöfliche Methodistenkirche
瑤族	Yao
Thú-sàng-khî	Tucheng (Neu-Taipeh)
Sîn-chông-khî	Xinzhuang
Hagi-sṳ	Hagi (Yamaguchi)
Wong Hi-zi	Wang Xizhi
Meu-nàm-khî	Maonan (Maoming)
Chûng-chhiû-chiet	Mondfest
Nài-lî-kak-li-sâ-ngì	Nergal-šarra-uṣur
Fùng-theu	Adzukibohne
Łuków	Łuków
Łęczna	Łęczna
Świdnik	Świdnik
Pô-sṳ̂ Ti-koet	Achämenidenreich
Nagato-sṳ	Nagato
Sî-lìm-yen	Xilin (Bose)
Mâ-thai-fuk-yîm	Evangelium nach Matthäus
Sṳ̍p-sṳ-ka	Kreuz (Christentum)
Â-chû Hòng-khûng X	AirAsia X
Â-chû Hòng-khûng	AirAsia
Yî-fut-só-sû	Brief des Paulus an die Epheser
Sòng-tet-sṳ	Changde
Yit-yòng-sṳ	Yiyang
Chhim-chû-sṳ	Chenzhou
Tshî Kông-khí	Xu Guangqi
Yî-lò-khén-nok-ngî	Ilocano
Sàng-khî (San-mî-sṳ)	Chengqu
Súi-nèn-sṳ	Suining (Sichuan)
Nui-kông-sṳ	Neijiang
Tha̍t-chû-sṳ	Dazhou
Ngá-ôn-sṳ	Ya’an
Fú-kûa	Bittermelone
Fún-fùng-set	Rosa (Farbe)
Nâ-sat-le̍t	Nazareth
Yî-tshu̍k	Yi (Volk)
Mî-koet Kûng-lî-fi Chhâ-fi	American Board of Commissioners for Foreign Missions
Â-thâ-li-ngâ	Atalja
Augustów	Augustów
Windsor, Berkshire	Windsor (Berkshire)
Kô Khô-kî	Spitzentechnologie
Hí Chṳ̂n-shuk	Heo Jong-suk
Tai Tet-sâng	Hudson Taylor
Hòn Hòn	Han Han
Pet-kóng-tsṳ́n	Beigang (Yunlin)
Tczew	Tczew
Hâ-nì-tshu̍k	Hani
Thòi-nàm-yen	Landkreis Tainan
Fù-chṳ-mìn-sṳ Kî-chhòng	Flughafen Tan-Son-Nhat
Hien-thoi Accent	Hyundai Accent
Hien-thoi Sonata	Hyundai Sonata
Hien-thoi Elantra	Hyundai Elantra
Hien-thoi Equus	Hyundai Equus
Vû-tsṳ-phe̍t-khiet-chhu̍k	Usbeken
Thap-kit-khiet-tshu̍k	Tadschiken
Wal-Mart Kûng-sṳ̂	Walmart
Yùn-tôn yun-son	Cloud Computing
Ńg-sùn-chiet Yun-thung	Pfingstbewegung
Liu̍k-theu	Mungbohne
Chêu-siên-chhu̍k	Koreaner
Khúa-ngì-khiet-tsṳ-tshu̍k	Kirgisen
Burgo de Osma-Ciudad de Osma	El Burgo de Osma-Ciudad de Osma
Sông-hói Ha̍p-tsok Tsû-tsṳt	Shanghaier Organisation für Zusammenarbeit
Yì Kit-chùn	Yu Gil-jun
Reus	Reus
San Esteban de Gormaz	San Esteban de Gormaz
Hien-thoi Santa Fe	Hyundai Santa Fe
Yî-ho̍k-yen	Medizinische Fakultät
Het-mien Phî-lù	Schwarzstirnlöffler
Sṳ̀n-chheu-fi	Assemblies of God
Fâ-tû-khî	Huadu
Sâ-â-nàm	Shah Alam
Kit-lùng-po Koet-chi Kî-chhòng	Flughafen Kuala Lumpur
Ngiu̍k-Sân	Yu Shan
Hōfu-sṳ	Hōfu
Thai-yí-sân	Lantau Island
Starogard Gdański	Starogard Gdański
Het-tsat-tshu̍k	Hezhen
Sîn-chhèu	Xin-Dynastie
Mauricie	Mauricie
Strzelce Opolskie	Strzelce Opolskie
Hò-làn Tâi-thi Sat-khiet-sêm-ngî	Niedersächsische Dialekte in den Niederlanden
Yîn-kô-khî	Yingge
Kâu-thûng	Straßenverkehr
Vû-yìn	Echte Fliegen
Tha̍t-mâ-thai	Dalmatien
Witwatersrand Thai-ho̍k	Witwatersrand-Universität
Edenville	Edenville
Pat-phu-khî	Babu (Hezhou)
Ôn-fa-yen	Anhua
Hà (Sṳ̍p-liuk-koet)	Xia (Königreich)
Sîn-chîn-yen	Xinjin
Mâ-lî-sûn	Robert Morrison (Missionar)
Mùng-sân-yen	Mengshan
Thai-lî-khî	Dali (Taichung)
Fûng-ngièn-sṳ	Fengyuan
Fò-phìn-khî	Heping (Taichung)
Vú-fûng-hiông	Wufeng (Taichung)
Pat-lî-khî	Bali (Neu-Taipeh)
Pán-khièu-khî	Banqiao
Kung-liàu-khî	Gongliao
Kîm-sân-khî	Jinshan (Neu-Taipeh)
Nà-khiéu-khî	Linkou (Neu-Taipeh)
Lù-chû-khî	Luzhou (Neu-Taipeh)
Phiâng-lìm-khî	Pinglin
Phìn-hâi-khî	Pingxi
Lui-fông-khî	Ruifang
Sâm-chhùng-khî	Sanchong
Sâm-hia̍p-khî	Sanxia (Neu-Taipeh)
Sâm-chṳ-khî	Sanzhi
Chhṳ̂m-hâng-khî	Shenkeng
Sa̍k-tàng-khî	Shiding
Sa̍k-mùn-khî	Shimen (Neu-Taipeh)
Su-nà-khî	Shulin
Thai-sân-khî	Taishan (Neu-Taipeh)
Thâm-súi	Tamsui
Van-lî-khî	Wanli (Neu-Taipeh)
Ńg-kú-khî	Wugu
Sip-chṳ-khî	Xizhi
Yún-fò-khî	Yonghe (Neu-Taipeh)
Fû-lùn-pi-ngì-sṳ	Hulun Buir
Ngo̍k-vûn-khiet-tshu̍k Tshṳ-tshṳ-khî	Autonomes Banner der Ewenken
Ǹg-chiu-sṳ	Wuzhou
Fòng-sàng-kóng-sṳ	Fangchenggang
Khîm-chiu-sṳ	Qinzhou
Kui-kóng-sṳ	Guigang
Ngiu̍k-lìm-sṳ	Yulin (Guangxi)
Pak-set-sṳ	Bose (Guangxi)
Fo-chiu-sṳ	Hezhou
Hò-chhṳ̀-sṳ	Hechi
Lòi-pîn-sṳ	Laibin
Fuk-thièn-khî	Futian
Chhùng-chó-sṳ	Chongzuo
Kôn-liâu	Amtsträger
Lùng-fi-yen	Longhui
Thú-kâ-tshu̍k	Tujia
Lai-vân-khî	Liwan (Guangzhou)
Hîn-nèn-khî	Xingning
Siau-sân-khî	Xiaoshan
Fûng-khôi-yen	Fengkai
Dewetsdorp	Dewetsdorp
Sîn-kie	New Territories
Khôi-phìn-sṳ	Kaiping
Tsit-sa̍k-sân Pó-ôn-tshu̍k Tûng-hiông-tshu̍k Sat-lâ-tshu̍k Tshṳ-tshṳ-yen	Jishishan
Mo-yi	Handel
Kô-mìn-khî	Gaoming
Saam-zi-gang	Drei-Zeichen-Klassiker
Thí-lîn-sṳ	Liling
Kędzierzyn-Koźle	Kędzierzyn-Koźle
Kóng-hon-sṳ	Guanghan
Meu-yen	Mao (Ngawa)
Ôn-hiông-yen	Anxiang
Ôn-hâi-yen	Anxi (Quanzhou)
Duiven	Duiven
Yo̍k-ho̍k	Pharmazie
Chhiâng-yòng-khî	Qingyang (Chengdu)
Fi-yòng-khî	Huiyang
Kóng-tó-yen	Präfektur Hiroshima
Thu̍k-liùng-tshu̍k	Derung
IPhone (Thi-yit thoi)	IPhone (Erste Generation)
Ye̍t-nàm-ngî sṳ-mû	Vietnamesische Schrift
Sîn Pâ-pí-lùn Vòng-koet	Neubabylonisches Reich
Fuk-tín-sṳ	Fuding
Fung-sân-sṳ	Fengshan
Khîm-nàm-khî	Qinnan
Thú-ngí-khì-ngî sṳ-mû	Türkische Lateinalphabete
Kien-yòng-sṳ	Jianyang (Nanping)
Shūnan-sṳ	Shūnan
Skarżysko-Kamienna	Skarżysko-Kamienna
Kô-tá-ha̍p-lû-sṳ	Kota Bharu
Sú-chiuk-khiéu-phiang	Hand-Fuß-Mund-Krankheit
Chhṳ̂m-súi-phu-khî	Distrikt Sham Shui Po
Mielec	Mielec
Yùn-siau-yen	Yunxiao
客家	Hakka
Vù-kau-piáng	Fladenbrot
Téu-liuk-sṳ	Douliu
Wejherowo	Wejherowo
Pu-yî-chhu̍k	Bouyei (Volk)
Mí-yi-yen	Miyi
Nâ-po-yen	Napo (Bose)
Ngì-làn-sṳ	Yilan (Taiwan)
Ńg-fù Sṳ̍p-liuk-koet	Sechzehn Reiche
Néu-yok Tû-fi-khî	New York Metropolitan Area
歷峯雧團	Richemont
Ng̀-tshon-sṳ	Wuchuan (Zhanjiang)
Lanaudière	Lanaudière
Thap-lùn-ti-nò-ngî	Tarandíne
Vòng Yún-khin	YC Wang
Lo̍k-chhîn-sṳ	Yueqing
Eu-hói-khî	Ouhai
Mâ-kûng-sṳ	Magong
Sîn-yàng-sṳ	Xinying
Tshu-theu-fú	Stinkender Tofu
Thai-pó-sṳ	Taibao
Sû-o-tsṳ́n	Su’ao
Làn-yí	Lan Yu (Insel)
Mèu-li̍t-sṳ	Miaoli
2009-ngièn sṳ-kie yun-thung-fi	World Games 2009
Nàm-o-hiông	Nan’ao (Yilan)
Thai-ngâ-tshu̍k	Atayal
Thòi-chûng-yen	Landkreis Taichung
Joy	Joy (Band)
Liu̍k-tó-hiông	Lü Dao
Lu̍k-kóng-tsṳ́n	Lukang
Pu-nùng-tshu̍k	Bunun
Liùng-vân-khî	Longwan
Lu̍k-sàng-khî	Lucheng (Wenzhou)
Phìn-yòng-yen	Pingyang
Yún-kâ-yen	Yongjia
Thung-thèu-yen	Dongtou
Ǹg-yèn	Fiskeboller
Chhṳ̀-hâi-sṳ	Cixi (Ningbo)
Thèu-sàng-tsṳ́n	Toucheng
Thai-hâi-tsṳ́n	Daxi (Taoyuan)
Yún-không-sṳ	Yongkang (Tainan)
Kông-sân-tsṳ́n	Gangshan
Phú-chṳ́-sṳ	Puzi
Thòi-vân Ngiùn-hòng	Taiwan Ginkō
Kîm-sàng-tsṳ́n	Jincheng (Kinmen)
Phû-lî-tsṳ́n	Puli (Nantou)
Mâ-hâi	George Leslie Mackay
Mî-nùng-tsṳ́n	Meinong
Theui-waan Thin-get Lin-mang	Taiwanische Solidaritätsunion
Thai-lû-kok Koet-kâ Kûng-yèn	Taroko-Nationalpark
Tûng-kóng-tsṳ́n	Donggang (Pingtung)
Khén-tên Koet-kâ Kûng-yèn	Kenting-Nationalpark
Phìn-fông Kûng-lî	Quadratkilometer
Fâ-lièn-sṳ	Hualien
Shuì-ôn-sṳ	Rui’an
Fung-fa-sṳ	Fenghua
Phìn-tûng-sṳ	Pingtung
Thòi-tûng-sṳ	Taitung
F4	JVKV
Chùng-chṳ́	Zongzi
Mìn-hiùng-hiông	Minxiong
Thòi-pet Tshia̍p-yun	Metro Taipei
Chhòn-yùng Hòng-khûng	EVA Air
Kôn-yîm	Guanyin
Nàm-thèu-sṳ	Nantou
Thòi-vân nàm-tó ngî-ngièn	Formosianische Sprachen
Lìm-pâ Se-pâu	Lymphozyt
Thò-yèn-sṳ	Taoyuan (Bezirk)
Hak-kâ thú-lèu	Tulou
Kô-sîn-shì	Ku (Kaiser)
Jarosław	Jarosław
Tûng-khî (Hiông-kóng)	Eastern District (Hongkong)
Â-chû Thien-sṳ Yû-han Kûng-sṳ̂ (Hiông-kóng)	Asia Television
Gaspésie–Îles-de-la-Madeleine	Gaspésie–Îles-de-la-Madeleine
Pok-lò-yen	Boluo
Ostrowiec Świętokrzyski	Ostrowiec Świętokrzyski
Sa̍k-fûng-khî	Shifeng
Tshiâ-tshu̍k	She
Sîn-kâ-po Koet-li̍p Thai-ho̍k	Nationaluniversität Singapur
Sên-sán	Produktion
Chojnice	Chojnice
Bronckhorst	Bronckhorst
Thi-kip-sṳ	Bezirksfreie Stadt
Mine-sṳ	Mine (Yamaguchi)
Mì-fûn-ho̍k	Differential (Mathematik)
Tûng-hiông-tshu̍k	Dongxiang
Lâ-fú-tshu̍k	Lahu
Włodawa	Włodawa
Starachowice	Starachowice
Stalowa Wola	Stalowa Wola
Chat-ho̍k Pok-sṳ	Ph.D.
Ermelo	Ermelo
Thông-phûng	Echte Bienen
Tshûng-shîn-yen	Präfektur Okinawa
Tshòng-lo̍k-sṳ	Changle
Yí-fù-khî	Yuhu
Sâm-súi-khî	Sanshui
Nàm-thin-sṳ	Nam Định
Montpellier Thai-ho̍k	Universität Montpellier
Końskie	Końskie
Fà-khièu	Auslandschinesen
Kien-nèn-yen	Jianning
Lô-kông-khî	Luogang
Madrid Chhṳ-chhṳ Thai-ho̍k	Autonome Universität Madrid
Tshṳ-tshṳ-chû	Autonomer Bezirk (China)
Medway	Borough of Medway
Pó-ôn-khî	Bao’an
Pet-liù-sṳ	Beiliu
Nysa, Pô-làn	Nysa
Belver de Cinca	Belver de Cinca
Pó-ôn-chhu̍k	Bonan
Culemborg	Culemborg
Kôan-tan-sṳ	Kuantan
Sokółka	Sokółka
Thâu-thông-shì	Yao (Kaiser)
Hikari-sṳ	Hikari
Krosno	Krosno
Kûng-lî	Kilometer
Almarza	Almarza
Abejar	Abejar
Aldealpozo	Aldealpozo
Arcos de Jalón	Arcos de Jalón
Almenar de Soria	Almenar de Soria
Vinuesa	Vinuesa
Shâu-sân-sṳ	Shaoshan
Yù-thòng Tshàm(YAT)	Yau Tong Station
Tai-tshu̍k	Dai (Volk)
Mùn-pâ-tshu̍k	Monba
Kudamatsu-sṳ	Kudamatsu
Kiong-tshu̍k	Qiang
Ngá-tshu̍k	Wa (Ethnie)
Brummen	Brummen
Kûng-yîn	Hektometer
Fû-yûng-sṳ	Seremban
Jasło	Jasło
Â-chhông-chhu̍k	Achang
Bielsk Podlaski	Bielsk Podlaski
Beuningen	Beuningen
Thú-tshu̍k	Tu (Volk)
Kîn-mí	Gigameter
Pân-kap	Guineataube
Súi-tshu̍k	Sui (Volk)
Nyet-láu-tshu̍k	Gelao
Kín-phó-tshu̍k	Jingpo
Lo̍k-pâ-tshu̍k	Lhoba
Li̍t-siuk-tshu̍k	Lisu
Vì-kî Pak-khô Ngî-ngièn Lie̍t-péu	Wikipedia:Sprachen
Siên-pî-chhu̍k	Xianbei
Sanyo-Onoda-sṳ	San’yō-Onoda
Billingham	Billingham
Pin-kông-khî	Binjiang
Pet-khî (Hiông-kóng)	North District (Hongkong)
Mô-nàm-tshu̍k	Maonan
Nu-tshu̍k	Nu (Volk)
Mu̍k-láu-tshu̍k	Mulam
Sî-sûng-pán-na̍p Thài-tshu̍k Tshṳ-tshṳ-chû	Xishuangbanna
Khwûi-tshiâng-khî	Kwai Tsing
Phù-mí-tshu̍k	Primi
Tet-ngo-tshu̍k	De’ang
Tshiên-vân-khî	Tsuen Wan
Pu-lóng-chhu̍k	Blang
Pok-pha̍k-yen	Bobai
Chhîn-sîn-yen	Qingxin
Bracknell Sêm-lìm	Bracknell Forest
Mìn-chú Chin-phu-tóng	Demokratische Fortschrittspartei
Tomaszów Lubelski	Tomaszów Lubelski
Liú-kông-yen	Liujiang
Thiên-hò-khî	Tianhe
Po-thèu-khî	Potou
Hrubieszów	Hrubieszów
Liùng-mùn-yen	Longmen
Hói-tshong-khî	Haicang
Pet Québec Thi-khî	Nord-du-Québec
Montérégie	Montérégie
Druten	Druten
Nàm-hiùng-sṳ	Nanxiong
Tshiùng-thâu Mèu-tshu̍k Tshṳ-tshṳ-yen	Songtao
Chhièn-Liòng	Frühere Liang
Liú-sàng-yen	Liucheng
Sun-tet-khî	Shunde
Dębica	Dębica
Fân-nyî-khî	Panyu
Québec-ngìn Tóng	Parti Québécois
Grahamstown	Grahamstown
Cape Town Thai-ho̍k	Universität Kapstadt
Phìn-lo̍k-yen	Pingle
Kui-phìn-sṳ	Guiping
Sasolburg	Sasolburg
Kûng-nèn-hîn Sú-kî	Dumbphone
Tûng-sân-yen	Dongshan (Zhangzhou)
Hò-thòng-khî	Hetang
Si̍p-mî-khî	Jimei
Ǹg-fûng-khî	Yufeng
Kraśnik	Kraśnik
Dęblin	Dęblin
Radzyń Podlaski	Radzyń Podlaski
Thûn-mùn-khî	Tuen Mun District
Nàm-khî (Hiông-kóng)	Southern District (Hongkong)
Vân-chái-khî	Wan Chai District
Prudnik	Prudnik
Villanueva de Sigena	Villanueva de Sigena
Stockton-on-Tees	Stockton-on-Tees
Kóng-nèn-yen	Guangning
Bultfontein	Bultfontein
Sî-Liòng	Westliche Liang
Wokingham	Wokingham
Fûng-hâi-khî	Fengxi
Kô-lò-sî	Kolossai
Lò-fù-khî	Luohu
Yàm-thièn-khî	Yantian
Khiâm-nàm Pu-yî-tshu̍k Mèu-tshu̍k Tshṳ-tshṳ-chû	Qiannan
Lìm-ha Fì-tshu̍k Tshṳ-tshṳ-chû	Linxia
Liùng-kông-khî	Longgang (Shenzhen)
Middelburg, Tûng Khôi-phú-sén	Middelburg (Ostkap)
Graaff-Reinet	Graaff-Reinet
Orania	Orania
Fu-yòng-sṳ	Fuyang (Hangzhou)
Yì-yâu-sṳ	Yuyao
Â-pa Chhong-chhu̍k Kiông-chhu̍k Chhṳ-chhṳ-chû	Ngawa
Welkom	Welkom
Vú-mîn-yen	Wuming (Nanning)
Hoedspruit	Hoedspruit
Lìm-ôn-sṳ	Lin’an
Hói-tsû-khî	Haizhu
Ye̍t-siù-khî	Yuexiu
Vryheid	Vryheid
Swellendam	Swellendam
Kwun-lò-sṳ	Miluo
Vòng-pu-khî	Huangpu (Guangzhou)
Nàm-hói-khî	Nanhai
Sin-nî-sṳ	Xinyi (Maoming)
Lùng-ôn-yen	Long’an (Nanning)
Tû-kông-yén-sṳ	Dujiangyan
Mâ-sân-yen	Mashan
Sîn-fi-khî	Xinhui
Tshiùng-fa-sṳ	Conghua
Lièn-sân Chong-chhu̍k Yâu-chhu̍k Chhṳ-chhṳ-yen	Lianshan (Qingyuan)
Lo̍k-tshông-sṳ	Lechang
Lièn-chiu-sṳ	Lianzhou
Kô-yêu-sṳ	Gaoyao
Fû-yûng-khî	Furong
Hîn-nèn-sṳ	Xingning (Meizhou)
Ho̍k-sân-sṳ	Heshan
Yòng-chhûn-sṳ	Yangchun
Mo̍k-li̍t Tha̍t-ngá Tha̍t-vat-ngì-tshu̍k Tshṳ-tshṳ-khì	Morin Dawa
Thùng-ôn-khî	Tong’an
Liu̍k-fûng-sṳ	Lufeng (Shanwei)
Thòi-kông-khî	Taijiang (Fuzhou)
Liùng-hói-sṳ	Longhai
Sa̍k-sṳ̂-sṳ	Shishi (Quanzhou)
Siông-ôn-khî	Xiang’an
Mên-hêu-yen	Minhou
Lìm-siong-sṳ	Linxiang (Yueyang)
Liù-yòng-sṳ	Liuyang
Lói-yòng-sṳ	Leiyang
Tsàu-vú-sṳ	Shaowu
Hói-shù-khî	Haishu
Kien-tet-sṳ	Jiande
Phî-yen	Pi (Chengdu)
Sîn-tû-khî	Xindu
Phìn-siông-sṳ	Pingxiang (Chongzuo)
Nî-chiu-sṳ	Yizhou
Tshîn-hói-khî	Chenghai (Shantou)
Yîn-tet-sṳ	Yingde
Sṳ̍p-fong-sṳ	Shifang
Vi	Magen
Tshông-sân-khî	Cangshan (Fuzhou)
Chhông-ǹg-yen	Cangwu
Liùng-hâ	Hummerartige
Kî-nok-tshu̍k	Jino
Chhém-hâi-sṳ	Cenxi
Ngo̍k-lùn-tshùn-tshu̍k	Oroqen
Chhà-lîn-yen	Chaling
Shèn-sàng-khî	Chancheng
Chhòng-sâ-yen	Changsha (Kreis)
Tshòng-thai-yen	Changtai
Tshòng-tin-yen	Changting
Chhòng-chû-khî	Changzhou (Wuzhou)
Tshèu-ôn-yen	Chao’an
Chaudière-Appalaches	Chaudière-Appalaches
Sî-Chû	Westliche Zhou-Dynastie
Liông (Nàm-chhèu)	Liang-Dynastie
Sṳ̀n-Hòn	Cheng Han
Sàng-phu Mèu-chhu̍k Chhṳ-chhṳ-yen	Chengbu
Sàng-siong-khî	Chengxiang
Tshak-kham-khî	Chikan (Zhanjiang)
Sî-Hon	Westliche Han-Dynastie
Chhùng-chû-sṳ	Chongzhou
Christiana (Nàm-fî)	Christiana (Südafrika)
Sùn-ôn-yen	Chun’an
Lí-sàng-khî	Licheng (Quanzhou)
Pet-ngan Thi-khî (Québec)	Côte-Nord
Mí-nàm-kâ-pó-ngìn	Minangkabau
Néu-yok-kóng	New Yorker Hafen
Sî-Chìn	Westliche Jin-Dynastie
Tha̍k-é	Dizi (Instrument)
Tûng-Hon	Östliche Han-Dynastie
Su-nèn-yen	Shouning
Sâ-vân-khî	Shawan (Leshan)
Thûng-chhôn-khî	Tongchuan (Dazhou)
Sṳ-chûng-khî (Lo̍k-Sân-sṳ)	Shizhong (Leshan)
Mâ-piên Yì-chhu̍k Chhṳ-chhṳ-yen	Mabian
Thai-phû-yen	Dabu (Meizhou)
Thai-fa Yâu-chhu̍k Chhṳ-chhṳ-yen	Dahua
Tân-yit kón-lî-khî	Unitary Authority
Kú-thièn-yen	Gutian
Tet-pó-yen	Debao
Tet-fa-yen	Dehua
Tet-khin-yen	Deqing (Zhaoqing)
Fi-sàng-khî	Huicheng
Chiáng-ngân-yen	Jingyan
Fài-si̍p-yen	Huaiji
Khien-vì-yen	Qianwei
Ńg-thûng-khiàu-khî	Wutongqiao
Kông-hói-khî	Jianghai
Khì-yen	Qu (Dazhou)
Sun-khin-khî	Shunqing
Kô-phiàng-khî	Gaoping (Nanchong)
Mu̍k-chhôn-yen	Muchuan
Liú-pet-khî	Liubei
Liú-nàm-khî	Liunan
Thien-pha̍k-yen	Dianbai
Sông-lìm-yen	Shanglin
Thâm-thòng-khî	Tantang
Mòi-yen	Meixian
Chṳ̂-yòng-khî	Ziyang (Yiyang)
Sâm-kông Thûng-chhu̍k Chhṳ-chhṳ-yen	Sanjiang
Na̍p-hâi-khî	Naxi (Luzhou)
Mièn-chuk-sṳ	Mianzhu
Lièn-sàng-yen	Liancheng
Kô-chiu-sṳ	Gaozhou
Khiûng-lôi-sṳ	Qionglai
Si-fi-sṳ	Sihui
Ngièu-phìn-yen	Raoping
Lùi-chiu-sṳ	Leizhou
Sun-tshông-yen	Shunchang
Lò-ngièn-yen	Luoyuan
Phîn-nàm-yen	Pingnan (Ningde)
Phìn-thâm-yen	Pingtan
Nàm-ôn-sṳ	Nan’an (Quanzhou)
Àu-choi Fôn	Sattelstorch
Thia̍p-chhái-khî	Diecai
Ya̍k-sân-khî	Dieshan
Tín-sàng-khî	Dingcheng
Tín-fù-khî	Dinghu
Chhîn-sàng-khî	Qingcheng (Qingyuan)
Tûng-khî (Pan-kî-fâ-sṳ)	Dong (Panzhihua)
Tûng-hîn-sṳ	Dongxing (Fangchenggang)
Tûng-ngièn-yen	Dongyuan
Kî-chhòng	Flughafen
Téu-mùn-khî	Doumen
Liu̍k-chhôn-yen	Luchuan
Tû-ôn Yâu-chhu̍k Chhṳ-chhṳ-yen	Du’an
Tôn-chiu-khî	Duanzhou
Tsen-zi-wun	Tausend-Zeichen-Klassiker
Ha̍p-phû-yen	Hepu
Lî Ngâ-kok	James Legge
Yen	Kreis (China)
Lò-kông-yen	Luojiang (Deyang)
Thèn-yen	Teng (Wuzhou)
Thi-fông Kau-fi	Local churches
Nàm-Yèn	Südliche Yan
Nàm-Liòng	Südliche Liang
Fûng-sun-yen	Fengshun
Siong-sân-yen	Xiangshan (Ningbo)
Ngiûn-chû-khî	Yinzhou (Ningbo)
Kông-pet-khî (Nèn-pô-sṳ)	Jiangbei (Ningbo)
Nèn-hói-yen (Chet-kông-sén)	Ninghai
Kông-kòn-khî	Jianggan
Ngò-mì-sân-sṳ	Emeishan
Siù-yí-khî	Xiuyu
Yún-tshûn-yen	Yongchun
Chàu-yòng-yen	Shaoyang (Kreis)
Sa̍k-kú-khî	Shigu
Tsiau-sàng-khî	Jiaocheng (Ningde)
Sien-yù-yen	Xianyou
Fên-sân-yen	Hengshan (Hengyang)
Yèn-phìn-khî	Yanping
Sîn-lò-khî	Xinluo
Phú-sàng-yen	Pucheng (Nanping)
Sâm-ngièn-khî	Sanyuan (Sanming)
Ngièn-fung-khî	Yanfeng
Hâm-kông-khî	Hanjiang (Putian)
Fûng-tshe̍t-khî	Fengze
Lai-sàng-khî	Licheng (Putian)
Sông-hông-yen	Shanghang
Tshiùng-hâi-yen	Songxi
Fên-nàm-yen	Hengnan
Vú-phìn-yen	Wuping
Fên-tûng-yen	Hengdong
Nàm-tshìn-yen	Nanjing (Zhangzhou)
Khî-tûng-yen	Qidong (Hengyang)
Lù-siung-khî	Lusong
Kâ-vò-yen	Jiahe
Sû-sien-khî	Suxian
Thâu-ngièn-yen	Taoyuan (Changde)
Liùng-fù-khî	Longhu
Sông-chhṳ̍t-yen	Sangzhi
Het-sân-khî	Heshan (Yiyang)
Kông-sàng-khî	Jiangcheng (Yangjiang)
Phûng-kông-khî	Pengjiang
Yòng-sî-yen	Yangxi
Hon-su-yen	Hanshou
Sa̍k-mùn-yen	Shimen
Lìm-lí-yen	Linli
Lìm-vú-yen	Linwu
Kui-yòng-yen	Guiyang (Chenzhou)
Yòng-tûng-yen	Yangdong
Hiông-chû-khî	Xiangzhou (Zhuhai)
Liùng-mâ-thâm-khî	Longmatan
Ngiùn-hói-khî	Yinhai
Vú-siên-yen	Wuxuan
Kóng-nàm-khî (Kui-kóng-sṳ)	Gangnan
Yùng-yen (Chhṳ-kung-sṳ)	Rong (Zigong)
Meu-kóng-khî	Maogang
Kîm-phìn-khî	Jinping (Shantou)
Yùng-yen	Rong (Yulin)
Lû-yen	Lu (Luzhou)
Siong-sân-khî	Xiangshan (Guilin)
Chin-yòng-khî	Jingyang (Deyang)
Ket-sî-yen	Jiexi
Siù-fûng-khî	Xiufeng
Thièn-yòng-yen	Tianyang
Chhìn-sî-yen	Jingxi
Yún-fuk-yen	Yongfu
Thièn-tûng-yen	Tiandong
Kiûng-sàng Yâu-chhu̍k Chhṳ-chhṳ-yen	Gongcheng
Kung-chiáng-khî	Gongjing
Mòi-kông-khî	Meijiang
Hîn-pîn-khî	Xingbin
Siong-khiâu-khî	Xiangqiao
Hîn-ngia̍p-yen	Xingye
Kú-nìn-yen	Gulin
Lìn-yùn-yen	Lingyun
Lò-sàng Mu-láu-chhu̍k Chhṳ-chhṳ-yen	Luocheng
Yàm-piên-yen	Yanbian (Panzhihua)
Lìm-kui-yen	Lingui
Ket-tûng-yen	Jiedong
Sî-khî (Pan-kî-fâ-sṳ)	Xi (Panzhihua)
Kon-yòng-yen	Guanyang
Kîm-sàng-kông-khî	Jinchengjiang
Kóng-héu-khî	Gangkou
Phû-pet-yen	Pubei
Ngiu̍k-chiu-khî	Yuzhou (Yulin)
Yùng-ôn-yen	Rong’an
Lìn-chhôn-yen	Lingchuan (Guilin)
Chhiòn-chiu-yen	Quanzhou (Guilin)
Van-siu-khî	Wanxiu
Khîm-pet-khî	Qinbei
Sîn-fûng-yen	Xinfeng (Shaoguan)
Fò-phìn-yen	Heping (Heyuan)
Sé-kiok-lî	Fußwaschung
Kîm-vân-khî	Jinwan
Liùng-sṳn-kok-chhu̍k Chhṳ-chhṳ-yen	Longsheng
Sîn-sàng-yen	Xincheng (Laibin)
Thiet-sân-kóng-khî	Tieshangang
Siong-chiu-yen	Xiangzhou (Laibin)
Kîm-siu Yâu-chhu̍k Chhṳ-chhṳ-yen	Jinxiu
Lùng-lìn Kok-chhu̍k Chhṳ-chhṳ-yen	Longlin
Chhiâng-siù-khî	Qingxiu
Chhit-sên-khî	Qixing
Thièn-lìm-yen	Tianlin
Liòng-khin-khî	Liangqing
Phìn-nàm-yen	Pingnan (Guigang)
Hói-sàng-khî	Haicheng (Beihai)
Phìn-kó-yen	Pingguo
Yung-nèn-khî	Yongning (Nanning)
Fòng-sàng-khî	Fangcheng (Fangchenggang)
Sông-sṳ̂-yen	Shangsi
Lìn-sân-yen	Lingshan
Lu̍k-tshài-yen	Luzhai
Hîn-ôn-yen	Xing’an (Guilin)
Phû-kông-yen	Pujiang (Chengdu)
Kîm-thòng-yen	Jintang
Vûn-kông-khî	Wenjiang
Phìn-yén-yen	Pingyuan (Meizhou)
Hói-fûng-yen	Haifeng
Lièn-nàm Yâu-chhu̍k Chhṳ-chhṳ-yen	Liannan
Liùng-tshôn-yen	Longchuan (Heyuan)
Liu̍k-hò-yen	Luhe (Shanwei)
Vú-hêu-khî	Wuhou
Liùng-chhièn-yi̍t-khî	Longquanyi
Chiau-liang-yen	Jiaoling
Kông-chiu-khî	Jiangzhou
Yu-kông-khî	Youjiang
Ha̍p-sân-sṳ	Heshan (Laibin)
Kîm-ngiù-khî	Jinniu
Kím-kông-khî	Jinjiang (Chengdu)
Phàng-chû-sṳ	Pengzhou
Kông-tûng-khî (Nèn-pô-sṳ)	Jiangdong
Hâ-sàng-khî	Xiacheng
Kiúng-shú-khî	Gongshu
Yì-hông-khî	Yuhang
Sông-sàng-khî	Shangcheng (Hangzhou)
Lo̍k-ngia̍p-yen	Leye (Bose)
Sân-sî Sṳ-sa	Sơn Tây
Chûng-koet Ngò-lò-sṳ̂-tshu̍k	Russische Minderheit in China
Windsor lâu Maidenhead	Windsor and Maidenhead
Â-ha̍p-sùi-lû-vòng	Ahasveros
Mà-tsông-khî	Mazhang
Ńg-fà-yen	Wuhua (Meizhou)
Súi-hâi-yen	Suixi (Zhanjiang)
Sui-nèn-yen	Suining (Shaoyang)
Tshî-vùn-yen	Xuwen
Fuk-ôn-sṳ	Fu’an
Nàm-àu-yen	Nan’ao
Chîn-sṳ-sṳ	Jinshi (Changde)
Liâm-kông-sṳ	Lianjiang (Zhanjiang)
Mên-tshîn-yen	Minqing
Hâ-sân-khî	Xiashan
Vung-ngièn-yen	Wengyuan
Fa-chiu-sṳ	Huazhou
Kien-eu-sṳ	Jian’ou
Mâ-mî-khî	Mawei
Yún-thai-yen	Yongtai (Fuzhou)
Nèn-hiông-yen	Ningxiang
Liùng-vùn-khî	Longwen
Sṳ-mìn-khî	Siming
Yí-fâ-khî	Yuhua (Changsha)
Ngiên-kông-sṳ	Yuanjiang (Yiyang)
Fi-tûng-yen	Huidong (Huizhou)
Siong-thâm-yen	Xiangtan (Kreis)
Phìn-fò-yen	Pinghe
Thai-nèn-yen	Taining
Kông-tshe̍t-yen	Guangze
Yún-ôn-sṳ	Yong’an
Thí-ngoi Mo̍k-yòng-ha̍p	Extrakorporale Membranoxygenierung
Lìm Tan	Lin Dan
分類:Tet-koet	Kategorie:Deutschland
分類:Yi-thai-li	Kategorie:Italien
分類:Kâ-nâ-thai	Kategorie:Kanada
分類:Sî-pân-ngà	Kategorie:Spanien
分類:Chûng-koet	Kategorie:China
分類:Ngi̍t-pún	Kategorie:Japan
分類:Àu-thai-li-â	Kategorie:Australien
分類:Yin-thu	Kategorie:Indien
分類:Yî-set-lie̍t	Kategorie:Israel
分類:Nàm-fî	Kategorie:Südafrika
Koet-li̍p Thòi-vân Thai-ho̍k Yî-ho̍k-yèn Fu-sat Yî-yèn	National Taiwan University Hospital
Thiên-sái (Hiông-kóng)	The Cullinan
Redcar and Cleveland	Redcar and Cleveland
分類:Yin-thu-nì-sî-â	Kategorie:Indonesien
分類:Pâ-kî-sṳ̂-thán	Kategorie:Pakistan
分類:Pô-làn	Kategorie:Polen
分類:Sîn-kâ-po	Kategorie:Singapur
分類:Hòn-koet	Kategorie:Südkorea
分類:Thai-koet	Kategorie:Thailand
分類:Ye̍t-nàm	Kategorie:Vietnam
分類:Phú-nen-lui	Kategorie:Säugetiere
分類:Tiâu	Kategorie:Vögel
分類:Chhṳ̍t-vu̍t	Kategorie:Pflanzen
分類:Vu̍t-lí-ho̍k	Kategorie:Physik
分類:Chhṳ-yèn Khô-ho̍k	Kategorie:Naturwissenschaft
分類:Sâng-vu̍t-ho̍k	Kategorie:Biologie
分類:Fa-ho̍k	Kategorie:Chemie
分類:Li̍t-sṳ́	Kategorie:Geschichte
分類:Thi-lî	Kategorie:Geographie
分類:Sa-fi	Kategorie:Gesellschaft
分類:Chûng-kau	Kategorie:Religion
分類:Thí-yuk	Kategorie:Sport
分類:Khô-ho̍k	Kategorie:Wissenschaft
分類:Lièn-ha̍p-koet	Kategorie:Vereinte Nationen
分類:Êu-chû Lièn-mèn	Kategorie:Europäische Union
分類:Kien-chuk-vu̍t	Kategorie:Bauwerk
分類:Thûng-sin	Kategorie:Kommunikation
分類:Thi-khiù	Kategorie:Erde
Chhièn-Chhîn	Frühere Qin
Chhièn-Yèn	Frühere Yan
Sî Berkshire	West Berkshire
Hiông-kóng Thiet-lu Yû-han Kûng-sṳ̂	MTR Corporation
Thai-mo-sân	Tai Mo Shan
Heu-Yèn	Spätere Yan
Pet-Liòng	Nördliche Liang
Chhièn-Chhàu	Han-Zhao
Fòng-tshùng	Heuschrecke
Louis Trichardt	Louis Trichardt
Abiego	Abiego
Sî-Chhîn	Westliche Qin
Yî-lien-chióng	Prix Stanislas Julien
Heu-Chhîn	Spätere Qin
Kú Lò-mâ	Römisches Reich
Tsui-heu ke Sṳ́m-phan	Jüngstes Gericht
Greenwich Thai-ho̍k	University of Greenwich
Middelburg, Mpumalanga-sén	Middelburg (Mpumalanga)
Yok-hon-nì-sṳ̂-páu Thai-ho̍k	Universität Johannesburg
Sat-mû-ngí-ki-song	1. Buch Samuel
分類:Chet-ho̍k	Kategorie:Philosophie
分類:Fu̍t-kau	Kategorie:Buddhismus
分類:Kî-tuk-kau	Kategorie:Christentum
分類:Yù-thai-kau	Kategorie:Judentum
Ventersdorp	Ventersdorp
Pet-Yèn	Nördliches Yan-Reich
Ên-tiâu	Adler (Biologie)
Heu-Liòng	Spätere Liang
Heu-Chhàu	Spätere Zhao
Hò-sṳ̂n	Milliliter
Bochotnica	Bochotnica
Trompsburg	Trompsburg
Brandfort	Brandfort
分類:Vùn-fa	Kategorie:Kultur
分類:Ngìn-vùn Khô-ho̍k	Kategorie:Geisteswissenschaft
分類:Tî-sṳt	Kategorie:Wissen
Gurrea de Gállego	Religion auf Kuba
Hiông-kóng Sṳp-thi Kûng-yèn	Hong Kong Wetland Park
Chṳ́-set	Purpur (Farbe)
分類:Yên-yèn	Kategorie:Schauspieler
模板:Userbox	Vorlage:Userbox
Wikipedia:Kón-lî-yèn	Wikipedia:Administratoren
分類:Chûng-fà Mìn-chhu̍k	Kategorie:Ethnie in China
分類:Ngìn-vu̍t	Kategorie:Person
分類:Mìn-chhu̍k	Kategorie:Ethnie
Wikipedia:Hàng-tsṳn-yèn	Wikipedia:Bürokraten
Wikipedia:IP chhà-fûng li-ngoi-chá	Wikipedia:IP-Sperre-Ausnahme
Wikipedia:Kî-hi-ngìn	Wikipedia:Bots
分類:Sṳ̀-kiên	Kategorie:Zeit
分類:Kûng-chhàng	Kategorie:Ingenieurwissenschaft
分類:Yî-ho̍k	Kategorie:Medizin
分類:Chṳn-chṳ	Kategorie:Politik
分類:Kau-yuk	Kategorie:Bildung
分類:Kông-ho̍k	Kategorie:Optik
Âi-khi̍p	Ägypten
分類:Chat-ho̍k-kâ	Kategorie:Philosoph
模板:Bot	Vorlage:Bot
Kâ-nâ-thai	Kanada
分類:Hiûng-ngà-li	Kategorie:Ungarn
分類:Hî-lia̍p	Kategorie:Griechenland
分類:Lâ-thot-vì-â	Kategorie:Lettland
分類:Yù-hi	Kategorie:Spiel
Thiên-koet	Himmel (Religion)
分類:Êu-chû koet-kâ	Kategorie:Staat in Europa
分類:Êu-chû	Kategorie:Europa
模板:Documentation	Vorlage:Dokumentation
Wikipedia:Yung-fu	Hilfe:Benutzer
Pok-sṳ	Doktor
Wikipedia:Sa-khî	Wikipedia:Autorenportal
分類:Wikipedians by language	Kategorie:Benutzer:nach Sprache
Khi-néu Kî-chhòng	Luftfahrt-Drehkreuz
Khî-ngia̍p	Unternehmen
Ngiuk-yèn	Fleischklößchen
模板:Softredirect	Vorlage:Interwiki redirect
模板:Delete	Vorlage:Löschen
分類:Kî-su̍t	Kategorie:Technologie
分類:Ngî-ngièn	Kategorie:Einzelsprache als Thema
Wikipedia:Chhóng-kien Sîn Thiàu-muk	Hilfe:Neuen Artikel anlegen
分類:含有損壞文件鏈接嘅頁面	Kategorie:Wikipedia:Defekter Dateilink
模板:Navbox	Vorlage:Erweiterte Navigationsleiste
Pak-ha̍p-fâ	Lilien
模板:!-	Vorlage:!-
模板:Unicode	Vorlage:Unicode
模板:Smallcaps	Vorlage:Kapitälchen
模板:Nowrap	Vorlage:Nowrap
分類:Fî-chû	Kategorie:Afrika
分類:Chhṳ-yù Pâng-sén	Kategorie:Freistaat (Provinz)
分類:Tûng Khôi-phú-sén	Kategorie:Ostkap
分類:Gauteng-sén	Kategorie:Gauteng
分類:KwaZulu-Natal-sén	Kategorie:KwaZulu-Natal
分類:Mpumalanga-sén	Kategorie:Mpumalanga
分類:Pet Khôi-phú-sén	Kategorie:Nordkap (Provinz)
分類:Sṳn-kîn	Kategorie:Bibel
分類:Limpopo-sén	Kategorie:Limpopo (Provinz)
分類:Sî Khôi-phú-sén	Kategorie:Westkap
分類:Sî-pet-sén	Kategorie:Nordwest (Provinz)
分類:Si	Kategorie:Buchwesen
模板:Pâ-phe̍t	Vorlage:Babel
模板:User ca-1	Vorlage:User ca-1
模板:User de	Vorlage:User de
模板:User de-1	Vorlage:User de-1
模板:User en-3	Vorlage:User en-3
模板:User en-1	Vorlage:User en-1
模板:User en-2	Vorlage:User en-2
模板:User en-4	Vorlage:User en-4
模板:User en-0	Vorlage:User en-0
模板:User en	Vorlage:User en
模板:User de-2	Vorlage:User de-2
模板:User fr-2	Vorlage:User fr-2
模板:User ja-1	Vorlage:User ja-1
模板:User fr	Vorlage:User fr
模板:Location map/Info	Vorlage:Positionskarte/Info
分類:Khûn-chhùng	Kategorie:Insekten
分類:Â-chû	Kategorie:Asien
分類:Chṳ-li	Kategorie:Chile
分類:Sok-lî-â-sén	Kategorie:Provinz Soria
分類:Nàm-mî-chû	Kategorie:Südamerika
分類:Khà-sṳ̂-tì-li-â lâu Lòi-ngong	Kategorie:Kastilien und León
分類:Mâ-lòi-sî-â	Kategorie:Malaysia
分類:Sṳ̍t-phín	Kategorie:Lebensmittel
模板:Mod	Vorlage:Modulo
模板:User es-2	Vorlage:User es-2
模板:Fôn-ngiàng	Vorlage:Willkommen
分類:Thiàu-mi-liau	Kategorie:Würzmittel
分類:Chû-chṳt	Kategorie:Organisationen
分類:Ngî-ngièn-ho̍k	Kategorie:Sprachwissenschaft
模板:ITA	Vorlage:ITA
模板:非洲行政區劃	Vorlage:Navigationsleiste Staaten in Afrika
模板:SVK	Vorlage:SVK
模板:Infobox Country	Vorlage:Infobox Staat
模板:TUR	Vorlage:TUR
分類:User en-4	Kategorie:User en-4
分類:User en	Kategorie:User en
分類:User zh	Kategorie:User zh
分類:User zh-N	Kategorie:User zh-M
分類:User en-2	Kategorie:User en-2
模板:User zh	Vorlage:User zh
模板:Cite web	Vorlage:Cite web
分類:Hòng-khûng	Kategorie:Luftfahrt
分類:Yím-sṳ̍t	Kategorie:Essen und Trinken
模板:Fong-wui	Vorlage:Linkbox Himmelsrichtungen
模板:BS3	Vorlage:BS3
分類:Tsúng-thúng	Kategorie:Staatspräsident
模板:IPA	Vorlage:IPA-Text
分類:Chṳn-chṳ Ngìn-lui	Kategorie:Politiker
分類:Mî-chû	Kategorie:Amerika
模板:其他	Vorlage:Begriffsklärungshinweis
分類:Language user templates	Kategorie:Vorlage:Babel-Sprache
模板:User language-N	Vorlage:Babel field M
Wikipedia:GNU自由文檔協議證書	Wikipedia:GNU Free Documentation License
模板:大洋洲行政區劃	Vorlage:Navigationsleiste Staaten in Australien und Ozeanien
分類:Vùn-ho̍k-kâ	Kategorie:Autor
分類:Kiûn-sṳ	Kategorie:Militärwesen
分類:Thai-ho̍k	Kategorie:Universität
模板:Lang-he	Vorlage:HeS
模板:Both	Vorlage:Booland
分類:Sṳ-kie Pok-lám-fi	Kategorie:Weltausstellung
模板:Documentation subpage	Vorlage:Dokumentation/Dokuseite
分類:Fu̍k-tsông	Kategorie:Buddhistischer Mönch
模板:FIN	Vorlage:FIN
模板:Purge	Vorlage:Purge
模板:Lang-de	Vorlage:DeS
模板:DNK	Vorlage:DNK
模板:Provinces of China	Vorlage:Navigationsleiste Administrative Gliederung Volksrepublik China
模板:Userpage	Vorlage:Wikipedia-Benutzer
模板:DEU	Vorlage:DEU
模板:SWE	Vorlage:SWE
模板:User language-4	Vorlage:Babel field 4
分類:Ye̍t-nàm kî-chhòng	Kategorie:Flughafen in Vietnam
Kiet-tshòng	Colon
分類:Kûng-sṳ̂	Kategorie:Unternehmen
Â-mí	Attometer
模板:User fr-3	Vorlage:User fr-3
模板:JPN	Vorlage:JPN
分類:Thien-nó	Kategorie:Computer
模板:MKD	Vorlage:MKD
模板:LTU	Vorlage:LTU
分類:Sṳ-chhòng	Kategorie:Ökonomischer Markt
Mô-li-ngìn	Māori
模板:Disambig	Vorlage:Begriffsklärung
模板:Tick	Vorlage:Häkchen
分類:Khien-không Khô-ho̍k	Kategorie:Gesundheitswissenschaft
分類:Hàng-thung Thien-fa	Kategorie:Mobiltelefon
模板:User nan	Vorlage:User zh-min-nan
模板:User nan-1	Vorlage:User zh-min-nan-1
模板:GRC	Vorlage:GRC
模板:CZE	Vorlage:CZE
模板:Lang-en	Vorlage:EnS
分類:Chhòn-ngiam-phiang	Kategorie:Infektionskrankheit
分類:Sîn-kau	Kategorie:Protestantismus
模板:GBR	Vorlage:GBR
分類:Sâng-vu̍t	Kategorie:Lebewesen
模板:SVN	Vorlage:SVN
模板:FRA	Vorlage:FRA
模板:Hiông-kóng Hàng-tsṳn Khî-va̍k	Vorlage:Navigationsleiste Distrikte Hongkongs
模板:User pt-2	Vorlage:User pt-2
分類:Kâ-li-sî-â	Kategorie:Galicien
模板:歐洲行政區劃	Vorlage:Navigationsleiste Staaten in Europa
分類:User yue	Kategorie:User zh-yue
分類:User fr	Kategorie:User fr
分類:User ja	Kategorie:User ja
分類:User pt	Kategorie:User pt
分類:User nl-3	Kategorie:User nl-3
分類:User fr-2	Kategorie:User fr-2
分類:User ja-2	Kategorie:User ja-2
分類:User ko-N	Kategorie:User ko-M
分類:User fr-N	Kategorie:User fr-M
分類:Vùn-sṳ	Kategorie:Schrift
分類:Tho-kau	Kategorie:Daoismus
分類:User ca	Kategorie:User ca
分類:User ca-1	Kategorie:User ca-1
分類:User de	Kategorie:User de
分類:User de-2	Kategorie:User de-2
分類:User de-N	Kategorie:User de-M
分類:User en-3	Kategorie:User en-3
分類:User en-N	Kategorie:User en-M
分類:User es	Kategorie:User es
分類:User es-2	Kategorie:User es-2
分類:User es-N	Kategorie:User es-M
分類:Hiông-kóng Thi-lî	Kategorie:Geographie (Hongkong)
模板:Lang-lv	Vorlage:LvS
分類:Yî-set-lie̍t kiûn-vòng	Kategorie:König (Israel)
分類:Kí-hò-ho̍k	Kategorie:Geometrie
模板:Ye̍t-nàm	Vorlage:Navigationsleiste Verwaltungsgliederung Vietnams
分類:User ja-1	Kategorie:User ja-1
分類:User ko	Kategorie:User ko
模板:Lang-vi	Vorlage:ViS
分類:Lièn-ha̍p-koet Pi-sû-chóng	Kategorie:UN-Generalsekretär
分類:Hói-yòng	Kategorie:Meer
模板:LUX	Vorlage:LUX
分類:Thai-yòng-ne	Kategorie:Sonnensystem
分類:Chhîn-su̍k Ne-thúng	Kategorie:Verwandtschaft
分類:Kóng-tûng-sén	Kategorie:Guangdong
分類:Fuk-kian	Kategorie:Fujian
分類:Koet-chi Chû-chṳt	Kategorie:Internationale Organisation
分類:Fat-mìn-kâ	Kategorie:Erfinder
分類:Yím-liau	Kategorie:Getränk
分類:User nan-1	Kategorie:User zh-min-nan-1
分類:User nan-2	Kategorie:User zh-min-nan-2
分類:User nan-3	Kategorie:User zh-min-nan-3
分類:User nan-N	Kategorie:User zh-min-nan-M
分類:Sa-fi Khô-ho̍k	Kategorie:Sozialwissenschaft
分類:Mî-koet Koet-kâ Kûng-yèn	Kategorie:Nationalpark in den Vereinigten Staaten
分類:Kô-tén Kau-yuk	Kategorie:Hochschulsystem
分類:Pâ-lùn-sî-â Chhṳ-chhṳ-khî	Kategorie:Valencianische Gemeinschaft
模板:User ja-2	Vorlage:User ja-2
分類:Thiên-chú-kau	Kategorie:Katholizismus
分類:User yue-N	Kategorie:User zh-yue-M
分類:Yîm-ngo̍k-kâ	Kategorie:Musiker
模板:Lang	Vorlage:Lang
分類:Fa-kâ	Kategorie:Maler
分類:Yin-thu chûng-kau	Kategorie:Religion (Indien)
分類:Ho̍k-su̍t	Kategorie:Akademische Bildung
分類:Ngìn-lui	Kategorie:Menschen
模板:CYP	Vorlage:CYP
分類:Yin-thu Thi-lî	Kategorie:Geographie (Indien)
分類:Sông-ngia̍p	Kategorie:Handel
分類:Fap-koet fòng-ti	Kategorie:Kaiser (Frankreich)
模板:EST	Vorlage:EST
模板:AUT	Vorlage:AUT
分類:Meu-khô	Kategorie:Katzen
分類:Kâ-le̍t-pí-hói	Kategorie:Karibisches Meer
分類:Thòi-vân Thi-lî	Kategorie:Geographie (Taiwan)
模板:User zh-3	Vorlage:User zh-3
模板:User zh-4	Vorlage:User zh-4
分類:Nì-pok Thi-lî	Kategorie:Geographie (Nepal)
分類:Thai-khûng-ngìn	Kategorie:Raumfahrer
分類:Chûng-fà Mìn-tshu̍k Tshṳ-tshṳ-chû	Kategorie:Autonomer Bezirk (China)
分類:Khî-ngia̍p-kâ	Kategorie:Unternehmer
分類:Fî-li̍t-pîn	Kategorie:Philippinen
分類:User nl	Kategorie:User nl
分類:User zh-1	Kategorie:User zh-1
分類:User zh-4	Kategorie:User zh-4
分類:User zh-3	Kategorie:User zh-3
分類:User zh-2	Kategorie:User zh-2
分類:Ho̍k-vi	Kategorie:Akademischer Grad
分類:Kîm-yùng	Kategorie:Finanzierung
分類:Thien-sṳ	Kategorie:Fernsehen
分類:Chhòn-kau-sṳ	Kategorie:Missionar
分類:Hói-hia̍p	Kategorie:Meerenge
粵語	Kantonesische Sprache
分類:Yin-Êu Ngî-ne	Kategorie:Indogermanische Sprachen
分類:Kî-chhòng	Kategorie:Flughafen
分類:Fa-ho̍k ngièn-su	Kategorie:Chemisches Element
分類:Khô-ho̍k-kâ	Kategorie:Wissenschaftler
分類:Pâ-kî-sṳ̂-thán Thi-lî	Kategorie:Geographie (Pakistan)
分類:Kî-tuk-kau lî-ngì	Kategorie:Liturgie
分類:Nì-pok	Kategorie:Nepal
分類:Thòi-vân	Kategorie:Taiwan
分類:Chûng-koet chhèu-thoi	Kategorie:Chinesische Dynastie
分類:Pet-mî-chû koet-kâ	Kategorie:Staat in Nordamerika
分類:Sṳ-tshòi	Kategorie:Gemüse
分類:Súi-kó	Kategorie:Obst
分類:Khiu-yok Sṳn-kîn	Kategorie:Altes Testament
分類:Pok-vu̍t-kón	Kategorie:Museum
分類:Hì-hèu	Kategorie:Klima
分類:Â-chû Thi-lî	Kategorie:Geographie (Asien)
分類:Ngìn-lui-ho̍k	Kategorie:Anthropologie
分類:Thai-khûng Chhàm	Kategorie:Raumstation
分類:Fap-koet Thai-ho̍k	Kategorie:Universität in Frankreich
模板:ESP	Vorlage:ESP
分類:Thung-vu̍t	Kategorie:Vielzellige Tiere
分類:Chit-chhûi Thung-vu̍t	Kategorie:Wirbeltiere
分類:Ngî-yîm-ho̍k	Kategorie:Phonetik
分類:Hòng-khûng Kûng-sṳ̂	Kategorie:Fluggesellschaft
分類:Ngìn-khièn	Kategorie:Menschenrechte
分類:Ngo̍k-hi	Kategorie:Musikinstrument
分類:Ngî-ne	Kategorie:Sprache nach Sprachfamilie
分類:Hon-sṳ	Kategorie:Chinesische Schrift
分類:Pó-sa̍k	Kategorie:Schmuckstein
分類:Koet-kâ Kûng-yèn	Kategorie:Nationalpark
分類:Hi-siong-ho̍k	Kategorie:Meteorologie
分類:Chûng-mî-chû	Kategorie:Mittelamerika
分類:Fî-kîm-su̍k	Kategorie:Nichtmetall
分類:Hiông-kóng	Kategorie:Hongkong
分類:Kóng-sî-sén	Kategorie:Guangxi
分類:Yên-liau	Kategorie:Brennstoff
分類:Sông-hói	Kategorie:Shanghai
分類:Sin-sit kî-su̍t	Kategorie:Informationstechnik
分類:Ngiuk-lui	Kategorie:Fleisch
分類:Yo̍k-ho̍k	Kategorie:Pharmazie
分類:Sú-tû	Kategorie:Hauptstadt
分類:Nàm-Â	Kategorie:Südasien
分類:Kham-thap-pu-lî-â	Kategorie:Kantabrien
分類:Â-sṳ̂-thù-lî-â-sṳ̂-sén	Kategorie:Asturien
分類:Kîm-su̍k	Kategorie:Metall
分類:Thòi-pet-sṳ	Kategorie:Taipeh
分類:Lò-màn Ngî-chhu̍k	Kategorie:Romanische Sprachen
分類:Kâu-thûng	Kategorie:Verkehrswesen
分類:Ngiên-kiu	Kategorie:Forschung
分類:Thông-lui	Kategorie:Kohlenhydrat
分類:Fòng-ti	Kategorie:Kaiser
分類:Nàm-tó ngî-hì	Kategorie:Austronesische Sprachen
分類:Pet-mî-chû	Kategorie:Nordamerika
分類:Kô-sú	Kategorie:Sänger
分類:Si-chhòng	Kategorie:Tibet
分類:Sú-ho̍k-kâ	Kategorie:Mathematiker
分類:Vu̍t-lî ho̍k-kâ	Kategorie:Physiker
分類:Kîn-chi ho̍k-kâ	Kategorie:Ökonom
分類:Mìn-tsú	Kategorie:Demokratie
分類:Kî-tuk-kau Li̍t-sṳ́	Kategorie:Christentumsgeschichte
分類:Àu-mûn	Kategorie:Macau
分類:Thòi-vân Koet-kâ Kûng-yèn	Kategorie:Nationalpark in Taiwan
分類:Khiù-lui Yun-thung	Kategorie:Ballspiel
分類:Ngiùn-hòng	Kategorie:Kreditinstitut
Fu̍k-vu	Dienstleistung
分類:Chûng-fà Ngìn-mìn Khiung-fò-koet	Kategorie:Volksrepublik China
分類:Kâ-thai-lò-nì-â	Kategorie:Katalonien
分類:Khien-không	Kategorie:Gesundheit
模板:Lang-pl	Vorlage:PlS
Trojany	Trojany (Woiwodschaft Masowien)
分類:Pâ-pí-lùn-ngìn	Kategorie:Babylonier
分類:Â-chû koet-kâ	Kategorie:Staat in Asien
分類:Mî-chû koet-kâ	Kategorie:Staat in Amerika
模板:Chûng-fà Mìn-chhu̍k	Vorlage:Navigationsleiste Anerkannte Nationalitäten der Volksrepublik China
模板:User nan-2	Vorlage:User zh-min-nan-2
模板:MLT	Vorlage:MLT
分類:Kûng-yèn	Kategorie:Parkanlage
分類:Thòi-vân Ngiùn-hòng	Kategorie:Kreditinstitut (Taiwan)
分類:Sùn-fàn Hì-thúng	Kategorie:Kreislaufsystem
分類:Si-chhòng Thi-lî	Kategorie:Geographie (Tibet)
分類:Nui-mùng-kú Tshṳ-tshṳ-khî	Kategorie:Innere Mongolei
分類:Koet-tsi kîn-tsi tsû-tsṳt	Kategorie:Internationale Wirtschaftsorganisation
分類:Lâ-tên Mî-chû	Kategorie:Lateinamerika
分類:Chûng-fà Mìn-koet	Kategorie:Republik China
分類:Siak-khiet-kau	Kategorie:Sikhismus
分類:Sa-fi Mìn-tsú Tsú-ngi	Kategorie:Sozialdemokratie
模板:BEL	Vorlage:BEL
分類:Kú-thoi chhu̍k-khiùn	Kategorie:Person nach historischer Ethnie
分類:Vùi-sṳ̂-khà-sén	Kategorie:Provinz Huesca
分類:Thap-là-kô-na̍p-sén	Kategorie:Provinz Tarragona
分類:Pâ-set-lò-nâ-sén	Kategorie:Provinz Barcelona
分類:Pâ-lùn-sî-â-sén	Kategorie:Provinz Valencia
分類:Chûng-kau-ho̍k	Kategorie:Religionswissenschaft
分類:Thò-yèn-yen	Kategorie:Taoyuan
分類:Thien-fa	Kategorie:Telefonie
模板:TPE	Vorlage:TPE
分類:Â-là-kung	Kategorie:Aragonien
分類:User cdo	Kategorie:User cdo
分類:User zh-min-dong-N	Kategorie:User cdo-M
分類:Tseu-mìn	Kategorie:Beleuchtung
模板:Chûng-fà Mìn-koet Hàng-chṳn Khî-va̍k	Vorlage:Navigationsleiste Verwaltungsgliederung der Republik China
分類:Lie̍t-yî-tha̍t-sén	Kategorie:Provinz Lleida
甲型流感病毒H7N9亞型	Vogelgrippe H7N9
分類:Sat-là-kô-sat-sén	Kategorie:Provinz Saragossa
模板:HUN	Vorlage:HUN
Â-phô	Großmutter
模板:Yin-thu-nì-sî-â	Vorlage:Navigationsleiste Indonesische Provinzen
模板:Kóng-sî Hàng-chṳn Khî-va̍k	Vorlage:Navigationsleiste Bezirksebene Guangxis
分類:User en-1	Kategorie:User en-1
分類:User de-1	Kategorie:User de-1
Li̍t-thoi-chṳ-song	1. Buch der Chronik
模板:Thòi-pet-sṳ	Vorlage:Navigationsleiste Stadtteile von Taipeh
Liû-khiû Khiùn-tó	Ryūkyū-Inseln
模板:User ru-3	Vorlage:User ru-3
模板:User nl-3	Vorlage:User nl-3
2013-ngièn Lù-sân Thi-chṳ́n	Erdbeben in Sichuan 2013
Yòng-ya̍p-é	Tagfalter
Ngiên-kiu-só	Graduate School
模板:Ping	Vorlage:Antwort
IPhone 5S	IPhone 5s
IPhone 5C	IPhone 5c
Sûng-kú Lô-siên	Doppelhelix
Yun Hyon-seok	Yun Hyon-seok
特殊:最近更改	Spezial:Letzte Änderungen
模組:HtmlBuilder	Modul:HtmlBuilder
馬來西亞航空17號班機空難	Malaysia-Airlines-Flug 17
Khóa Vùn-chet	Ko Wen-je
