អាហ្វ្រិក	Afrika
ជប៉ុន	Japan
អង់គ្លេស	England
ស្កុតឡែន	Schottland
វ៉ែល	Wales
អៀរឡង់ខាងជើង	Nordirland
សាធារណរដ្ឋអៀរឡង់	Irland
ប្រទេសហុងគ្រី	Ungarn
អេស្ប៉ាញ	Spanien
សហរដ្ឋអាមេរិក	Vereinigte Staaten
ផែនដី	Erde
ប៊ឺណឺស លី	Tim Berners-Lee
ស៊ុយអែត	Schweden
ប្រទេសប៉ូឡូញ	Polen
អ៊ីតាលី	Italien
ព័រទុយហ្គាល់	Portugal
អឺរ៉ុប	Europa
អាស៊ី	Asien
វិគីភីឌា	Wikipedia
ភីអេចភី	PHP
ទីក្រុងញូវយ៉ក	New York City
កុំព្យូទ័រ	Computer
អ៊ីនធើណេត	Internet
បារ៉ាក់ អូបាម៉ា	Barack Obama
ប៉ារីស	Paris
អាប្រាហាម លីនខូន	Abraham Lincoln
ប្រព័ន្ធប្រតិបត្តការ Android	Android (Betriebssystem)
Google ស្វែងរក	Google Inc.
ម៉ិកស៊ិក	Mexiko
មហាសមុទ្រអាត្លង់ទិក	Atlantischer Ozean
មហាសមុទ្រប៉ាស៊ីហ្វិក	Pazifischer Ozean
ថ្ងៃច័ន្ទ	Montag
ខែមករា	Januar
ខែកុម្ភៈ	Februar
ខែមីនា	März
ភពអង្គារ	Mars (Planet)
ខែមេសា	April
ខែឧសភា	Mai
ខែមិថុនា	Juni
ខែកក្កដា	Juli
ខែសីហា	August
ខែកញ្ញា	September
ខែតុលា	Oktober
ខែវិច្ឆិកា	November
ខែធ្នូ	Dezember
អង្គារ	Dienstag
ថ្ងៃពុធ	Mittwoch
ថ្ងៃព្រហស្បតិ៍	Donnerstag
ថ្ងៃសុក្រ	Freitag
ថ្ងៃសៅរ៍	Samstag
ថ្ងៃអាទិត្យ	Sonntag
សេះ (​អុក​)	Springer (Schach)
បារាំង	Frankreich
សត្វឆ្កែ	Haushund
រាជាណាចក្ររួម	Vereinigtes Königreich
ឆ្មា	Hauskatze
ភាសាបារាំង	Französische Sprache
ប្រេស៊ីល	Brasilien
រុស្ស៊ី	Russland
ការ៉េ	Quadrat
សមុទ្រ	Meer
អាល្លឺម៉ង់	Deutschland
ភាសាអាល្លឺម៉ង់	Deutsche Sprache
ប្រទេសអាយឡែន	Island
ភពសៅរ៍	Saturn (Planet)
១ (លេខ)	Eins
២ (លេខ)	Zwei
៣ (លេខ)	Drei
៥	Fünf
ចតុកោណកែង	Rechteck
មុំកែង	Rechter Winkel
អ៊ុយក្រែន	Ukraine
ទីក្រុងរ៉ូម	Rom
អាល់បានី	Albanien
អាស៊ែបៃហ្សង់	Aserbaidschan
អង់ដូរ៉ា	Andorra
សាធារណរដ្ឋកាហ្សាក់ស្ថាន	Kasachstan
បុរីវ៉ាទីកង់	Vatikanstadt
គុយបា	Kuba
ឥណ្ឌូនេស៊ី	Indonesien
អាហ្វ្រិកខាងត្បូង	Südafrika
ប្រវត្តិសង្ខេប ក្រុមតន្រ្តី រ៉ុក linkin park	Linkin Park
ប្រទេសអាល់ហ្សេរី	Algerien
ស្រា	Wein
ទឹក	Wasser
ទូរទស្សន៏	Fernsehen
ភាសាអាយឡែន	Isländische Sprache
ឈីលី	Chile
ព្រះយេស៊ូវ គ្រីស្ទ	Jesus Christus
ភពពុធ	Merkur (Planet)
ប្រវត្តិសាស្ត្រ	Geschichte
ភពសុក្រ	Venus (Planet)
ភាសា	Sprache
ភពព្រហស្បតិ៍	Jupiter (Planet)
ភពអ៊ុយរ៉ានុស	Uranus (Planet)
វិគីភីឌាភាសាអង់គ្លេស	Englischsprachige Wikipedia
ភពណិបទូន	Neptun (Planet)
សិង្ហបុរី	Singapur
ភ្លុយតុង	Pluto
ហ្វេសប៊ុក	Facebook
សង្គ្រាមលោកលើកទីមួយ	Erster Weltkrieg
សង្គ្រាមលោកលើកទី២	Zweiter Weltkrieg
ទំព័រគំរូ:Corruption	Korruption
Ubuntu	Ubuntu
លីនុច	Linux
គណិតវិទ្យា	Mathematik
បារ៉ែន	Bahrain
ព្រះចន្ទ	Mond
អូស្ត្រាលី	Australien
រូបវិទ្យា	Physik
ជីវវិទ្យា	Biologie
កូរ៉េខាងជើង	Nordkorea
ព្រះរាជាណាចក្រកម្ពុជា	Kambodscha
ឌីណូស័រ	Dinosaurier
សាសនាឥស្លាម	Islam
សេរីភាព	Frieden
សហភាពអឺរ៉ុប	Europäische Union
ណាប៉ូលេអុងបូណាប៉ារត៍	Napoleon Bonaparte
ព្រះអាទិត្យ	Sonne
ឆ្នាំពន្លឺ	Lichtjahr
អូសេអានី	Ozeanien
ប្រព័ន្ធព្រះអាទិត្យ	Sonnensystem
អុីដ្រូសែន	Wasserstoff
ទីម័រខាងកើត	Osttimor
ម៉ុង ប្លុង	Mont Blanc
សឺរេស	(1) Ceres
អៀរីស	(136199) Eris
ភព	Planet
តន្ត្រី	Musik
ភាសាអ៊ីតាលី	Italienische Sprache
អាលុយមីញ៉ូម	Aluminium
នូវែលសេឡង់	Neuseeland
ឥណ្ឌា	Indien
អង់ដ្រេ ម៉ារី អំពែរ	André-Marie Ampère
វីលីម ហ្សេកស្ពែរ	William Shakespeare
ប៉ាឡាវ	Palau
ម៉ុងហ្គោលី	Mongolei
ជេនហ្គិស ខាន់	Dschingis Khan
កូឡុំប៊ី	Kolumbien
ព្រះពុទ្ធសាសនា	Buddhismus
ហ្គាតេម៉ាឡា	Guatemala
មហាសមុទ្រអាកទិក	Arktischer Ozean
អ៊ីរ៉ង់	Iran
ភាសាប៉ូឡូញ	Polnische Sprache
ហ្សកដង់	Jordanien
កៀហ៊្សីស៊ីស្ថាន	Kirgisistan
គុយវ៉ែត	Kuwait
ឡាវ	Laos
លីបង់	Libanon
ទ្វីបអាមេរិក	Amerika
ម៉ាឡេស៊ី	Malaysia
មីយ៉ាន់ម៉ា	Myanmar
នេប៉ាល់	Nepal
ប៉ាគីស្ថាន	Pakistan
MySQL	MySQL
អារ៉ាប៊ីសាអូឌីត	Saudi-Arabien
ស្រីលង្កា	Sri Lanka
ផ្លាតូ	Platon
តាជីគីស្ថាន	Tadschikistan
YouTube	YouTube
អារីស្តូត	Aristoteles
ថៃ	Thailand
វិទ្យុ	Hörfunk
តួរមិនីស្ថាន	Turkmenistan
វៀតណាម	Vietnam
កូរ៉េខាងត្បូង	Südkorea
សាធារណរដ្ឋឥស្លាមអាហ្វហ្កានីស្ថាន	Afghanistan
ព្រែកជីកស៊ុយអែស	Sueskanal
បង់ក្លាដែស្ស	Bangladesch
សូក្រាត	Sokrates
ធ្វិតថឺរ	Twitter
ប៊្រុយណេ	Brunei
ហ្វីលីពីន	Philippinen
អ៊ីសាក់ ញូតុន	Isaac Newton
OpenStreetMap	OpenStreetMap
អាល់បឺត អែងស្តែង	Albert Einstein
ប្រទេសហ្សំប៊ី	Sambia
ប៉េកាំង	Peking
មហាត្មះគន្ធី	Mohandas Karamchand Gandhi
ឆាលែស ដាវីន	Charles Darwin
ជូលីស៍ សេសារ	Gaius Iulius Caesar
ឥន្ទធនូ	Regenbogen
អង្គការសហប្រជាជាតិ	Vereinte Nationen
ភូមិវិទ្យា	Geographie
ទីក្រុងប្រាក	Prag
បន្ទុកអគ្គីសនី	Elektrische Ladung
ខេត្តជើងភ្នំ (ប្រទេសអ៊ីតាលី)	Piemont
មហាសមុទ្រឥណ្ឌា	Indischer Ozean
អូសាម៉ា ប៊ីន ឡាឌែន	Osama bin Laden
ភាសាអេស្ប៉ាញ	Spanische Sprache
ភីឡាដេលផ្យា	Philadelphia
ញូវយ៉ក	New York (Bundesstaat)
វ្លាឌីមៀរ អ៊ីលីច លេនីន	Wladimir Iljitsch Lenin
អូហ្គុសទុស	Augustus
លោកកៃយុសសេសារ	Caligula
ត្រាហ្សាន	Trajan
Kde	KDE
កូរ៉ាស៊ូន អាគីណូ	Corazon Aquino
ទីក្រុងតូខ្យូ	Präfektur Tokio
ហ្វឺឌីណាន់ដ៏ ម៉ាហ្សេឡង់	Ferdinand Magellan
ស៊ីសេរ៉ូ	Marcus Tullius Cicero
ភ្នំពេញ	Phnom Penh
ទីក្រុងព្រៃនគរ	Ho-Chi-Minh-Stadt
ទីក្រុងហានូយ	Hanoi
គ្រិស្តសាសនា	Wahre Jesus-Kirche
ភាសាអង់គ្លេស	Englische Sprache
គូឡាឡាំពួ	Kuala Lumpur
២០០១	2001
JavaScript	JavaScript
HTML5	HTML5
ល្បឿនពន្លឺ	Lichtgeschwindigkeit
JPEG	JPEG
អេឡិចត្រុង	Elektron
ចក្រភព រ៉ូម	Römische Kaiserzeit
Microsoft	Microsoft
គីមីវិទ្យា	Chemie
ស៊ីទ្រុងជ្រូក	C-Sharp
បេណេឌីកទី១៦	Benedikt XVI.
៧ កក្កដា	7. Juli
បាល់ទាត់	Fußball
ទីក្រុងបូកូតា	Bogotá
ថ្ងៃទី៣១ខែធ្នូ	31. Dezember
រិសថា	(4) Vesta
ស៊ីដនីយ៏	Sydney
ភ្លើង	Feuer
ខ្យល់	Erdatmosphäre
កោះស៊ូម៉ាត្រា	Sumatra
ចាការតា	Jakarta
ចំណាត់ថ្នាក់ក្រុម:Wikipedia templates	Kategorie:Vorlage:
កោះជ្វា	Java (Insel)
ចំណាត់ថ្នាក់ក្រុម:ចំណាត់ថ្នាក់ក្រុមនៃទំព័រគំរូវិគីភីឌា	Kategorie:Vorlage:nach Artikelthema
កាលីម៉ាន់តាន់	Kalimantan
ខេត្តបន្ទាយមានជ័យ	Banteay Meanchey
វិគីភីឌា:ប្រអប់ខ្សាច់	Wikipedia:Spielwiese
អាកាសយានដ្ឋាន ដុង ហ៊យ	Flughafen Dong Hoi
អាន់ ហ្វ្រែង	Anne Frank
ខុង ជឺ	Konfuzius
ម៉ារីលីន ម៉ុនរ៉ូ	Marilyn Monroe
ចំណាត់ថ្នាក់ក្រុម:គណិតវិទ្យា	Kategorie:Mathematik
ចំណាត់ថ្នាក់ក្រុម:ប្រវត្តិសាស្ត្រខ្មែរ	Kategorie:Kambodschanische Geschichte
ចំណាត់ថ្នាក់ក្រុម:ប្រវត្តិសាស្រ្តសិង្ហបុរី	Kategorie:Geschichte (Singapur)
សមុទ្រ មេឌីទែរ៉ានេ	Mittelmeer
វីនដូអេច	Microsoft Windows 8
ទំព័រគំរូ:ប្រទេសនៅទ្វីបអាស៊ី	Vorlage:Navigationsleiste Staaten in Asien
ទំព័រគំរូ:Agree	Vorlage:Pro
ទន្លេហ្គារ៉ូន	Garonne
ស៊ីតថល	Seattle
ជញ្ជាំង ប៊ែរឡាំង	Berliner Mauer
ស្រូវ	Reis
ទំព័រគំរូ:Lang-tr	Vorlage:TrS
ទំព័រគំរូ:ផតថល	Vorlage:Portal
ប៊ីល ហ្គេត	Bill Gates
ភាសាជប៉ុន	Japanische Sprache
ប្រជុំវីជ្ជា	Enzyklopädie
ឌីវីឌី	DVD
ទំព័រដើម	Wikipedia:Hauptseite
Central processing unit	Hauptprozessor
រេស៊ីស្ទ័រ	Widerstand (Bauelement)
កីឡាអូឡាំពិក	Olympische Spiele
សមុទ្រ កាសព្យែន	Kaspisches Meer
ឈី ហ្គីវ៉ារ៉ា	Che Guevara
ទីក្រុងកាបូល	Kabul
ហ្គ្រាប្រីអ៊ែល ហ្រ្គារ៉ាស្សៀ ម៉ារ៉ាហ្គេស	Gabriel García Márquez
ទស្សនវិជ្ជា	Philosophie
ចំណាត់ថ្នាក់ក្រុម:លុប	Kategorie:Wikipedia:Schnelllöschen
លិទ្ធិកុម្មុយនិស្ត	Kommunismus
ហ៊ីលឡារី រូដហេម គ្លីនតុន	Hillary Clinton
Boeing 737	Boeing 737
អាហារនៅប្រទេសបារំាង និង របៀបធ្វើ	Französische Küche
មណ្ឌលម៉ាញេតូ	Magnetosphäre
UTC+7	UTC+7
ភាសាកាតាឡាន	Katalanische Sprache
បណ្ណាល័យ	Bibliothek
នីល ហេនរីក ដេវីដ ប៊័រ	Niels Bohr
និវេសនវិទ្យា	Ökologie
ក្លឹបបាល់ទាត់បារសេឡូណា	FC Barcelona
នយោបាយ	Politik
ធនាគារពិភពលោក	Weltbank
ប្រជាធិបតេយ្យ	Demokratie
អង្គការសន្ធិសញ្ញាអាត្លង់ទិកខាងជើង	NATO
ម៉ារី ស្កូដូស្កា គុយរី	Marie Curie
រង្វាន់ណូបែល	Nobelpreis
មជ្ឈិមបូព៌ា	Mittlerer Osten
រាជវង្សហាន	Han-Dynastie
ប្រទេស	Staat
គ្រឹស្តុបផើ កូឡំបូស (Christopher Columbus)	Christoph Kolumbus
ព្រែកជីកប៉ាណាម៉ា	Panamakanal
មហាសមុទ្រខាងត្បូង	Südlicher Ozean
ក្មេង	Kind
លេអុនហាដ អយល័រ	Leonhard Euler
ណាប៉ូលេអុងទី៣	Napoleon III.
ភាសារុស្ស៊ី	Russische Sprache
ល្វី ដ៏អស្ចារ្យ	Ludwig XIV.
សមាគមប្រជាជាតិអាស៊ីអាគ្នេយ៍	ASEAN
ប្រវត្តិសាស្ត្របារាំង	Geschichte Frankreichs
តុលាការយុត្តិធម៌អន្តរជាតិ	Internationaler Gerichtshof
យូណេស្កូ	UNESCO
អង្គការសុខភាពពិភពលោក	Weltgesundheitsorganisation
អង្គការពាណិជ្ជកម្មពិភពលោក	Welthandelsorganisation
ភាសាចិន	Chinesische Sprachen
ធម្មជាតិ	Natur
ឈាម	Blut
រញ្ជួយផែនដី	Erdbeben
សមុទ្រឡាប់តែវ	Laptewsee
ភ្លើងចរាចរ	Ampel
ម៉ាទីន ឡូតធឺរ ឃីង	Martin Luther King
ត្រីកោណមាត្រ	Trigonometrie
ធរណីមាត្រ	Geometrie
វេយ្យាករណ៍	Grammatik
សេដ្ឋកិច្ច	Wirtschaftswissenschaft
អក្សរក្រិច	Griechisches Alphabet
អក្សរឡាតាំង	Lateinisches Alphabet
រឿងមហាភារតយុទ្ធ	Mahabharata
ការិយាល័យសហព័ន្ធស៊ើបអង្កេត	Federal Bureau of Investigation
វីយោឡុង	Violine
ឃឹម	Zymbal
អេឡិចសាន់ដឺ ដឹ ហ្គារ៉ែត	Alexander der Große
សង្គម	Gesellschaft (Soziologie)
ការអប់រំ	Bildung
មនុស្សប្រុស	Mann
វិគីភីឌាភាសាអេស៉្បាញ	Spanischsprachige Wikipedia
សិទ្ធិមនុស្ស	Menschenrechte
ទាសភាព	Sklaverei
សង្គ្រាមស៊ីវិល	Bürgerkrieg
ភ្នំ	Berg
ហុងកុង	Hongkong
សង្គ្រាមត្រជាក់	Kalter Krieg
សេអ៊ូល	Seoul
សង្គ្រាមវៀតណាម	Vietnamkrieg
ម៉ៃឃើល ហ្វារ៉ាដេយ	Michael Faraday
អង់រីកូ ហ្វែរមី	Enrico Fermi
ភាសាអ៊ុយក្រែន	Ukrainische Sprache
HTML	Hypertext Markup Language
ច្យូហានេស គូទេនបឺគ	Johannes Gutenberg
ភាសាដាណឺម៉ាក	Dänische Sprache
ភាសាអេស្តូនី	Estnische Sprache
ហិណ្ឌូសាសនា	Hinduismus
ភាសាពែក	Persische Sprache
សាសនា	Religion
ភាសាកូរ៉េ	Koreanische Sprache
ភាសាខ្មែរ	Khmer-Sprache
ហ្រ្គេតស៊ីងមួន	Sigmund Freud
ភាសាថៃ	Thailändische Sprache
ភាសាម៉ាឡេ	Malaiische Sprache
ភាសាហេប្រ៊ូ	Hebräische Sprache
ចន ឡុក	John Locke
ថ្លើម	Leber
ចិត្តវិទ្យា	Psychologie
មហាសមុទ្រ	Ozean
ពុទ្ធប្រវត្តិសង្ខេប	Siddhartha Gautama
ចរិយាមារយាទ	Ethik
សារជីវកម្មផ្សព្វផ្សាយព័ត៌មានរបស់ចក្រភពអង់គ្លេស(BBC)	British Broadcasting Corporation
ក្លិបបាល់ទាត់ឆេលស៊ី	FC Chelsea
ក (អវយវៈ)	Hals
រាជវង្សថាង	Tang-Dynastie
John F. Kennedy	John F. Kennedy
LibreOffice	LibreOffice
ផ្លូវរូងដីក្រោមសមុទ្រ	Eurotunnel
តារាងខួបនៃធាតុគីមី	Periodensystem
ប្រូម៉ាស	Käse
ទំពាំងបាយជូរ	Weintraube
បន្លែ	Gemüse
បច្ចេកវិទ្យា	Technologie
វិស្វកម្ម	Ingenieurwissenschaften
ទំនាក់ទំនង	Kommunikation
វិជ្ជាជីវៈខាងសារព័ត៌មាន	Journalismus
កាសែត	Zeitung
ទូរស័ព្ទ	Telefon
វប្បធម៌	Kultur
សំស្ក្រឹត	Sanskrit
ប្រដាប់របត់ឈាម	Blutkreislauf
The Guardian	The Guardian
សមីការឌីផេរ៉ង់ស្យែល	Differentialgleichung
មៃក្រូសូហ្វអ៊ិសេល	Microsoft Excel
មុំ	Winkel
សំទុះ	Beschleunigung
ព្រះសិវៈ	Shiva
ព្រះវិស្ណុ	Vishnu
Local Area Network	Local Area Network
Wide Area Network	Wide Area Network
ព្រះព្រហ្ម	Brahma
កម្លាំង	Kraft
កសិកម្ម	Landwirtschaft
សំលៀកបំពាក់	Kleidung
ល្បឿន	Geschwindigkeit
ក្រដាស	Papier
សុញ្ញកាស	Vakuum
ស៊ីនេម៉ាទិច	Kinematik
ក្រលាផ្ទៃ	Flächeninhalt
ទ្រឹស្តីបទពីតាករ	Satz des Pythagoras
ចំនួនកុំផ្លិច	Komplexe Zahl
Cristiano Ronaldo	Cristiano Ronaldo
អ្នកថតរូប	Fotografie
ល្ខោន	Theater
គ្រឿងអេឡិចត្រូនិច	Elektrisches Bauelement
ព័ត៌មានវិទ្យា	Informationstechnik
អាស៊ីអាគ្នេយ៍	Südostasien
ក្រុងសៀមរាប	Siem Reap
បញ្ជីរាយនាម ប្រទេស	Liste der Staaten der Erde
វិគីភីឌាភាសាព័រទុយហ្គាល់	Portugiesischsprachige Wikipedia
ប្រដាប់រំលាយអាហារ	Verdauung
កីឡាចាក់សាប	Fechten
រោគផ្ដាសាយធម្មតា	Erkältung
រោគសរសៃប្រសាទ	Psychische Störung
ប្រតិទិន ក្រេកូរី	Gregorianischer Kalender
សុខភាព	Gesundheit
ជម្ងឺរលាកទងសួត	Lungenentzündung
ជំងឺអេដស៍	AIDS
កូដ QR	QR-Code
ជំងឺទឹកនោមផ្អែម	Diabetes mellitus
ទំព័រគំរូ:Location map Belgium	Vorlage:Positionskarte Belgien
ទំព័រគំរូ:Location map Croatia	Vorlage:Positionskarte Kroatien
ទំព័រគំរូ:Location map Ukraine	Vorlage:Positionskarte Ukraine
ទំព័រគំរូ:Location map Burma	Vorlage:Positionskarte Myanmar
ទំព័រគំរូ:Location map Philippines	Vorlage:Positionskarte Philippinen
ទំព័រគំរូ:Location map Vietnam	Vorlage:Positionskarte Vietnam
ទំព័រគំរូ:Location map Cambodia	Vorlage:Positionskarte Kambodscha
ទំព័រគំរូ:Location map Thailand	Vorlage:Positionskarte Thailand
ទំព័រគំរូ:Location map Indonesia	Vorlage:Positionskarte Indonesien
ទំព័រគំរូ:Location map Australia	Vorlage:Positionskarte Australien
ញូតុន	Newton (Einheit)
ចក្រភព អូតូម៉ង់	Osmanisches Reich
ម៉ាស៊ីនចំហេះក្នុង	Verbrennungskraftmaschine
ក្បាច់គិតលេខ	Abakus (Rechenhilfsmittel)
វឺតប្រែស	WordPress
Joomla!	Joomla
ដើមដូង	Kokospalme
ភាសាណាវ៉ាថ្ល៍	Nahuatl
ភាសាម៉ាយ៉ាយូកាតិក	Mayathan
អែនជេលីណា ចូលី	Angelina Jolie
អ៊ីលដឺហ្រ្វែន	Île-de-France
ភាសាអារ៉ាប់	Arabische Sprache
Thanksgiving	Thanksgiving
តំបន់ឃ្ជឺស្សឺ	Kyūshū
តំបន់ស៊ីកុគឹ	Shikoku
ទង់ជាតិ	Flagge
ខ្មៅដៃ	Bleistift
សហភាពសូវៀត	Sowjetunion
ចំណុចរលាយ	Schmelzpunkt
កាមេរ៉ា	Fotoapparat
កម្មវិធីទូរទស្សន៍	Fernsehsendung
ខេត្តខាហ្គុស៊ីម៉ា	Präfektur Kagoshima
ភាសាស៊ី	C (Programmiersprache)
ម៉ង់តេរីយើ	Charles de Secondat, Baron de Montesquieu
វិគីភីឌា:អត្ថបទពិសេស	Wikipedia:Exzellente Artikel
ពិភពលោក	Welt
ឈូក	Indische Lotosblume
ឡងប៊ិច (កាលីផ្វនញ៉ា)	Long Beach (Kalifornien)
រង្វង់	Kreis
ប្លង់	Ebene (Mathematik)
វិគីភីឌាភាសាកូរ៉េ	Koreanischsprachige Wikipedia
ទៀបកោះម៉ាឡេ	Malaiische Halbinsel
អេប៉ុងហ្ស៍ (ពពុះទឹក)	Schwämme
មធ្យមនព្វន្ធ	Arithmetisches Mittel
World Cup	Fußball-Weltmeisterschaft
សម្ដេចប៉ាប	Papst
IATA	International Air Transport Association
បុណ្យណូអែល	Weihnachten
ត្រីកោណ	Dreieck
លោកអេលីសេ រីខ្លាស	Élisée Reclus
អ្នកប្រើប្រាស់:អេង ឡុង/សង្គមវិទ្យាមូលដ្ឋាន	Soziologie
សញ្ញាសំលេងអន្តរជាតិ	Internationales Phonetisches Alphabet
តៃវ៉ាន់	Taiwan (Insel)
Friedrich Schiller	Friedrich Schiller
ជំនឿបាហៃ	Bahaitum
១	1
អាប្រាហាម ម៉ាស្លូ	Abraham Maslow
ខ្ទឹមស	Knoblauch
អ៊ូលេនបាធរ	Ulaanbaatar
កោះ	Insel
ភាសាផ្លូវការ	Amtssprache
ខ្សែអេក្វាទ័រ	Äquator
ទិស	Himmelsrichtung
លេខអាតូម	Ordnungszahl
អាល់ហ្វ្រិដ ណូបែល	Alfred Nobel
សម្ដេចប៉ាប យូហាន ទី២៣	Johannes XXIII.
កិរិយាសព្ទ	Verb
ទីតានិច	RMS Titanic
សត្វឆ្អឹងកង	Wirbeltiere
បាគូ	Wiedehopf
អំពែរ	Ampere
ISO 3166-1	ISO-3166-1-Kodierliste
១ មុនគ.ស	1 v. Chr.
ម៉ែត្រការ៉េ	Quadratmeter
ជំនួយ:Interlanguage links	Plankton
ខេត្តកំពង់គោ	Long An
ទ្រឹស្តីបទទ្វេធា	Binomischer Lehrsatz
សមុទ្រជប៉ុន	Japanisches Meer
អាស៊ីខាងកើត	Ostasien
អាមេរិក កណ្ដាល	Zentralamerika
គ្រីស្ទអឌែលហ្វៀន	Christadelphian
បរិមាត្រ	Umfang
ចក្រភព អូទ្រីស-ហុងគ្រី	Österreich-Ungarn
បណ្ណាល័យជាតិ	Öffentliche Bibliothek
ផាយថុន	Python (Programmiersprache)
អានន្ទ	Ananda
អាស៊ីហ្គេមឆ្នាំ១៩៥១	Asienspiele 1951
បាកាន	Bagan
ចិន	China
សំទុះទំនាញដី	Schwerefeld
ច្បាប់ធម្មតា	Common Law
អ្នកម្តាយ តេរេសា​ (Mother Teresa)	Mutter Teresa
ប្លូក	Blog
រោគគ្រុនចាញ់	Denguefieber
ដុល្លារហុងកុង	Hongkong-Dollar
Xian JH-7	Xian JH-7
ខ្សែបណ្ដោយ	Meridian (Geographie)
ខេត្តឃ្លាំង	Sóc Trăng (Provinz)
ខេត្តទឹកខ្មៅ	Cà Mau (Provinz)
សមុទ្រខារ៉ា	Karasee
ផ្លេតបន្ទោរ	Blitz
កំរងកោះ	Archipel
តួប្រុស	Schauspieler
អំបូរភាសាយូតូអាហ្សតិក	Uto-aztekische Sprachen
ចាស្ទីន ពីពេ្រ	Justin Bieber
ក្រុម​ភាសា​ថៃកៈដៃ	Tai-Kadai-Sprachen
ចក្រភព រុស្ស៊ី	Russisches Kaiserreich
មឞវជ	Mošovce
បេណាហ្សៀរ ប៊ូតូ	Benazir Bhutto
ស៊ីឌី	Compact Disc
ឧទ្ធម្ភាគចក្រ	Hubschrauber
គុណនាម	Adjektiv
វីតាមីន	Vitamin
វែបសាយ	Website
តំបន់ហុកកៃដូ	Hokkaidō
រូបមន្តសមមូលម៉ាស់-ថាមពល	Äquivalenz von Masse und Energie
សមុទ្រ អារ៉ាល់	Aralsee
ហូ ជីមិញ	Hồ Chí Minh
ម៉ាក ហ្សុកឃឺបឺក	Mark Zuckerberg
ប្រតិកម្មគីមី	Chemische Reaktion
ខេត្តក្រមួនស	Kiên Giang
ខេត្តមាត់ជ្រូក	An Giang
ខេត្តរោងដំរី	Tây Ninh (Provinz)
ខេត្តព្រះត្រពាំង	Trà Vinh (Provinz)
Binomial nomenclature	Binäre Nomenklatur
ខេត្តពលលាវ	Bạc Liêu (Provinz)
ខេត្តផ្សារដែក	Đồng Tháp
វ៉ែសបែង	Westjordanland
ភាសាបាលី	Pali
គេហទំព័រ	Webseite
ចតុកោណ	Viereck
ឈិន ឡុង	Jackie Chan
ទិវាកុមារអន្តរជាតិ	Kindertag
Yahoo!	Yahoo
បន្ទាត់	Gerade
ហ្មរិឩពឡ	Mariupol
G8	G8
អង្កត់ផ្ចិត	Durchmesser
គ្រូបង្រៀន	Lehrer
ស្នាដៃនៃបុព្វបុរសខ្មែរ	Schreiben
ស្ដេចប៉ាប យ៉ូហាន ប៉ូលទី១	Johannes Paul I.
ណៃពិដោ	Naypyidaw
ISO 4217	ISO 4217
ព្យែរ គុយរី	Pierre Curie
ក្រុមប្រឹក្សាសន្តិសុខ អង្គការសហប្រជាជាតិ	Sicherheitsrat der Vereinten Nationen
ពហុកោណ	Polygon
ទិវានៃក្ដីស្រលាញ់	Valentinstag
ហ្គូហ្គល	Markt
សមុទ្រចិនខាងត្បូង	Südchinesisches Meer
និវេសនប្រព័ន្ធ	Ökosystem
សមុទ្រលឿង	Gelbes Meer
យ៉ាំងហ្គូន	Rangun
សូរព្យញ្ជនៈ	Konsonant
ច្បាប់ចលនារបស់ញូតុន	Newtonsche Gesetze
ឈូងសមុទ្របេងហ្គាល់	Golf von Bengalen
ទិវានារីអន្តរជាតិ	Internationaler Frauentag
.jp	.jp
ភ្នំហ្វឹជី	Fuji (Vulkan)
ប៉ុលពត	Pol Pot
Xian H-6	Xian H-6
Chengdu J-7	Chengdu J-7
Shenyang J-8	Shenyang J-8
ភ្នំភ្លើង អ៊ីស៊ាឡឺក	Eyjafjallajökull
ម៉ាក្រូសេដ្ឋកិច្ច	Makroökonomie
Harbin SH-5	Harbin SH-5
ដីជ្រោយហ្គាស្សា	Gazastreifen
​វិទ្យុ​ស្ទូឌីយោ 54 បណ្តាញ	Radio Studio 54 Network
អេលីប	Ellipse
វិទ្យុអាស៊ីសេរី	Radio Free Asia
សមាគមន៍សារព័ត៌មាន	Associated Press
អធិដ្ឋាន	Gebet
គណៈកម្មាធិការអូឡាំពិកអន្តរជាតិ	Internationales Olympisches Komitee
Skype	Skype
.kh	.kh
ចតុកោណស្មើ	Raute
ទន្លេមេគង្គ	Mekong
មេកានិច	Mechanik
វិចិត្រសាលវលញ្ឆករប្រទេស	Liste der Nationalwappen
ហែងរីហ ហឺត	Heinrich Hertz
អង់រី បិកកឺរ៉ែល	Henri Becquerel
ទស្សនាវដ្ដី	Zeitschrift
សមីការដឺក្រេទី២	Quadratische Gleichung
រូពីឥណ្ឌូនេស៊ី	Indonesische Rupiah
សមុទ្រអុកហុតស្គ៍	Ochotskisches Meer
ចិត្តវិភាគ	Psychoanalyse
ខ្មែរម៉ាស្ទើ	Webmaster
.kr	.kr
URL	Uniform Resource Locator
ក្រុមបាល់ទាត់ជម្រើសជាតិ អេស្ប៉ាញ	Spanische Fußballnationalmannschaft
Google Earth	Google Earth
ប៊ែនហាដ រីម៉ាន	Bernhard Riemann
កោន	Kegel (Geometrie)
អាតុល	Atoll
ទិន្នន័យ	Daten
ខ្លែង	Drachen
ស្ថាបត្យករ	Architekt
មហាអំណាច អាប់ស៊ីស	Achsenmächte
វិគីភីឌា:FAQ	Hilfe:FAQ
.th	.th
ចក្រភព អាល្លឺម៉ង់	Deutsches Kaiserreich
ក្រុមបាល់ទាត់ជម្រើសជាតិ អាល្លឺម៉ង់	Deutsche Fußballnationalmannschaft
ហេរី ផោតធ័រ និង សិលាទេព	Harry Potter und der Stein der Weisen
អង្គការ Creative Commons	Creative Commons
ឥណ្ឌូចិន	Indochina
ប្រាសាទអង្គរវត្ត	Angkor Wat
ទ្រឹស្ដីរ៉ឺឡាទីវីតេ	Relativitätstheorie
ប្រុស	Männliches Geschlecht
Toulon	Toulon
ប៉ាស្កាល់	Pascal (Einheit)
ទ្រឹស្ដីល្បែង	Spieltheorie
នីតិរដ្ឋ	Rule of law
សមុទ្រចិនខាងកើត	Ostchinesisches Meer
ខ្នុរ	Jackfruchtbaum
ប្រលេឡូក្រាម	Parallelogramm
ប្រាសាទព្រះវិហារ	Prasat Preah Vihear
ចតុកោណព្នាយ	Trapez (Geometrie)
ស៊ូស៊ី	Sushi
រូប៊ិក ខ្យូប	Zauberwürfel
កាល	Plautus
ចង្រិត	Echte Grillen
ទិវាពលកម្មអន្ដរជាតិ	Erster Mai
ស្ទឹង	Bach
សមុទ្រអង់ដាម៉ង់	Andamanensee
ប៉ិបស៊ី	Pepsi
ក្រុមបាល់ទាត់ជម្រើសជាតិ អង់គ្លេស	Englische Fußballnationalmannschaft
ក្រុមបាល់ទាត់ជម្រើសជាតិ បារាំង	Französische Fußballnationalmannschaft
ទំព័រគំរូ:Commonscat	Vorlage:Commonscat
វិគីភីឌាភាសាអាល្លឺម៉ង់	Deutschsprachige Wikipedia
អាស៊ីខាងលិច	Naher Osten
យេនឌ័រ	Geschlechtsidentität
អង្គការសហភាពអន្តរជាតិដើម្បីអភិរក្សធម្មជាតិ	IUCN
ទីក្រុងមេឌេយីណ	Medellín
ប៉ារ៉ាបូល	Parabel (Mathematik)
ខេត្តអ៊ីវ៉ាតិ	Präfektur Iwate
ទ្វារសមុទ្រមលក្កា	Straße von Malakka
មហាយាន	Mahayana
ប្រព័ន្ធប្រតិបត្តការ iOS	Apple iOS
ចំនួនបឋម	Primzahl
សង្គ្រាម ប្រាំមួយ ថ្ងៃ	Sechstagekrieg
ក្រុងឡូវែល រដ្ឋម៉ាស្សាឈូស៊ែត	Lowell (Massachusetts)
សមុទ្រជ្វា	Javasee
សិប្បកម្មខ្ញុំ	Minecraft
ច្រកសមុទ្រធ្ងន់ធ្ងរ	Dire Straits
វីហ្សួលបេហ៊្សិក.ណេត	Visual Basic .NET
បំណែងចែករដ្ឋបាលនៃកម្ពុជា	Verwaltungsgliederung Kambodschas
អនុគមន៍ដឺក្រេទី២	Quadratische Funktion
ច្បាប់អំពែរ	Ampèresches Gesetz
ជំងឺអ៊ីបូឡា	Ebolafieber
ច្រកកូរ៉េ	Koreastraße
ឆកសមុទ្រកូរ៉េ	Koreabucht
កង្កែប	Froschlurche
ខ្សែទឹកឃឹរ៉ុស៊ីអុ	Kuroshio
ចំណាត់ថ្នាក់ក្រុម:រដ្ឋាភិបាល	Kategorie:Regierung
ទំព័រគំរូ:Infobox legislature	Vorlage:Infobox Parlament
ទន្លេយ៉ាលូ	Yalu
ទំព័រគំរូ:ប្រវត្តិសាស្ត្រអាស៊ី	Vorlage:Navigationsleiste Geschichte nach Staat/Asien
មីហ្គេល អ៊ីដាលហ្គោ អ៊ី កុស្ទីយ៉ា	Miguel Hidalgo
នរោត្តម សីហមុនី	Norodom Sihamoni
ហ៊ុន សែន	Hun Sen
តូក្យូស្កាយទ្រី	Tokyo Skytree
ហោ ណាំហុង	Hor Namhong
ភាសាប៉ាស្តូ	Paschtunische Sprache
កំណែទម្រង់រូបិយវត្ថុ	Währungsreform
ធនាគារកណ្ដាល	Zentralbank
Pidgin	Pidgin (Instant Messenger)
​វិលហែម វុឌ	Wilhelm Wundt
យិដា តាដូ	Gerda Taro
មនុស្សពីងពាង	Spider-Man
សារធាតុគីមី	Chemischer Stoff
ចលនានៅក្នុងរូបវិទ្យា	Bewegung (Physik)
ជម្ងឺកញ្ជ្រឹល	Masern
ក្រុមបាល់ទាត់ជម្រើសជាតិ អាហ្សង់ទីន	Argentinische Fußballnationalmannschaft
ខ្យល់ព្រះអាទិត្យ	Sonnenwind
បាល់ទាត់ពិភពលោក ២០១៤	Fußball-Weltmeisterschaft 2014
ម៉ូបាល (អាល់ឡាបាម៉ា)	Mobile (Alabama)
កុំព្យូទ័រផ្រូក្រាមមីង(Computer programming)	Programmierung
ខេត្តឈីបា	Präfektur Chiba
ខេត្តអៃឈិ	Präfektur Aichi
វិបត្តិសេដ្ឋកិច្ចឆ្នាំ ១៩៩៧	Asienkrise
ខ្មែរ	Erwachsener
សិល្បៈប្រើវោហារបង្ហូរគំនិត	Rhetorik
ឃីមីហ្គាយ៉ុ	Kimi Ga Yo
សាល អូហ្គុស្ទីន ដឺ គូឡុំ	Charles Augustin de Coulomb
ខេត្តអាគីតា	Präfektur Akita
ថ្នាក់ពាក្យ	Wortart
កាន់ជិ	Kanji
នាម	Name
ប្រវត្តិសាស្ត្រចិន	Geschichte Chinas
អវតារ	Avatara
ច្បាប់គូឡុំ	Coulombsches Gesetz
រឿង រ៉ូមេអូ និង ហ្ស៊ុយលីយេ	Romeo und Julia
សាលីណា កូមាស់	Selena Gomez
ក្រុម (តារាងខួបនៃធាតុគីមី)	Gruppe des Periodensystems
ក្រុមបាល់ទាត់ជម្រើសជាតិ ប្រេស៊ីល	Brasilianische Fußballnationalmannschaft
កាល ឡែមស្ដែនណឺ	Karl Landsteiner
បាល់ប៉ូឡូញ	Polandball
ឯកសារភាពយន្ត	Dokumentarfilm
អនុគមន៍ត្រីកោណមាត្រ	Trigonometrische Funktion
ហ្រាន្ដកូស ហ្វីឡុន	François Fillon
ខួប (តារាងខួបនៃធាតុគីមី)	Periode des Periodensystems
ល្បែងទាញព្រ័ត្រ	Tauziehen
Article (grammar)	Artikel (Wortart)
មេដ្យានទ័រ	Zirkel
Rfid	RFID
ហិចហ្វាន់	Hedgefonds
ISO 3166	ISO 3166
សញ្ញាជាតិកូរ៉េខាងជើង	Wappen Nordkoreas
គីឡូ	Kilo (Präfix)
ការតាំងសមាធិ	Meditation
យ៉ុតតា	Yotta
សង់ទី	Zenti
ហ្វង់តូ	Femto
ច្រកតារតារី	Tatarensund
ហ្សិបតូ	Zepto
យ៉ុកតូ	Yokto
ដេស៊ី	Dezi
ម៉ាស៊ីនស្វែងរក	Metasuchmaschine
អាំងតេក្រាលមិនកំនត់	Stammfunktion
Shenyang J-15	Shenyang J-15
គណបក្សហ៊្វុនស៊ិនប៉ិច	Front Uni National pour un Cambodge Indépendant, Neutre, Pacifique, et Coopératif
ខេត្តក្យូតុ	Präfektur Kyōto
តំលៃដាច់ខាត	Betragsfunktion
ហេដ្ឋារចនាសម្ព័ន្ធ	Infrastruktur
សាស្ត្រាចារ្យ	Professur
តេគីឡា	Tequila
សន្ធិសញ្ញាប្រេស្ត-លីតូវស្ក	Friedensvertrag von Brest-Litowsk
William Thomson, 1st Baron Kelvin	William Thomson, 1. Baron Kelvin
អាណាខេត្តអូសាកា	Präfektur Ōsaka
ខេត្តអិហ៊ីមិ	Präfektur Ehime
វាំងននដែក	Eiserner Vorhang
Kara (band)	Kara (Band)
វីលៀម ជែម	William James
ខេត្តយ៉ាម៉ាកាតា	Präfektur Yamagata
ច្រកតៃវ៉ាន់	Formosastraße
គំរោងម៉ាន់ហាត់ថាន់	Manhattan-Projekt
ខេត្តយ៉ាម៉ាហ្គឹឈិ	Präfektur Yamaguchi
ខេត្តខាន់ណាហ្គាវ៉ា	Präfektur Kanagawa
បញ្ចកោណ	Fünfeck
តំបន់ជឺហ្គុកឹ	Chūgoku
ខេត្តណាហ្គាណុ	Präfektur Nagano
ខេត្តសៃតាម៉ា	Präfektur Saitama
ខេត្តមីអិ	Präfektur Mie
ណុត	Knoten (Einheit)
តំបន់តុហុកកឹ	Tōhoku
ខេត្តហ្គឺនម៉ា	Präfektur Gunma
ជ្រូកទឹក	Dugong
ខ្សែទឹកមហាសមុទ្រ	Meeresströmung
ខេត្តមីយ៉ាសាគី	Präfektur Miyazaki
ខេត្តឃឹម៉ាម៉ុតុ	Präfektur Kumamoto
មូលដ្ឋានូបនីយកម្មភាសា	Multimedialokalisierung
Mikoyan MiG-29	Mikojan-Gurewitsch MiG-29
សប្ដាហ៏ពិសិដ្ឋ	Karwoche
ឈូងសមុទ្រថៃ	Golf von Thailand
លី ក្វាន់យូ	Lee Kuan Yew
កម្មសិទ្ធិបញ្ញា	Geistiges Eigentum
អាណាខេត្តណារ៉ា	Präfektur Nara
បុព្វបទនៅក្នុងប្រព័ន្ធខ្នាតអន្តរជាតិ	SI-Vorsatz
យន្តហោះប៉ូឡូញកំទេចឆ្នាំ២០១០	Flugzeugabsturz bei Smolensk
ជនភៀសខ្លួន	Flüchtling
ហង់រី កាវិនឌីស	Henry Cavendish
បុណ្យចូលឆ្នាំចិន	Chinesisches Neujahrsfest
ថេរវាទ	Theravada
តំបន់ខាន់តូ	Kantō
ខេត្តនីហ្គាតាក់	Präfektur Niigata
ខេត្តយ៉ាម៉ាណាស៊ី	Präfektur Yamanashi
ខេត្តស៊ីម៉ាណិ	Präfektur Shimane
ខេត្តតុយ៉ាម៉ា	Präfektur Toyama
ខេត្តអូកាយ៉ាម៉ា	Präfektur Okayama
ISO 3166-2	ISO 3166-2
ខេត្តអយតាក់	Präfektur Ōita
ខេត្តខូឈិ	Präfektur Kōchi
ភ្នំមេរ៉ាពី	Merapi (Vulkan)
ព្រះធម៌	Dharma
តំបន់ឈឺប៊ឹ	Chūbu
វ៉ាក់សាំង	Impfstoff
រោគក្អកមាន់	Keuchhusten
គន្ថនិទ្ទេស	Bibliografie
កម្ពុជា នៅកីឡាអូឡាំពិករដូវក្ដៅ ២០០៨	Olympische Sommerspiele 2008/Teilnehmer (Kambodscha)
គីមឈី	Kimchi
ខេត្តកំពង់ចាម	Kampong Cham (Provinz)
ខ្សែទឹកហ្គ្រីនលែនខាងកើត	Grönlandstrom
ខ្សែទឹកហាំបុល	Humboldtstrom
ខ្សែទឹកអូស្ត្រាលីខាងកើត	Ostaustralstrom
ជ័រទឹក	Harz (Material)
ដុនបូស្កូ	Johannes Bosco
ធ្នូរង្វង់	Kreisbogen
អប្សរា	Apsara
ស្រុក	Distrikt
រាជវង្សចោឡា	Chola
ខ្លារខិន ២ (រថក្រោះ)	Leopard 2
មហាអំណាច កណ្ដាល	Mittelmächte
អិចសា	Exa (Präfix)
ហិកតូ	Hekto
ដេកា	Deka (Präfix)
រ៉ូបឺតកាប៉ា	Robert Capa
ពីកូ	Piko (Präfix)
លីប៉ូល ស៊ីដាស៊ាងហ័រ	Léopold Sédar Senghor
វិគីភីឌាភាសាឥណ្ឌូនេស៊ី	Wikipedia:Enzyklopädie/Indonesischsprachige Wikipedia
ទន្ដគោម	Agaven
ប្រវតិ្តBoney M	Boney M.
វីមេអូ	Vimeo
អំពើអនិត្យានុកូល	Häusliche Gewalt
ហង់រី ការចេរ ប្រេស្សុង	Henri Cartier-Bresson
ត្រីកោណសម័ង្ស	Gleichseitiges Dreieck
ម៉ាក់ណូលា	Magnolien
ចូសេហ្វ ហិនរី	Joseph Henry
មន ស	Weiße Maulbeere
ពិធីបញ្ជាប់ពាក្យ	Verlöbnis
ត្រីកោណកែង	Rechtwinkliges Dreieck
សមុទ្រហ្វីលីពីន	Philippinensee
ប្រព័ន្ធកូអ័រដោណេភូមិសាស្ត្រ	Geopolitik
Eurocopter Tiger	Eurocopter Tiger
តេត្រាអែត	Tetraeder
ម៉ោងផែនដី	Earth Hour
នរោត្ដម សីហនុ	Norodom Sihanouk
ទន្លេរីយ៉ូហ្គ្រែនដេ	Rio Grande
សំព័រ	Brotfruchtbäume
កម្មវិធីអភិវឌ្ឍន៍សហប្រជាជាតិ	Entwicklungsprogramm der Vereinten Nationen
ម៉ាស៊ីនថត លេកា	Leica Camera
សេវាសាធារណៈ	Daseinsvorsorge
មេគុណជីនី	Gini-Koeffizient
នីត្រូគ្លីសេរីន	Nitroglycerin
វណ្ណយុត្តិ	Diakritisches Zeichen
ទង់ជាតិកម្ពុជា	Flagge Kambodschas
ក្រុងអង្គរ	Angkor
ក្រពេញទីមុស	Thymus
ទ្រឹស្តីបទកូស៊ីនុស	Kosinussatz
ទក្សិណ ជិនវ័ត្រ	Thaksin Shinawatra
ប្រធាន	Subjekt (Grammatik)
ហិនរី រ៉េម៉ុន	Henry J. Raymond
អ៊ែង​ហ្គ្រី បឺដ	Angry Birds
អ៊ីពែបូល	Hyperbel (Mathematik)
វិសមភាពស្វ័យគុណ	Ungleichung
ប៊ិច	Schreibstift
ចេក​	Kochbanane
XHTML	Extensible Hypertext Markup Language
ចម្ប៉ាក្រហម	Champaka
គ្រោះទុរ្ភិក្ស	Hungersnot
អរិយសច្ច៤	Vier Edle Wahrheiten
ស្តាទិច	Statik (Physik)
ខេត្តណាហ្គាសាគី	Präfektur Nagasaki
វិគីភីឌាភាសាស្វីស	Schwedischsprachige Wikipedia
ភ្លើងឆេះព្រៃ	Waldbrand
ទ្រឹស្តីបទស៊ីនុស	Sinussatz
ច្បាប់ហ៊ូក	Hookesches Gesetz
ក្រុមបាល់ទាត់ជម្រើសជាតិ ជប៉ុន	Japanische Fußballnationalmannschaft
រោគឈឺចាប់ក្នុងសន្លាក់ឆ្អឹង	Arthritis
ប្លុកហ្គឺ (Blogger)	Blogger.com
ធម្មនុញ្ញនៃអង្គការសហប្រជាជាតិ	Charta der Vereinten Nationen
Boeing AH-64 Apache	Boeing AH-64
រោគហើមសួត	Bronchitis
អេមីល្យូ ហ្គីណូ សេហ្គ្រែ	Emilio Segrè
Sukhoi Su-27	Suchoi Su-27
ម៉ាស៊ីនត្រជាក់	Klimaanlage
កាំ	Radius
អភិសិទ្ធិ វេជ្ជាជីវៈ	Abhisit Vejjajiva
HAL Tejas	HAL Tejas
អ៊ីដ្រូស្តាទិច	Hydrostatik
វិគីភីឌាភាសាជប៉ុន	Japanischsprachige Wikipedia
គោលនយោបាយរូបិយវត្ថុ	Geldpolitik
យានដឹកជញ្ជូនសាធារណៈ	Öffentlicher Verkehr
ការសំភាសន៏	Interview
ពាណិជ្ជកម្មអន្តរជាតិ	Außenhandel
ចក្រភពអាណានិគមបារាំង	Französische Kolonien
ពន្ធលើប្រាក់ចំណូល	Einkommensteuer
រូបចំលាក់	Statue
នាឡិកាខ្សាច់	Sanduhr
ពុយមីស	Bims
FM	Frequenzmodulation
សង្គមស៊ីវិល	Zivilgesellschaft
សមុទ្របូហៃ	Golf von Bohai
ការិយាល័យ	Büro
ការបង្រៀនដែនដីបរិសុទ្ធ	E-Learning
ម៉ែត្រក្នុងមួយវិនាទី	Meter pro Sekunde
រូបមន្តហេរុង	Satz des Heron
ទន្សោង	Banteng
វីតាមីន B	Vitamin B
គណៈកម្មាធិការជាតិអូឡាំពិក	Nationales Olympisches Komitee
ប៉មតូក្យូ	Tokyo Tower
ទិវាទឹកអន្តរជាតិ	Weltwassertag
រូបមន្តអយល័រ	Eulersche Formel
ស៊ីយ៉ាញួរ	Cyanide
អរិយដ្ឋង្គិកមគ្គ	Edler Achtfacher Pfad
សហភាពឥណ្ឌូចិន	Französisch-Indochina
ចន្ទគតិ	Lunarkalender
ការវិភាគតាមអ៊ីនធើណែត	Unique Visit
សំទុះមុំ	Winkelbeschleunigung
អាស៊ីហ្គេមឆ្នាំ១៩៧០	Asienspiele 1970
កាលប្បវត្តិព្រះពុទ្ធសាសនា	Zeittafel zum Buddhismus
គោលនយោបាយសារពើពន្ធ	Fiskalpolitik
ឡាហ្គូន	Lagune
Mathew Brady	Mathew B. Brady
អប់សិន (ហិរញ្ញវត្ថុ)	Option (Wirtschaft)
អង្កត់ធ្នូ	Sehne (Geometrie)
អាយុសង្ឃឹម	Lebenserwartung
ជំនួយ:Using colours	Hilfe:Farben
ខុទ្ទកាល័យ	Board of Directors
សីដក់	Sepak Takraw
ធនាគារអភិវឌ្ឍន៍អាស៊ី	Asiatische Entwicklungsbank
បញ្ជីរដ្ឋមានអាវុធនុយក្លេអ៊ែរ	Atommacht
ទីផ្សារអ៊ីធើណែត	Online-Marketing
សៀវភៅ	Das Dschungelbuch
បារីអេឡិចត្រូនិច	Elektrische Zigarette
Eagles (ក្រុមភ្លេង)	Eagles
កំណើនសេដ្ឋកិច្ច	Wirtschaftswachstum
យន្តសាស្រ្តរថយន្ត	Automobilindustrie
អាឌាម លេមបឺត	Adam Lambert
រូបមន្តដឺម័រ	Moivrescher Satz
អនុគមន៍ហ្គាំម៉ា	Gammafunktion
ផ្សារធំថ្មី	Zentralmarkt (Phnom Penh)
សញ្ញាជាតិបង់ក្លាដែស្ស	Wappen Bangladeschs
នាង​សីតា	Sita (Mythologie)
សូរ (​ភាសាសាស្ត្រ​)	Tonsprache
ខ្មែរក្រហម	Rote Khmer
ម៉ូឌុល​យ៉ាំង	Elastizitätsmodul
យុន ជីមិ-ហូ	Yun Chi-ho
ទីភ្នាក់ងារសារព័ត៌មាន	Nachrichten- und Presseagentur
ថេរហ្វារ៉ាដេយ	Faraday-Konstante
ប្រវត្តិអ៊ីនធើណេត	Geschichte des Internets
សមភាពគួរកត់សំគាល់	Binom
ខូប្រា	Kopra
ទ្រឹស្តីបទមេនេឡូស	Satz von Menelaos
អត្ថបទ(ប្រើបា្រស់ភាសា)	Kontext (Sprachwissenschaft)
ជូគ័រលាង	Zhuge Liang
បំលែងឡាប្លាស	Laplace-Transformation
សញ្ញាជាតិតួរគី	Hoheitszeichen der Türkei
បឹងទន្លេសាប	Tonle Sap (See)
Dassault Mirage 2000	Dassault Mirage 2000
ចំនួនអវិជ្ជមាន	Negative Zahl
វិសុទ្ធិមគ្គ	Visuddhimagga
សញ្ញាជាតិវៀតណាម	Wappen Vietnams
ខ្មែរ (ជនជាតិ)	Khmer (Volk)
សញ្ញាជាតិកូរ៉េខាងត្បូង	Wappen Südkoreas
សញ្ញាជាតិឡាវ	Wappen von Laos
សញ្ញាជាតិប៉ាគីស្ថាន	Wappen Pakistans
Tigranes the Great	Tigranes II.
សម្ដេចព្រះមហាឃោសនន្ន	Maha Ghosananda
កោះក្នុងទ្វីប	Binneninsel
ត្រីពណ៌	Trikolore
សញ្ញាជាតិប៊្រុយណេ	Wappen Bruneis
រង្វង់ត្រីកោណមាត្រ	Einheitskreis
ចំរៀករង្វង់	Kreissektor
អនុគមន៍ដឺក្រេទី៣	Kubische Gleichung
អនុគមន៍អ៊ីពែបូលីក	Hyperbelfunktion
ឆាវ ឆាវ	Cao Cao
Sukhoi Su-30	Suchoi Su-30
កម្មវិធីស្បៀងអាហារពិភពលោក	Welternährungsprogramm der Vereinten Nationen
រៀល	Kambodschanischer Riel
សមុទ្រស្ទើរបិទ	Randmeer
ច្រកសិង្ហបុរី	Straße von Singapur
វិគីភីឌាភាសារុស្ស៊ី	Russischsprachige Wikipedia
សញ្ញាជាតិអូម៉ង់	Wappen Omans
ភាសាកម្មវិធី Lua	Lua
សញ្ញាជាតិប៊ូតាន	Wappen Bhutans
ភ្លេងជាតិថៃ	Phleng Chat
ព្រះរតនត្រ័យ	Drei Juwelen
អាហារនៅប្រទេសម៉ិចស៊ិក	Mexikanische Küche
ច្រកឡាប៉េរូស	La-Pérouse-Straße
ផ្សារហិរញ្ញវត្ថុ	Finanzmarkt
ញ៉ែ	Flirt
ព្រះឆាយាល័ក្ខកម្ពុជា	Wappen Kambodschas
ទិវាអង្គការសហប្រជាជាតិ	Tag der Vereinten Nationen
ខ្សែទឹកអាត្លង់ទិកខាងជើង	Nordatlantikstrom
ប្រវត្តិសាស្ត្រវៀតណាម	Geschichte Vietnams
ខ្សែទឹកខាណារី	Kanarenstrom
ទ្រឹស្តីបទឆិវ៉ា	Satz von Ceva
LinkedIn	LinkedIn
ព្រះត្រៃបិដក	Pali-Kanon
បុណ្យវិសាខបូជា	Vesakh
ទីក្រុងព្រែកឫស្សី	Cần Thơ
ជនជាតិចាម	Champa
រីស្ស៉ាត កាពុសស៊ីនស្គី	Ryszard Kapuściński
ប្រវត្តិសាស្ត្រភូមា	Geschichte Myanmars
ស៊ាន ឃីងស្តន	Sean Kingston
កងទ័ពជើងទឹកបារាំង	Französische Marine
ចំប៉ី	Frangipani
ពហុកីឡាដ្ឋានសុផាចាឡាសៃ	Suphachalasai-Stadion
អនុគមន៍បេសែ្សល	Besselsche Differentialgleichung
លោក អាប់ឌូ ឌីអោហ្វ	Abdou Diouf
វិធីហ្វៃណៃថ៍អ៊េលម៉ិន	Finite-Elemente-Methode
ច្បាប់អគ្គីសនីវិភាគរបស់ហ្វារ៉ាដេយ	Faradaysche Gesetze
ខេត្តព្រះសីហនុ	Sihanoukville
មានប្រ	Anggun
ប្រហុក	Prahok
និកាយនៃព្រះពុទ្ធសាសនា	Schulen und Systeme des Buddhismus
ដុនបូស្កូសាឡេស៊ាន្ត	Salesianer Don Boscos
ខ្នាតគោលនៅក្នុងប្រព័ន្ធខ្នាតអន្តរជាតិ	SI-Basiseinheit
អង្គរធំ	Angkor Thom
Kara	Kara
ព្រះបាទសុទ្ធោទន	Shuddhodana
ប្រទេសនៅអឺរ៉ុប	Liste der Länder Europas
វិទ្យុសម្លេងសហរដ្ឋអាមេរិក	Voice of America
ជេឃ្វីរី	JQuery
ទិវាពិភពលោកគ្មានថ្នាំជក់	Weltnichtrauchertag
គម្ពីរបញ្ចតន្ត្រ	Panchatantra
មេដ្យាន	Seitenhalbierende
ផ្លាយ អាស់	Flugasche
T-80	T-80
សញ្ញាជាតិកាតារ	Wappen Katars
សញ្ញាយ៉ាកូប៊ី	Jacobi-Symbol
ភាសាចាម	Cham (Sprache)
មីហ៊្គោ	MeeGo
វិភាគចិត្តវិទ្យា	Analytische Psychologie
លីវ ប៉ី	Liu Bei
កិច្ចព្រមព្រៀងពាណិជ្ជកម្ម	Handelsabkommen
ម៉ាត្សឹស៊ីតា ខូណុស្កិ	Matsushita Kōnosuke
សង្គ្រាមគ្រីមៀ	Krimkrieg
ក្ងោកបៃតង	Ährenträgerpfau
នាវាចរណ៏	Navigator
Pinterest	Pinterest
អាស៊ីហ្គេមឆ្នាំ១៩៦២	Asienspiele 1962
អៀង ធីរិទ្ធ	Ieng Thirith
ភ្នំសេមេរូ	Semeru
កោះសមុយ	Ko Samui
ថវិការដ្ឋាភិបាល	Haushaltsplan
អាំងតេក្រាលដោយផ្នែក	Partielle Integration
ផ្សោតក្បាលត្រឡោក	Irawadidelfin
Near Field Communication	Near Field Communication
ខៀវ ពណ្ណារី	Khieu Ponnary
ហិរញ្ញវត្ថុសាធារណៈ	Finanzwissenschaft
កប៉ាល់ ជួង	Schiffsglocke
សាលាសំណាក់	Pavillon
ជយវម៌្មទី១	Jayavarman I.
ប្រាសាទក្រោលគោ	Krol Ko
ខ្សែទឹកកាលីហ្វរនៀ	Kalifornienstrom
រូបមន្តអយល័រ-ម៉ាក្លូរីន	Euler-Maclaurin-Formel
នគរឆាវ	Cao (Staat)
AIDC F-CK-1 Ching-kuo	AIDC Ching-Kuo
OSM	OSM
ខេត្តសាឡៈវ៉ាន់	Provinz Salavan
ប្រាសាទមេបុណ្យខាងកើត	Östlicher Mebon
ទិន្នន័យបើកចំហ	Open Data
ទិន ហ្វី	Stephen Chow
ចម្ប៉ាខែក	Magnolia figo
ហាំង ង៉ោ	Haing S. Ngor
ព្រះបាទសូរ្យវរ្ម័នទី២	Suryavarman II.
ហ្គោស ចុកតុង	Goh Chok Tong
ហិនរី វីលសុន	Henry Wilson (Politiker)
ហុងដា សូអ៊ិជិរ៉ូ	Sōichirō Honda
ស៊ុន ឈាន	Sun Quan
ឆាវ ភី	Cao Pi
ម៉ាស៊ីនថតវីឌីអូ	Videokamera
សមុទ្រកូរ៉ូ	Korosee
ពិម្ពិសារ	Bimbisara
ដូមីនិក សាវីយ៉ូ	Dominikus Savio
ក្រុមបាល់ទាត់ជម្រើសជាតិកម្ពុជា	Kambodschanische Fußballnationalmannschaft
Seo Jae-pil	Philip Jaisohn
ព្រះសារីបុត្រ	Sariputta
ទ្រឹស្តីបទគ្រីន	Satz von Green
ប្រាសាទអូសាកា	Burg Ōsaka
ការប្រើប្រាស់ភាសា	Angewandte Linguistik
គោព្រៃ	Kouprey
VCD	Video-CD
បេអាត​ រិចន័រ	Beat Richner
ថ្ងៃបាស់ស្ទីល	Nationalfeiertag (Frankreich)
កម្ពុជាប្រជាធិបតេយ្យ	Demokratisches Kampuchea
សាលាក្ដីខ្មែរក្រហម	Rote-Khmer-Tribunal
ណាសសែរ អាល់ មូហាមមេដ អាល់ អាហ៍មេដ អាល់ អាបាហ៍	Nasir al-Muhammad al-Ahmad as-Sabah
ស៊ុនធិ បុណ្យ រ័តក្លិន	Sonthi Boonyaratglin
ខេត្តផុងសាលី	Provinz Phongsali
ខេត្តបកែវ	Provinz Bokeo
ខេត្តចំប៉ាសក្តិ	Provinz Champasak
កិលេស	Leidenschaft
ព្រះបាទជ័យវរ្ម័នទី៧	Jayavarman VII.
កស្សបៈ	Mahakashyapa
កាំង ហ្កិច អ៊ាវ	Kaing Guek Eav
អាយតនៈ	Achtzehn Elemente
ស៊ឺ ម៉ាអ៉ី	Sima Yi
ចំនុចហ្គែរហ្គោន	Inkreis
ប្រវត្តិសាស្រ្តនៃរូបថត	Geschichte und Entwicklung der Fotografie
ឋានន្តរសក្ដិរាជវង្សនិងអភិជន	Adelstitel
ក្រុមហ៊ុនអាកាសចរណ៍ជាតិ កម្ពុជាអង្គរអ៊ែរ	Cambodia Angkor Air
កីឡាឧបទ្វីបអាស៊ីអាគ្នេយ៍លើកទី៥	Südostasienspiele 1969
ទ្រឹស្តីបទមេអំបៅ	Schmetterlingssatz
កន្ថឹក	Nördliches Spitzhörnchen
វណ្ណ មូលីវណ្ណ	Vann Molyvann
ហេង សំរិន	Heng Samrin
ខៀវ សំផន	Khieu Samphan
ជេកខប រីស	Jacob August Riis
ព្យែរ វ៉ារីញ៉ុង	Pierre de Varignon
នួន ជា	Nuon Chea
អៀង សារី	Ieng Sary
ជយវម៌្មទី៣	Jayavarman II.
អជាតសត្តុ	Ajatasattu
បន្ទាត់អយល័រ	Eulersche Gerade
ប្រវត្តិសាស្ត្រថៃ	Geschichte Thailands
បុណ្យសែនព្រះខែ	Mondfest
មហាមោគ្គលាន	Moggalana
ប្រេម ទីនសូឡានុន្ទ	Prem Tinsulanonda
គុណកិរិយា	Adverb
ឌីណាមិក HTML	Dynamisches HTML
នូហាក់ ភូមសៈវ៉ាន់	Nouhak Phoumsavanh
កុំផ្លិចឆ្លាស់	Konjugation (Mathematik)
ការកើនឡើងនៃចំនួនប្រជាជននៅលើពិភពលោក	Bevölkerungsentwicklung
ស៊ីហ្គេមលើកទី៩	Südostasienspiele 1977
ប្រាសាទអកយំ	Prasat Ak Yum
គោលនយោបាយកសិកម្ម	Agrarpolitik
ហង់រី មូហូ	Henri Mouhot
តារាងអាំងតេក្រាល	Tabelle von Ableitungs- und Stammfunktionen
បន្ទាត់សេកង់	Sekante
ពហុកោណស្មើ	Gleichseitiges Polygon
ប្រាសាទតាកែវ	Ta Keo
សម្ដេចប៉ាបហ្វ្រង់សូ័រ	Franziskus (Papst)
ព្រះពុទ្ធ​២៨​ព្រះអង្គ	Liste von Buddhas
ទ្រឹស្តីបទតូលេមី	Satz von Ptolemäus
Regional Internet registry	Regional Internet Registry
ខ្វែងជ័យបុរី	Provinz Sainyabuli
ខ្វែងជើងខ្វែង	Provinz Xieng Khouang
ខេត្តឧត្តមជ័យ	Provinz Oudomxay
ខេត្តកោះកុង	Koh Kong (Provinz)
ខេត្តកណ្ដាល	Kandal
ម៉ារី ដូមីនិក ម៉ាសារីលូ	Maria Mazzarello
ព្រះនាងយសោធរា	Yasodhara
អនុគមន៍បែតា	Eulersche Betafunktion
ទ្រឹស្តីបទតង់សង់	Tangenssatz
លិង្គ	Linga
ឌិត ប្រន	Dith Pran
មធ្យមនព្វន្ធ-ធរណីមាត្រ	Arithmetisch-geometrisches Mittel
កូម៌ៈ	Kurma
អាស៊ីហ្គេមឆ្នាំ១៩៧៤	Asienspiele 1974
អាកាសយានដ្ឋានអន្តរជាតិតានសូនណាត្ត	Flughafen Tan-Son-Nhat
KAI T-50 Golden Eagle	KAI T-50
ឧបទ្វីបកូរ៉េ	Koreanische Halbinsel
វីគីប្រជុំ	Wikimania
អាស៊ីហ្គេម	Asienspiele
ទង់ជាតិសិង្ហបុរី	Flagge Singapurs
បង្អួចឆ្នាំ 2000	Microsoft Windows 2000
សមីការដឺក្រេទី១	Lineare Gleichung
សញ្ញាជាតិអាហ្វហ្គានីស្ថាន	Wappen Afghanistans
E-commerce	Elektronischer Handel
Sukhoi Superjet 100	Suchoi Superjet 100
អ្នក​មាន​ជាង​គេ​លើ​ពិភពលោក	The World’s Billionaires
គណកម្មាធិការអូឡាំពិកកូរ៉េ	Korean Olympic Committee
ច្រកខាន់ម៉ុង	Kammon-Straße
អាស៊ីហ្គេមឆ្នាំ២០០២	Asienspiele 2002
ឆកសមុទ្រលាវតុង	Liaodong-Bucht
ឆកសមុទ្របូហៃ	Bohai-Bucht
T-ARA	T-ara
អាស៊ីហ្គេមឆ្នាំ១៩៨៦	Asienspiele 1986
អាណាស្រុកម៉ូបាល (អាល់ឡាបាម៉ា)	Mobile County
ម្កាក់	Goldpflaume
បារខែម	Barcamp
ដើមត្នោត	Palmyrapalme
ព្រះបាទសូរ្យវរ្ម័នទី១	Suryavarman I.
ខេត្តកំពង់ធំ	Kampong Thom (Provinz)
ខេត្តព្រះវិហារ	Preah Vihear (Provinz)
ខេត្ត ហួ ផាន់	Provinz Houaphan
ខ្វែងអាចម៍ក្រពើ	Provinz Attapeu
បញ្ជីទីក្រុងនិងទីប្រជុំជននៅកម្ពុជា	Liste der Städte in Kambodscha
ខេត្តខាំមួន	Provinz Khammuan
ខេត្តប៉ៃលិន	Pailin
ឆាយាលក្សសារព័ត៌មាន	Reportagefotografie
បារីសង់	Geometrischer Schwerpunkt
វិសមភាពប៊ូល	Bonferroni-Ungleichung
ស៊ីសុវត្ថិ មុនីវង្ស	Sisowath Monivong
អង្គឌួង	Ang Duong
ក្រុមបាល់ទាត់ជម្រើសជាតិ កូរ៉េខាងត្បូង	Südkoreanische Fußballnationalmannschaft
សុញ្ញតា	Shunyata
គោលនយោបាយសាធារណៈ	Public Policy
Xian MA60	Xi’an MA60
ស្រុកអន្លង់វែង	Anlong Veng
កស្ថានីយភ្នំបូកគោ	Bokor Hill Station
នរោត្តម	Norodom I.
ម៉ាសែលលីន ចាមប៉ាញេត	Marcellin Champagnat
ព្រះបាទយសោវរ្ម័នទី១	Yasovarman I.
អេដូអារដូ អាម៉ាល់ឌី	Edoardo Amaldi
Chengdu J-20	Chengdu J-20
វេយ្យាករណ៍អង់គ្លេស	Englische Grammatik
ព្រះបាទឥន្រ្ទវរ្ម័នទី១	Indravarman I.
ស៊ីឡាត	Silat
ទ្រឹស្តីបទវ្យែត	Satzgruppe von Vieta
ប្រាសាទភ្នំបាខែង	Phnom Bakheng
អាំងតេក្រាលហ្វ្រេនែល	Fresnel-Integral
គោលនយោបាយសេដ្ឋកិច្ច	Wirtschaftspolitik
ប្រាសាទភិមានអាកាស	Phimeanakas
Baskin​-Robbins បាន	Baskin-Robbins
ទិវាសេរីភាពសារព័ត៌មានពិភពលោក	Internationaler Tag der Pressefreiheit
ប្រាសាទតាព្រហ្ម	Ta Prohm
អាជ្ញាធរអន្តរកាលសហប្រជាជាតិនៅកម្ពុជា	United Nations Transitional Authority in Cambodia
ប្រាសាទធម្មនន្ទ	Thommanon
អាំងតេក្រាលផ្ទៃ	Oberflächenintegral
ប្រាសាទមេបុណ្យខាងលិច	Westlicher Mebon
ប្រាសាទបន្ទាយក្តី	Banteay Kdei
ប្រាសាទបន្ទាយសំរែ	Banteay Samré
រួបថតនៅក្នុងសង្គ្រាម	Kriegsfotografie
មជ្ឈិមនិកាយ	Majjhima-Nikaya
ស្រះស្រង់	Srah Srang
ខេត្តតាកែវ	Takeo (Provinz)
លានស្តេចគំលង់	Terrasse des Lepra-Königs
ខេត្តហ៊ីរ៉ូស៊ីម៉ា	Präfektur Hiroshima
ព្រះសហគមន៏កាតូលិកភូមិភាគភ្នំពេញ	Apostolisches Vikariat Phnom-Penh
បន្ទប់រៀន	Klassenraum
ជំរំជនភៀសខ្លួន	Flüchtlingslager
ហ្គូតហ្គោល	Google Sites
ខេត្តឧត្ដរមានជ័យ	Oddar Meanchey
ប្រភេទស្រាទំពាំងបាយជូរពីប្រទេសបារាំង	Weinbau in Frankreich
អុក	Makruk
បទនគររាជ	Nokoreach
នគររាជសីមា	Nakhon Ratchasima
ចំនួនអាកស៊ីម៉ែដ	Archimedes-Zahl
តំលៃលើការចាប់អារម្មណ៍	Tausend-Kontakt-Preis
អនុគមន៍អ៊ីពែបូលីកច្រាស់	Areafunktion
បញ្ជីរាយនាម ជ័យលាភីរង្វាន់ណូបែលសន្តិភាព	Liste der Friedensnobelpreisträger
ស្ទឹងស៊ីលីវូង	Ciliwung
ISO 3166-2:KH	ISO 3166-2:KH
ទ្រឹស្តីបទពីក	Satz von Pick
ខេត្តសៀមរាប	Siem Reap (Provinz)
ខេត្តមណ្ឌលគិរី	Mondulkiri
ខេត្តកំពង់ស្ពឺ	Kampong Speu (Provinz)
ប្រាសាទបាយ័ន	Bayon
អុនសេន	Onsen
ឧត្តមស្នងការអង្គការសហប្រជាជាតិទទួលបន្ទុកសិទ្ធិមនុស្ស	UNHCHR
សម រង្ស៊ី	Sam Rainsy
ត្រីតុកកែជ្រូក	Pantherfisch
ធុតង្គ	Dhutanga
ជាតក	Jataka
ក្រុងហាកុណិ (ខេត្តកាណាហ្គាវ៉ា)	Hakone
អនុគមន៍ត្រីកោណមាត្រច្រាស់	Arkusfunktion
ប្រវត្តិសាស្ត្រខ្មែរ	Geschichte Kambodschas
ម៉ាជូ ពីជូ	Machu Picchu
គណនីធនាគារ	Bankkonto
ខ្សែទឹកប្រេស៊ីល	Brasilstrom
ក្រុមអសនិក (អាកាសចរណ៍)	Staffel (Militär)
Pilatus PC-7	Pilatus PC-7
ត្រកៀតប៉ោង	Dickstielige Wasserhyazinthe
ជ្រោយណុតុ	Noto-Halbinsel
ចតុកោណចារឹកក្នុងរង្វង់	Sehnenviereck
គីឡូម៉ែត្រការ៉េ	Quadratkilometer
ចេននី រីវឺរ៉ា	Jenni Rivera
ពហុកោណនិយ័ត	Regelmäßiges Polygon
ប្រទេសនៅអាស៊ី	Liste der Staaten Asiens
រលួស	Indischer Korallenbaum
ប្រទេសមួយ ប្រព័ន្ធពីរ	Ein Land, zwei Systeme
ត្រកៀត	Wasserhyazinthengewächse
បណ្តាញផ្លូវហាយវេអាស៊ី	Asiatisches Fernstraßen-Projekt
អាស៊ីហ្គេមឆ្នាំ១៩៥៤	Asienspiele 1954
អាស៊ីហ្គេមឆ្នាំ១៩៥៨	Asienspiele 1958
អាស៊ីហ្គេមឆ្នាំ១៩៦៦	Asienspiele 1966
អាស៊ីហ្គេមឆ្នាំ១៩៧៨	Asienspiele 1978
អាស៊ីហ្គេមឆ្នាំ១៩៨២	Asienspiele 1982
អាស៊ីហ្គេមឆ្នាំ១៩៩០	Asienspiele 1990
អាស៊ីហ្គេមឆ្នាំ១៩៩៤	Asienspiele 1994
អាស៊ីហ្គេមឆ្នាំ១៩៩៨	Asienspiele 1998
Hongdu JL-8	Hongdu JL-8
ច្រកចូហរ	Straße von Johor
នគរលូ	Lu (Staat)
ត្រីរាជ	Mekong-Riesenwels
ទ្រឹស្តីបទស្តេអាត	Satz von Stewart
Yeghishe Charents	Jeghische Tscharenz
Hongdu L-15	Hongdu L-15
CAC/PAC JF-17 Thunder	Chengdu FC-1
ខេត្តរតនគិរី	Ratanakiri
បញ្ចក្ខន្ធ	Skandha
Gloomy Sunday	Gloomy Sunday (Lied)
ខេត្តហ្លួងព្រះបាង	Provinz Luang Prabang
ខេត្តកំពត	Kampot (Provinz)
សង្គ្រាមឥណ្ឌូចិនលើកទី១	Indochinakrieg
ខេត្តស្វាយរៀង	Svay Rieng (Provinz)
សង្គាយនា	Buddhistisches Konzil
ISO 9362	ISO 9362
ប៉ាកាយ៉ា	Pacaya
ទិវាអក្ខរកម្មអន្តរជាតិ	Weltalphabetisierungstag
ទ្រឹស្ដីបទការ៉េទាំង៤របស់ឡាហ្គ្រង់	Vier-Quadrate-Satz
សុត្តន្តបិដក	Suttapitaka
ខេត្តអូគីណាវ៉ា	Präfektur Okinawa
លានជល់ដំរី	Terrasse der Elefanten
គណបក្សប្រជាជនកម្ពុជា	Kambodschanische Volkspartei
អាស៊ីខាងត្បូង	Südasien
កំណាត់រង្វង់	Kreissegment
ខេត្តក្រចេះ	Kratie (Provinz)
ប្រាសាទបាគង	Bakong
ប្រាសាទបក្សីចាំក្រុង	Baksei Chamkrong
ប្រាសាទបន្ទាយស្រី	Banteay Srei
ប្រាសាទបាពួន	Baphuon
សមីការឌីផេរ៉ង់ស្យែលប៊ែរនូយី	Bernoullische Differentialgleichung
កណ្ដុរភ្នំ	Bambusratten
ឃុំបន្ទាយឆ្មារ	Banteay Chhmar
ខេត្តបាត់ដំបង	Battambang (Provinz)
តំបន់ត្រីកោណមាស	Goldenes Dreieck
ប្រាសាទបឹងមាលា	Beng Mealea
សង្គ្រាមផ្ទៃក្នុងកម្ពុជា	Kambodschanischer Bürgerkrieg
ESET	Eset
អាស៊ីហ្គេមរដូវរងារ	Winter-Asienspiele
ក្រុងយ៉ាណៃ	Yanai (Yamaguchi)
កុសិនារា	Kushinagar
KM	Kilometer
បញ្ជីព្រះមហាក្សត្រកម្ពុជា	Liste der Staatsoberhäupter von Kambodscha
ផ្លូវកណ្ដាល	Mittlerer Weg
ជម្រើសអ្នកប្រើប្រាស់	Haushaltstheorie
ខេត្តពោធិ៍សាត់	Pursat (Provinz)
ខេត្តស្ទឹងត្រែង	Stung Treng (Provinz)
ក្រុមប្រឹក្សាអូឡាំពិកអាស៊ី	Olympic Council of Asia
ច្រកកាលីម៉ាតា	Karimata-Straße
សារមន្ទីរទួលស្លែង	Tuol-Sleng-Genozid-Museum
ខេត្តកែប	Kep (Kambodscha)
ទ្រឹស្តីបទវីវីអានី	Satz von Viviani
បញ្ជីអ្នកទទួលបានជ័យលាភីណូបែលខាងរូបវិទ្យា	Liste der Nobelpreisträger für Physik
VietJet Air	VietJet Air
ភវវម៌្មទី១	Bhavavarman I.
ក្រុងសិរីសោភ័ណ	Sisophon
សាកលវិទ្យាល័យ ចុឡាលុងករណ៍	Chulalongkorn-Universität
Gallery of dependent territory flags	Flaggen und Wappen nichtselbständiger Gebiete
អនុគមន៍ស៊ីនុសកាឌីណាល់	Sinc-Funktion
ខេត្តព្រៃវែង	Prey Veng (Provinz)
អនុគមន៍ពហុហ្គាំម៉ា	Polygammafunktion
កប្ប	Kalpa (Mythologie)
ខ្សែទឹកអេក្វាទ័រខាងជើង	Nordäquatorialstrom
សាធារណរដ្ឋប្រជាមានិតកម្ពុជា	Volksrepublik Kampuchea
នគរវ្នំ	Funan
ក្រុងកំពត	Kampot
ខេត្តកំពង់ឆ្នាំង	Kampong Chhnang (Provinz)
ស៊ីហ្គេម	Südostasienspiele
ISO 3166-3	ISO 3166-3
ព្រះនាងមាយា	Maya (Mutter Buddhas)
ព្រះបាទជ័យវរ្ម័នទី៣	Jayavarman III.
ស៊ីសុវត្ថិ	Sisowath I.
ពោធិបក្ខិយធម៌	Bodhipakkhiyadhamma
ពោជ្ឈង្គ៧	Bojjhanga
ព្រហ្មវិហារធម៌	Brahmavihara
បាល់ទាត់កញ្ចុំផ្កាយ	Galactik Football
ការ​បញ្ចាំង​ស្លាយ	Tonbildschau
វីគីភីឌាភាសាខ្មែរ	Flüchtige organische Verbindungen
ចំប៉ីសៀម	Wüstenrosen
ជំនួយ:មាតិកា	Hilfe:Übersicht
ស៊ីហ្គេមលើកទី២៣	Südostasienspiele 2005
ច្បាប់ប្រលេឡូក្រាម	Parallelogrammgleichung
ចំនុចប៊្រូការ	Brocard-Punkte
មីក្រូម៉ែត្រការ៉េ	Größenordnung (Fläche)
ព្រៃវែង	Prey Veng
ធនធានដែលមិនកកើតឡើងវិញ	Nichterneuerbarer Rohstoff
ខ្សែទឹកអៀមីងហ្គើរ	Irmingerstrom
ស៊ីហ្គេមលើកទី១១	Südostasienspiele 1981
ជួរភ្នំដងរែក	Dongrek-Gebirge
ប្រាសាទព្រះខ័ន	Preah Khan
រូបមន្តញូតុន-កូត្ស	Newton-Cotes-Formeln
មធ្យមលោការីត	Logarithmisches Mittel
មធ្យមស្តូឡារស្គី	Stolarsky-Mittel
កបិលវត្ថុ	Kapilavastu
ស្វាកន្ទុយស	Schwarzschenkliger Kleideraffe
ប្រាសាទភ្នំក្រោម	Phnom Krom
Nanchang Q-5	Nanchang A-5
ស៊ីហ្គេមលើកទី២១	Südostasienspiele 2001
ពិធីបុណ្យមាឃបូជា	Magha Puja
ប្រដាល់សេរី	Pradal Serey
សុន សេន	Son Sen
គណកម្មាធិការអូឡាំពិកជប៉ុន	Japanisches Olympisches Komitee
ចំនួនតេត្រាអែក	Tetraederzahl
ក្រុងកំពង់ធំ	Kampong Thom
អង់រីកូ ពែរស៊ីកូ	Enrico Persico
ឧបាលិ	Upali
ភ្នំដា	Phnom Da
ព្រះពុទ្ធសាសនា​នៅ​ស្រីលង្កា	Buddhismus in Sri Lanka
ចំណុចរំពុះ	Siedepunkt
ក្រុងប៉ោយប៉ែត	Poipet
វិសមភាពភីដូ	Ungleichung von Pedoe
ត្រៃលក្ខណ៍	Drei Daseinsmerkmale
អាកាសយានដ្ឋានអន្តរជាតិភ្នំពេញ	Flughafen Phnom Penh
អក្សរខ្មែរ	Khmer-Schrift
អាកាសយានដ្ឋានអន្តរជាតិសៀមរាបអង្គរ	Flughafen Siem Reap-Angkor
បច្ចេកវិទ្យាសារពត៌មាន	Online-Journalismus
ក្មេងទំនើង	Jugendkriminalität
ចេនឡា	Chenla
ប្រកែកនយោបាយថៃ ស.ក.២០១០	Unruhen in Bangkok 2010
ស្ដេចចក្រពត្តិ	Chakravartin
តថាគត	Tathagata
ប្រាសាទនាគព័ន្ធ	Neak Pean
ជា ស៊ីម	Chea Sim
នគរឆឹន	Chen (Staat)
ប្រព័ន្ធផ្សព្វផ្សាយសុក្រិត្យ	Social Media Optimization
អាំងតេក្រាលប្តូរអថេរ	Integration durch Substitution
កម្មវីធីសូនីវីហ្គាស	Sony Vegas
ស៊ីហ្គេមលើកទី២៥	Südostasienspiele 2009
ខ្សែទឹកអេក្វាទ័រខាងត្បូង	Südäquatorialstrom
សិក្ខាបទ៥	Fünf Silas
កងទ័ពអេហ្ស៊ីប	Streitkräfte Ägyptens
ប្រាសាទប្រែរូប	Pre Rup
ប្រាសាទក្រវាន់	Prasat Kravan
ប្រាសាទព្រះគោ	Preah Ko
ប្រាសាទលលៃ	Lolei
ប្រាសាទតាសោម	Ta Som
ស្ពានថ្ម	Spean Thma
CAIC Z-10	WZ-10
អាំងតេក្រាលត្រីកោណមាត្រ	Integralkosinus
សមីការឌីផេរ៉ងស្យែលក្លែរ៉ូ	Clairautsche Differentialgleichung
ខ្សែទឹកណរវេយ	Norwegischer Strom
ទង់ព្រះពុទ្ធសាសនា	Internationale Buddhistische Flagge
មករ	Makara (Mythologie)
តំបន់អឌ្ឍច័ន្ទមាស	Goldener Halbmond
បណ្ឌិត្យ​សភា​នីតិ​អន្តរជាតិ​នៃ​ទីក្រុង​ឡាអេ	Haager Akademie für Völkerrecht
ស៊ីហ្គេមលើកទី២៦	Südostasienspiele 2011
សម្រែកនៃដុលោរ៉េស៏	Grito de Dolores
Shenyang J-11	Shenyang J-11
មុំក្នុង	Innenwinkel
ផ្នែកពិត	Realteil
សមីការហ៊ីល	Hillsche Differentialgleichung
វិសមភាព វេតស្សឹនបុក	Ungleichung von Weitzenböck
Kawasaki OH-1	Kawasaki OH-1
កីឡាអាស៊ីខាងកើត	Ostasienspiele
ស៊ីហ្គេមលើកទី២០	Südostasienspiele 1999
បុណ្យ តារា	Tanabata
ក្រុមមិត្តភក្តិ (Peer group)	Peergroup
ក្រុងតាកែវ	Takeo (Kambodscha)
សមីការកូស៊ី-អយល័រ	Eulersche Differentialgleichung
ស្ពានខាន់ម៉ុងក្យូ	Kammon-Brücke
កីឡាអាស៊ីខាងត្បូង	Südasienspiele
OSGeo	Open Source Geospatial Foundation
វិគីភីឌា:ស្ថានទូតខ្មែរ	Wikipedia:Botschaft
Bottleneck	Flaschenhals (Logistik)
ប្រៃសណីយ៍ភ័ណ្ឌ	Postpaket
ស៊ីហ្គេមលើកទី១៩	Südostasienspiele 1997
ស៊ីហ្គេមលើកទី២៧	Südostasienspiele 2013
ស៊ីហ្គេមលើកទី១៧	Südostasienspiele 1993
ស៊ីហ្គេមលើកទី១០	Südostasienspiele 1979
ស៊ីហ្គេមលើកទី២៤	Südostasienspiele 2007
ស៊ីហ្គេមលើកទី១៤	Südostasienspiele 1987
ទីឃនិកាយ	Digha-Nikaya
នវវិទ្យា	Theologischer Rationalismus
រដ្ឋសភាជាតិកម្ពុជា	Nationalversammlung (Kambodscha)
អនុគមន៍ទ្រីហ្គាំម៉ា	Trigamma-Funktion
ហ្វ្រង់កូ រ៉ាសិតទី	Franco Rasetti
វ៉ន វេត	Vorn Vet
កូស៊ីនុសអ៊ីពែបូលីក	Kosinus Hyperbolicus
កូស៊ីនុស	Kosinus
វិទ្យុតាមអ៊ីនធើណែត	Digitalradio
តូនី វ៉ាការ៉ូ	Tony Vaccaro
កោះទន្សាយ	Koh Tonsay
តង់សង់អ៊ីពែបូលីក	Tangens Hyperbolicus
ស៊ីនុសអ៊ីពែបូលីក	Sinus Hyperbolicus
កីឡាឧបទ្វីបអាស៊ីអាគ្នេយ៍លើកទី៣	Südostasienspiele 1965
កីឡាឧបទ្វីបអាស៊ីអាគ្នេយ៍លើកទី៤	Südostasienspiele 1967
កីឡាឧបទ្វីបអាស៊ីអាគ្នេយ៍លើកទី៦	Südostasienspiele 1971
កីឡាឧបទ្វីបអាស៊ីអាគ្នេយ៍លើកទី៨	Südostasienspiele 1975
ឈូងសមុទ្រ	Golf (Meer)
គមនាគមន៍កម្ពុជា	Liste der Fernstraßen in Kambodscha
អនុគមន៍ហ្គុឌែរម៉ាន់	Gudermannfunktion
វិធីសាស្រ្តហ្រ្វូបេនៀស	Frobenius-Methode
សាកលវិទ្យាល័យអាគីតា	Universität Akita
ចន វ៉នណុក	John Warnock
អភិបាលកិច្ចល្អ	Gute Regierungsführung
ឃុនបរម	Khun Borom
មួយម៉ូនីកា	Agnes Monica
Candies	Candies
កីឡាឧបទ្វីបអាស៊ីអាគ្នេយ៍លើកទី១	Südostasienspiele 1959
កីឡាអាស៊ីខាងកើតឆ្នាំ២០០៥	Ostasienspiele 2005
កីឡាឧបទ្វីបអាស៊ីអាគ្នេយ៍លើកទី២	Südostasienspiele 1961
ស៊ីហ្គេមលើកទី១៦	Südostasienspiele 1991
ស៊ីហ្គេមលើកទី១៥	Südostasienspiele 1989
ស៊ីហ្គេមលើកទី១៨	Südostasienspiele 1995
កីឡាឧបទ្វីបអាស៊ីអាគ្នេយ៍លើកទី៧	Südostasienspiele 1973
សាកលវិទ្យាល័យហ្វឹគឹអ៊ី	Universität Fukui
ស៊ីហ្គេមលើកទី២២	Südostasienspiele 2003
ស៊ីហ្គេមលើកទី១៣	Südostasienspiele 1985
ស៊ីហ្គេមលើកទី១២	Südostasienspiele 1983
ទ្រឹស្តីបទកាសី	Satz von Casey
ប្រាសាទព្រះប៉ាលីឡៃ	Preah Palilay
ESET NOD32 Antivirus	Eset NOD32
វិគីភីឌា:Glossary	Hilfe:Glossar
នីវរណធម៌	Nivarana
បុណ្យ	Tham bun
ចំណាត់ថ្នាក់ក្រុម:ប្រទេសជប៉ុន	Kategorie:Japan
ចំណាត់ថ្នាក់ក្រុម:ម៉ិកសិច	Kategorie:Mexiko
វិធីសាស្រ្តក្នុងការទំនាក់ទំនង	Kommunikationsmodell
ទ្រឹស្តីបទប្រាម៉ាហ្គឹបតា	Satz von Brahmagupta
ចេមនិងផ្លែប៉ែសយក្ស	James und der Riesenpfirsich (Roman)
ស្ងោរជ្រក់សាច់មាន់	Hühnersuppe
បន្ទប់សារពត៌មាន	Newsdesk
ចំណាត់ថ្នាក់ក្រុម:ឥណ្ឌូនេស៊ី	Kategorie:Indonesien
ចំណាត់ថ្នាក់ក្រុម:សិង្ហបុរី	Kategorie:Singapur
ចំណាត់ថ្នាក់ក្រុម:រូបវិទ្យា	Kategorie:Physik
ចំណាត់ថ្នាក់ក្រុម:វិទ្យាសាស្រ្តធម្មជាតិ	Kategorie:Naturwissenschaft
ចំណាត់ថ្នាក់ក្រុម:ជីវវិទ្យា	Kategorie:Biologie
ចំណាត់ថ្នាក់ក្រុម:សាសនា	Kategorie:Religion
ចំណាត់ថ្នាក់ក្រុម:កីឡា	Kategorie:Sport
ចំណាត់ថ្នាក់ក្រុម:វិទ្យាសាស្ត្រ	Kategorie:Wissenschaft
ប្រជាមតិទាក់ទងនឹងឯករាជភាពរបស់ស្កុតឡែនឆ្នំា២០១៤	Referendum über die Unabhängigkeit Schottlands
សំយុត្តនិកាយ	Samyutta-Nikaya
សំយោជនៈ	Wiedergeburt (Buddhismus)
ខួច​គូថ	Michaelis-Raute
G8+5	G8+5
ចំនួនហ្គាលីលេ	Galilei-Zahl
ត្រីគល់រាំង	Riesenbarbe
ប្រវត្តិសាស្រ្តរបស់ទូរទស្សន៍	Geschichte des Fernsehens
ប្រវត្តិវិទ្យុ	Geschichte des Hörfunks
ប្រវត្តិសាស្រ្តអ្នកកាសែត	Geschichte des Journalismus
ប្រវត្តិច្បាប់រក្សាសិទ្ធ	Geschichte des Urheberrechts
Honda HA-420 HondaJet	Honda HA-420
ទ្រឹស្ដីនៃពណ៌	Farbenlehre
នើនដូ	Nuendo
នពតល ប៉័ទមៈ	Noppadon Pattama
ស្ករត្នោត	Palmzucker
អង្គាបុស្ប	Jasminbaum
Guizhou JL-9	Guizhou JL-9
ប្រាសាទភ្នំជីសូរ	Phnom Chisor
កោះរុង	Koh Rong
ស្ដង់ដា	Standard (Begriffsklärung)
ខុទ្ទកនិកាយ	Khuddaka-Nikaya
ប៉ាន់ រិទ្ធី	Rithy Panh
ជីវក	Jivaka Kumar Bhaccha
ទំព័រគំរូ:Dts	Vorlage:Dts
បុណ្យកឋិន	Kathin-Zeremonie
គែន	Khaen
វិសមភាព កុលហ្គោម៉ូរ៉ូវ	Kolmogorow-Ungleichung
ទីក្រុងរ៉ូមបុរាណ	Römisches Reich
ប្រាសាទកោះកេរ	Koh Ker
អាំងតេក្រាលមាឌ	Volumenintegral
ការវាយប្រហារដែនអាកាសនៅទីក្រុងបេកដាត ថ្ងៃទី ១២ កក្តដា ២០០៧	Luftangriffe in Bagdad vom 12. Juli 2007
ទ្រឹស្តីបទរូទ	Satz von Routh
ក្លឹបបាល់ទាត់ ភ្នំពេញក្រោន	Phnom Penh Crown
វត្តភ្នំ	Wat Phnom
ប្រាសាទសំបូរព្រៃគុក	Sambor Prei Kuk
គណបក្សសិទ្ធិមនុស្ស	Menschenrechtspartei (Kambodscha)
អាគីតា	Akita
ទ្រឹស្ដីបទវ៉ារីញ៉ុង	Satz von Varignon
អនុគមន៍ហ្សេតាបឋម	Primzetafunktion
កូវែស៊ីនុស	Kosinus versus
ចំណាយរដ្ឋាភិបាល	Staatsausgaben
អ្នកសារពត័មាន	Journalist
ចំណាត់ថ្នាក់ក្រុម:អូឡាំពិក	Kategorie:Olympische Spiele
ចំណាត់ថ្នាក់ក្រុម:ព្រះពុទ្ធសាសនា	Kategorie:Buddhismus
ប្រអប់ខ្សាច់	Sandkasten (Begriffsklärung)
ណូរី	Norry
ពហុកីឡដ្ឋានជាតិអូឡាំពិក	Olympiastadion Phnom Penh
កិច្ចតែងការ	Unterrichtsplanung
ជំងឺរលាកបំពង់ក	Pharyngitis
ទេសចរបារាំង	Tourismus in Frankreich
ឃុំប្រាសាទ (ស្រុកព្រះនេត្រព្រះ)	Prasat
អង្គការសង្គមអភិរក្សសត្វព្រៃ	Wildlife Conservation Society
សាកលវិទ្យាល័យអប់រំអៃឈិ	Pädagogische Hochschule Aichi
ប្រាសាទព្រះពិធូរ	Preah Pithu
ខេត្តបលិខាំសៃ	Provinz Bolikhamsai
ភ្នំឧដុង្គ	Udong
ទ្រឹស្តីបទមីកេល	Satz von Miquel
ដប់ប្រាំពីរមេសាជោគជ័យ	Dap Prampi Mesa Chokchey
ស៊ីនុសអាំងតេក្រាល	Integralsinus
ទំព័រគំរូ:Location map USA2	Vorlage:Positionskarte USA 48
ទ្រឹស្តីបទអូស្រ្តូស្គី	Satz von Ostrowski
ចំណាត់ថ្នាក់ក្រុម:ទ្វីប	Kategorie:Kontinent
ចំណាត់ថ្នាក់ក្រុម:ភូមិវិទ្យា	Kategorie:Geologie
ចំណាត់ថ្នាក់ក្រុម:យន្តហោះ	Kategorie:Luftfahrzeug
ឆាលេស ហ្គេសស្គី	Charles Geschke
ទំព័រគំរូ:ប្រព័ន្ធព្រះអាទិត្យ	Vorlage:Navigationsleiste Sonnensystem
វិគីភីឌា:សារ ទំព័រគំរូ/លំហឈ្មោះ ការពិភាក្សារបស់អ្នកប្រើប្រាស់	Wikipedia:Textbausteine/Benutzerseiten
ពីរ៉ាមីត	Pyramide (Geometrie)
ទេវទហៈ	Devdaha
ពន្ធតែមប្រិ៍	Stempelsteuer
ជំនួយ:ការកត់ឈ្មោះចូល	Hilfe:Anmelden
គ្រោះមហន្តរាយ	Katastrophe
វិគីភីឌា:Reference desk	Wikipedia:Auskunft
ទំព័រគំរូ:Authority control	Vorlage:Normdaten
ទំព័រគំរូ:Quote	Vorlage:Zitat
ទំព័រគំរូ:Location map Scotland	Vorlage:Positionskarte Schottland
ទំព័រគំរូ:Location map England	Vorlage:Positionskarte England
ចំណាត់ថ្នាក់ក្រុម:សេដ្ឋកិច្ច	Kategorie:Wirtschaftswissenschaft
វិគីភីឌា:សុំប្តូរអត្តនាម	Wikipedia:Benutzernamen ändern
ចំណាត់ថ្នាក់ក្រុម:ជនជាតិ ភាគតិច ក្នុង ប្រទេស កម្ពុជា	Kategorie:Ethnie in Kambodscha
វិគីភីឌា:Oversight	Wikipedia:Oversight
វិគីភីឌា:IP block exemption	Wikipedia:IP-Sperre-Ausnahme
វិគីភីឌា:រូបយន្ត	Wikipedia:Bots
ចំណាត់ថ្នាក់ក្រុម:Hidden categories	Kategorie:Kategorie:Versteckt
វិសមភាពភីត្រឹ	Peetre-Ungleichung
អេហ៊្សីប	Ägypten
ជំនួយ:ទំព័រគំរូ	Hilfe:Vorlagen
វិគីភីឌា:វិគីគម្រោង	Wikipedia:WikiProjekt
ទំព័រគំរូ:Bot	Vorlage:Bot
វិគីភីឌា:អ្វីៗដែលវិគីភីឌាមិនអនុញ្ញាត	Wikipedia:Was Wikipedia nicht ist
អាម៉ុក	Amok (Khmer)
កាណាដា	Kanada
ចំណាត់ថ្នាក់ក្រុម:ប្រទេសអាយឡែន	Kategorie:Island
វិគីភីឌា:អំពីវិគីភីឌា	Wikipedia:Über Wikipedia
ចំណាត់ថ្នាក់ក្រុម:ខ្នាតក្រលាផ្ទៃ	Kategorie:Flächeneinheit
ជំនួយ:ពាក្យទិព្វ	Hilfe:Variablen
ចំណាត់ថ្នាក់ក្រុម:អឺរ៉ុប	Kategorie:Europa
ចំណាត់ថ្នាក់ក្រុម:បច្ចេកវិទ្យា	Kategorie:Sachsystematik
ចំណាត់ថ្នាក់ក្រុម:ជំនួយក្នុងវិគីភីឌា	Kategorie:Wikipedia:Hilfe
វិគីភីឌា:ទំព័រអ្នកប្រើប្រាស់	Hilfe:Benutzernamensraum
ទំព័រគំរូ:Documentation	Vorlage:Dokumentation
វិគីភីឌា:អ្នកប្រើប្រាស់	Hilfe:Benutzer
វិគីភីឌា:Protection policy	Wikipedia:Geschützte Seiten
វិគីភីឌា:WikiLove	Wikipedia:Wikiliebe
វិគីភីឌា:Userboxes	Benutzer:Vorlage
វិគីភីឌា:ហត្ថលេខា	Hilfe:Signatur
វិគីភីឌា:លក្ខណៈវិនិច្ឆ័យនៃលុបជាបន្ទាន់	Wikipedia:Schnelllöschantrag
វិគីភីឌា:Most wanted articles	Wikipedia:Artikelwünsche
វិគីភីឌា:Huggle	Wikipedia:Huggle
ទំព័រគំរូ:Softredirect	Vorlage:Interwiki redirect
ទំព័រគំរូ:លុបជាបន្ទាន់	Vorlage:Löschen
ក្លោងទ្វារ:ចិន	Portal:China
វិគីភីឌា:វិគីគម្រោង ជីវប្រវត្តិ	Wikipedia:WikiProjekt Biografien
ទំព័រគំរូ:Succession	Vorlage:Personenleiste
ជំនួយ:ប្រអប់ព័ត៌មាន	Hilfe:Infoboxen
ចំណាត់ថ្នាក់ក្រុម:ភាសា	Kategorie:Einzelsprache als Thema
ចំណាត់ថ្នាក់ក្រុម:វេយ្យាករណ៍	Kategorie:Grammatik
ចំណាត់ថ្នាក់ក្រុម:វិគីភីឌា	Kategorie:Wikipedia
វិគីភីឌា:ការបដិសេធ ទូទៅ	Wikipedia:Impressum
ជំនួយ:ចំណាត់ថ្នាក់ក្រុម	Hilfe:Kategorien
វិគីភីឌា:សារទំព័រគំរូ	Wikipedia:Textbausteine
វិគីភីឌា:អសង្ស័យកម្ម	Wikipedia:Formatierung
Portal:Contents/Portals	Portal:Wikipedia nach Themen
ទំព័រគំរូ:Navbox	Vorlage:Erweiterte Navigationsleiste
ជំនួយ:រូបមន្ត	Hilfe:TeX
ដេវិឌ ឆាណ្ឌល័រ	David P. Chandler
ជំនួយ:តំណភ្ជាប់	Hilfe:Links
តំបន់ពាណិជ្ជកម្មសេរី	Freihandelsabkommen
ទំព័រគំរូ:Error	Vorlage:Vorlagenfehler
ទំព័រគំរូ:Loop	Vorlage:Grafische Zeitleiste/Loop
ទំព័រគំរូ:Void	Vorlage:NULL
ទំព័រគំរូ:Key press	Vorlage:Taste
ទំព័រគំរូ:Sc	Vorlage:Kapitälchen
ទំព័រគំរូ:Clear	Vorlage:Absatz
ទំព័រគំរូ:Color	Vorlage:Blau
ទំព័រគំរូ:Nowrap	Vorlage:Nowrap
ទំព័រគំរូ:Bots	Vorlage:Bots
វិគីភីឌា:វិគីគម្រោង ទំព័រគំរូ	Wikipedia:WikiProjekt Vorlagen
ទ្រឹស្តីបទមុំក្រៅ	Außenwinkelsatz
ចំណាត់ថ្នាក់ក្រុម:ខ្សែកោង	Kategorie:Geometrische Kurve
ទំព័រគំរូ:Babel	Vorlage:Babel
ទំព័រគំរូ:Commons	Vorlage:Commons
ទំព័រគំរូ:NavPeriodicTable	Vorlage:Periodensystem
វិគីភីឌា:Citing sources	Wikipedia:Literatur
ទំព័រគំរូ:User af-1	Vorlage:User af-1
ទំព័រគំរូ:User als-1	Vorlage:User als-1
ទំព័រគំរូ:User az	Vorlage:User az
ទំព័រគំរូ:User bar-1	Vorlage:User bar-1
ទំព័រគំរូ:See also	Vorlage:Siehe auch
ទំព័រគំរូ:User de	Vorlage:User de
ទំព័រគំរូ:User de-1	Vorlage:User de-1
ទំព័រគំរូ:User et-1	Vorlage:User et-1
ទំព័រគំរូ:User el	Vorlage:User el
ទំព័រគំរូ:User es	Vorlage:User es
ទំព័រគំរូ:User de-3	Vorlage:User de-3
ទំព័រគំរូ:User en-3	Vorlage:User en-3
ទំព័រគំរូ:User en-1	Vorlage:User en-1
ទំព័រគំរូ:User en-2	Vorlage:User en-2
ទំព័រគំរូ:User en-4	Vorlage:User en-4
ទំព័រគំរូ:User fi	Vorlage:User fi
ទំព័រគំរូ:User en-0	Vorlage:User en-0
ទំព័រគំរូ:User es-4	Vorlage:User es-4
ទំព័រគំរូ:User en	Vorlage:User en
ទំព័រគំរូ:User de-2	Vorlage:User de-2
ទំព័រគំរូ:User es-1	Vorlage:User es-1
ទំព័រគំរូ:User fa	Vorlage:User fa
ទំព័រគំរូ:User fr-1	Vorlage:User fr-1
ទំព័រគំរូ:User id-3	Vorlage:User id-3
ទំព័រគំរូ:User it-3	Vorlage:User it-3
ទំព័រគំរូ:User tr-2	Vorlage:User tr-2
ទំព័រគំរូ:User fr-2	Vorlage:User fr-2
ទំព័រគំរូ:User tr	Vorlage:User tr
ទំព័រគំរូ:User ja	Vorlage:User ja
ទំព័រគំរូ:User ja-1	Vorlage:User ja-1
ទំព័រគំរូ:User it-1	Vorlage:User it-1
ទំព័រគំរូ:User fr	Vorlage:User fr
ទំព័រគំរូ:User gsw-1	Vorlage:User gsw-1
ទំព័រគំរូ:Location map/Info	Vorlage:Positionskarte/Info
ចំណាត់ថ្នាក់ក្រុម:Navigational boxes	Kategorie:Vorlage:Navigationsleiste
ចំណាត់ថ្នាក់ក្រុម:អាស៊ី	Kategorie:Asien
ចំណាត់ថ្នាក់ក្រុម:User uk-N	Kategorie:User uk-M
ទំព័រគំរូ:Lang-ja	Vorlage:JaS
ទំព័រគំរូ:Football squad player	Vorlage:Football squad player
ទំព័រគំរូ:Mod	Vorlage:Modulo
ទំព័រគំរូ:Now Commons	Vorlage:NowCommons
ទំព័រគំរូ:User it	Vorlage:User it
ទំព័រគំរូ:User uk	Vorlage:User uk
ទំព័រគំរូ:User es-2	Vorlage:User es-2
ទំព័រគំរូ:ស្វាគមន៍	Vorlage:Willkommen
ទំព័រគំរូ:Month header	Vorlage:Navigationsleiste Monate
ចំណាត់ថ្នាក់ក្រុម:ទំព័រគំរូសំរាប់កូអរដោនេ	Kategorie:Vorlage:mit Koordinate
ទំព័រគំរូ:USA	Vorlage:USA
ចំណាត់ថ្នាក់ក្រុម:User ms	Kategorie:User ms
ទំព័រគំរូ:Football kit	Vorlage:Football kit
ទំព័រគំរូ:Wikiatlas	Vorlage:Wikiatlas
ចំណាត់ថ្នាក់ក្រុម:User fr-1	Kategorie:User fr-1
ទំព័រគំរូ:Wikiquote	Vorlage:Wikiquote
ទំព័រគំរូ:Image label	Vorlage:Image label
ទំព័រគំរូ:Infobox television	Vorlage:Infobox Fernsehsendung
ទំព័រគំរូ:Prose	Vorlage:Nur Liste
ទំព័រគំរូ:ទិន្នន័យ​នៃប្រទេសប៉ាឡេស្ទីន	Vorlage:PSE
ទំព័រគំរូ:Sidebar	Vorlage:Seitenleiste
ទំព័រគំរូ:In use	Vorlage:In Bearbeitung
ទំព័រគំរូ:Update	Vorlage:Veraltet
ទំព័រគំរូ:ប្រអប់ព័ត៌មាន មន្ទីរពេទ្យ	Vorlage:Infobox Krankenhaus
ទំព័រគំរូ:ប្រអប់ព័ត៌មាន ទស្សនាវដ្ដី	Vorlage:Infobox Publikation
ទំព័រគំរូ:Image requested	Vorlage:Bilderwunsch
ទំព័រគំរូ:ប្រអប់ព័ត៌មាន ភ្លេងជាតិ	Vorlage:Infobox Nationalhymne
ទំព័រគំរូ:ទិន្នន័យ​នៃប្រទេសគាហ្គីស្ថាន	Vorlage:KGZ
ទំព័រគំរូ:ប្រអប់ព័ត៌មាន សាលារៀន	Vorlage:Infobox Schule
ទំព័រគំរូ:Userboxbottom	Vorlage:Userboxbottom
ទំព័រគំរូ:Copy to Wikimedia Commons	Vorlage:Commonsfähig
ទំព័រគំរូ:Rnd	Vorlage:Siground
ទំព័រគំរូ:ចំណាត់ថ្នាក់ក្រុមនៃទំព័រគំរូ	Vorlage:Vorlagenkategorie
ទំព័រគំរូ:ប្រអប់ព័ត៌មាន ប្រទេស	Vorlage:Infobox Staat
ទំព័រគំរូ:Max	Vorlage:Max
ទំព័រគំរូ:Infobox software	Vorlage:Infobox Software
ទំព័រគំរូ:Infobox airline	Vorlage:Infobox Fluggesellschaft
ទំព័រគំរូ:Wide image	Vorlage:Panorama
ទំព័រគំរូ:ប្រអប់ព័ត៌មាន ជម្លោះយោធា	Vorlage:Infobox Militärischer Konflikt
ទំព័រគំរូ:Redirect4	Vorlage:Str left
ទំព័រគំរូ:Resolved	Vorlage:Erl.
ទំព័រគំរូ:Str sub long	Vorlage:Str sub
ទំព័រគំរូ:ទិន្នន័យ​នៃប្រទេសហ្វីលីពីន	Vorlage:PHL
ទំព័រគំរូ:ប្រអប់ព័ត៌មាន គណបក្សនយោបាយ	Vorlage:Infobox Partei
ទំព័រគំរូ:ប្រអប់ព័ត៌មាន ល្បែងវីដេអូ	Vorlage:Infobox Computer- und Videospiel
ទំព័រគំរូ:Age in years and days	Vorlage:Alter in Jahren und Tagen
ទំព័រគំរូ:Nom	Vorlage:Nominiert
ទំព័រគំរូ:Cleanup	Vorlage:Überarbeiten
ទំព័រគំរូ:ប្រអប់ព័ត៌មាន សាកលវិទ្យាល័យ	Vorlage:Infobox Hochschule
ទំព័រគំរូ:Cite journal	Vorlage:Cite journal
ទំព័រគំរូ:ទិន្នន័យ​នៃប្រទេសប្រ៊ុយណេ	Vorlage:BRN
ទំព័រគំរូ:វិគីសៀវភៅ	Vorlage:Wikibooks
ទំព័រគំរូ:Familytree	Vorlage:Stammbaum
ទំព័រគំរូ:Featured article	Vorlage:Exzellent
ចំណាត់ថ្នាក់ក្រុម:User en-4	Kategorie:User en-4
ចំណាត់ថ្នាក់ក្រុម:User en	Kategorie:User en
ចំណាត់ថ្នាក់ក្រុម:User zh	Kategorie:User zh
ចំណាត់ថ្នាក់ក្រុម:User zh-N	Kategorie:User zh-M
ចំណាត់ថ្នាក់ក្រុម:User en-2	Kategorie:User en-2
ទំព័រគំរូ:ប្រអប់ព័ត៌មាន	Vorlage:Infobox
ទំព័រគំរូ:Infobox instrument	Vorlage:Infobox Musikinstrument
ទំព័រគំរូ:TOC right	Vorlage:TOCright
ទំព័រគំរូ:RankedMedalTable	Vorlage:Medaillentabelle
ទំព័រគំរូ:User zh	Vorlage:User zh
ទំព័រគំរូ:Legend	Vorlage:Farblegende
ទំព័រគំរូ:ប្រអប់ព័ត៌មាន បណ្ណាល័យ	Vorlage:Infobox Bibliothek
ទំព័រគំរូ:Cite web	Vorlage:Cite web
ទំព័រគំរូ:YouTube	Vorlage:YouTube
ទំព័រគំរូ:Current	Vorlage:Laufendes Ereignis
ទំព័រគំរូ:Won	Vorlage:Gewonnen
ទំព័រគំរូ:Min	Vorlage:Min
ទំព័រគំរូ:Wiktionary	Vorlage:Wiktionary
ទំព័រគំរូ:Bar box	Vorlage:Balkendiagramm
ទំព័រគំរូ:Lang-sr	Vorlage:SrS
ទំព័រគំរូ:Infobox settlement	Vorlage:Infobox Ort
ទំព័រគំរូ:User ru	Vorlage:User ru
ទំព័រគំរូ:Admin	Vorlage:Admininfo
ទំព័រគំរូ:IPA	Vorlage:IPA-Text
ទំព័រគំរូ:អត្ថន័យដទៃទៀត	Vorlage:Begriffsklärungshinweis
ទំព័រគំរូ:Archive box	Vorlage:Archivübersicht
វិគីភីឌា:Text of GNU Free Documentation License	Wikipedia:GNU Free Documentation License
ទំព័រគំរូ:រង្វាន់ណូបែល	Vorlage:Navigationsleiste Nobelpreise
ទំព័រគំរូ:Sisterlinks	Vorlage:Schwesterprojekte
ទំព័រគំរូ:ប្រអប់ព័ត៌មាន តំបន់ការពារ	Vorlage:Infobox Nationalpark
ទំព័រគំរូ:Birth category header	Vorlage:Kategorie Ge
ចំណាត់ថ្នាក់ក្រុម:ជ័យលាភីរង្វាន់ណូបែល ផ្នែករូបវិទ្យា	Kategorie:Nobelpreisträger für Physik
ចំណាត់ថ្នាក់ក្រុម:ជ័យលាភីរង្វាន់ណូបែល ផ្នែកគីមីវិទ្យា	Kategorie:Nobelpreisträger für Chemie
ទំព័រគំរូ:GeoGroup	Vorlage:All Coordinates
ទំព័រគំរូ:ParmPart	Vorlage:ParmPart
ទំព័រគំរូ:Infobox OS	Vorlage:Infobox Betriebssystem
ទំព័រគំរូ:ប្រអប់ព័ត៌មាន ភព	Vorlage:Infobox Planet
ទំព័រគំរូ:Compact periodic table	Vorlage:Navigationsleiste Periodensystem
ទំព័រគំរូ:Lang-fa	Vorlage:FaS
ទំព័រគំរូ:ទិន្នន័យ​នៃប្រទេសម៉ាឡេស៊ី	Vorlage:MYS
ទំព័រគំរូ:Infobox website	Vorlage:Infobox Website
ទំព័រគំរូ:Globalize	Vorlage:Staatslastig
ទំព័រគំរូ:Image label end	Vorlage:Image label end
ទំព័រគំរូ:Documentation subpage	Vorlage:Dokumentation/Dokuseite
ទំព័រគំរូ:ទិន្នន័យ​នៃប្រទេសឥណ្ឌូនេស៊ី	Vorlage:IDN
ទំព័រគំរូ:Talk header for guidelines	Vorlage:Diskussionsseite
ទំព័រគំរូ:CcTLD	Vorlage:Navigationsleiste ccTLD
ទំព័រគំរូ:Cc-by-2.0	Vorlage:Bild-CC-by/2.0
ទំព័រគំរូ:Rtl-lang	Vorlage:Rtl-lang
ទំព័រគំរូ:ប្រអប់ព័ត៌មានទីកន្លែងកេរដំណែលពិភពលោក	Vorlage:Infobox Welterbe
ទំព័រគំរូ:Str len	Vorlage:Str len
ទំព័រគំរូ:Purge	Vorlage:Purge
ទំព័រគំរូ:Lang-de	Vorlage:DeS
ទំព័រគំរូ:Lang-la	Vorlage:LaS
ទំព័រគំរូ:ប្រអប់ព័ត៌មាន អាគារ	Vorlage:Infobox Bauwerk
ទំព័រគំរូ:Lang-el	Vorlage:GrS
ទំព័រគំរូ:ទិន្នន័យ​នៃប្រទេសអារ៉ាប៊ីសាអូឌីត	Vorlage:SAU
ទំព័រគំរូ:User page	Vorlage:Wikipedia-Benutzer
ទំព័រគំរូ:DE	Vorlage:DEU
ទំព័រគំរូ:ប្រអប់ព័ត៌មាន ព្រះវិហារគ្រិស្ដសាសនា	Vorlage:Infobox Kirchengebäude
ទំព័រគំរូ:ផ្នែក និងទឹកដីនាយសមុទ្ររបស់បារាំង	Vorlage:Navigationsleiste Französische Überseegebiete
ទំព័រគំរូ:User	Vorlage:Benutzer
ទំព័រគំរូ:Spoken Wikipedia	Vorlage:Gesprochene Version
ទំព័រគំរូ:វិគីភីឌាភាសា	Vorlage:Navigationsleiste Wikipedia-Sprachversionen
ទំព័រគំរូ:Refimprove	Vorlage:Belege fehlen
ទំព័រគំរូ:ស្នើសុំប្ដូរឈ្មោះ	Vorlage:Renameuser
ទំព័រគំរូ:CIA World Factbook link	Vorlage:CIA-Factbook
ទំព័រគំរូ:Image label small	Vorlage:Image label small
ទំព័រគំរូ:Featured article candidates	Vorlage:Kandidat
ទំព័រគំរូ:AddNewSection	Vorlage:AddNewSection
ទំព័រគំរូ:Nihongo	Vorlage:Nihongo
ទំព័រគំរូ:User fr-3	Vorlage:User fr-3
ទំព័រគំរូ:JPN	Vorlage:JPN
ជំនួយ:តារាង	Hilfe:Tabellen
ទំព័រគំរូ:Gbmapping	Vorlage:Gbmappingsmall
ទំព័រគំរូ:ទិន្នន័យ​នៃប្រទេសប៉ាគីស្ថាន	Vorlage:PAK
ទំព័រគំរូ:Age in days nts	Vorlage:Tagesdifferenz
ទំព័រគំរូ:Nations at the 2008 Summer Olympics	Vorlage:Navigationsleiste Teilnehmer Olympische Sommerspiele 2008
ទំព័រគំរូ:JULIANDAY	Vorlage:JULIANDAY
ទំព័រគំរូ:Disagree	Vorlage:Kontra
ទំព័រគំរូ:DNB portal	Vorlage:DNB-Portal
ទំព័រគំរូ:Talkarchive	Vorlage:Archiv
ទំព័រគំរូ:ទិន្នន័យ​នៃប្រទេសអ៊ីរ៉ង់	Vorlage:IRN
ទំព័រគំរូ:ទិន្នន័យ​នៃប្រទេសហ្សកដង់	Vorlage:JOR
ទំព័រគំរូ:Bibleverse	Vorlage:Bibel
ទំព័រគំរូ:ទិន្នន័យ​នៃប្រទេសហុងកុង	Vorlage:HKG
ទំព័រគំរូ:ទិន្នន័យ​នៃប្រទេសកូរ៉េខាងជើង	Vorlage:PRK
ទំព័រគំរូ:Infobox continent	Vorlage:Infobox Kontinent
ទំព័រគំរូ:Date	Vorlage:Datum
ទំព័រគំរូ:BHU	Vorlage:BTN
ទំព័រគំរូ:ទិន្នន័យ​នៃប្រទេសសិង្ហបុរី	Vorlage:SGP
ទំព័រគំរូ:ទិន្នន័យ​នៃប្រទេសឥណ្ឌា	Vorlage:IND
ទំព័រគំរូ:ទិន្នន័យ​នៃប្រទេសម៉ាកាវ	Vorlage:CN-92
ទំព័រគំរូ:សបា្ដហ៍	Vorlage:Navigationsleiste Wochentage
ទំព័រគំរូ:Colors	Vorlage:W3C-Farben
ចំណាត់ថ្នាក់ក្រុម:User ja-N	Kategorie:User ja-M
ទំព័រគំរូ:Lang-ru	Vorlage:RuS
ទំព័រគំរូ:ណែនាំ	Vorlage:Begriffsklärung
ទំព័រគំរូ:No	Vorlage:Nein-Feld
ទំព័រគំរូ:Tick	Vorlage:Häkchen
ចំណាត់ថ្នាក់ក្រុម:ទំព័រគំរូ ប្រអប់ព័ត៌មាន	Kategorie:Vorlage:Infobox
ចំណាត់ថ្នាក់ក្រុម:Lists of flags	Kategorie:Liste (Flaggen)
ចំណាត់ថ្នាក់ក្រុម:ហិរញ្ញវត្ថុសាធារណៈ	Kategorie:Haushaltsrecht
ចំណាត់ថ្នាក់ក្រុម:អ្នកថតរូប	Kategorie:Fotografie
ទំព័រគំរូ:Partial	Vorlage:Teilweise-Feld
ចំណាត់ថ្នាក់ក្រុម:យន្តហោះយោធា	Kategorie:Militärischer Flugzeugtyp
ទំព័រគំរូ:LAO	Vorlage:LAO
ទំព័រគំរូ:User zh-min-nan	Vorlage:User zh-min-nan
ទំព័រគំរូ:User zh-min-nan-1	Vorlage:User zh-min-nan-1
ទំព័រគំរូ:GRC	Vorlage:GRC
ទំព័រគំរូ:PRT	Vorlage:PRT
ទំព័រគំរូ:ទិន្នន័យ​នៃប្រទេសបង់ក្លាដែស្ស	Vorlage:BGD
ទំព័រគំរូ:States of Austria	Vorlage:Navigationsleiste Österreichische Bundesländer
ចំណាត់ថ្នាក់ក្រុម:អង្គការមិនរកប្រាក់កំរៃ	Kategorie:Non-Profit-Organisation
ទំព័រគំរូ:Lang-uk	Vorlage:UkS
ទំព័រគំរូ:KHM	Vorlage:KHM
ទំព័រគំរូ:ប្រអប់ព័ត៌មាន អង្គការ	Vorlage:Infobox Verband
ទំព័រគំរូ:MNE	Vorlage:MNE
ទំព័រគំរូ:Category TOC	Vorlage:TOC Kategorie
ទំព័រគំរូ:ទិន្នន័យ​នៃប្រទេសមីយ៉ាន់ម៉ា	Vorlage:MMR
ទំព័រគំរូ:Lang-id	Vorlage:IdS
ទំព័រគំរូ:GSE	Vorlage:GSE
ទំព័រគំរូ:ទិន្នន័យ​នៃប្រទេសកូរ៉េខាងត្បូង	Vorlage:KOR
ទំព័រគំរូ:Chinese name	Vorlage:Hinweis Chinesischer Name
ចំណាត់ថ្នាក់ក្រុម:User gsw-1	Kategorie:User gsw-1
ទំព័រគំរូ:User it-2	Vorlage:User it-2
ទំព័រគំរូ:Lang-fr	Vorlage:FrS
ទំព័រគំរូ:Superimpose	Vorlage:Bild mit Markierung
ទំព័រគំរូ:FRA	Vorlage:FRA
ទំព័រគំរូ:Age	Vorlage:Alter
ទំព័រគំរូ:Pending	Vorlage:Ausstehend
ទំព័រគំរូ:?	Vorlage:?
ទំព័រគំរូ:Number table sorting	Vorlage:Nts
ទំព័រគំរូ:CIA World Factbook	Vorlage:CIA-Factbook/Meta
ទំព័រគំរូ:Legend-line	Vorlage:Linienlegende
ចំណាត់ថ្នាក់ក្រុម:ព្រះមហាក្សត្រខ្មែរ	Kategorie:König (Kambodscha)
ទំព័រគំរូ:Coord	Vorlage:Coordinate
ទំព័រគំរូ:POV	Vorlage:Neutralität
ទំព័រគំរូ:Citation/make link	Vorlage:Citation/make link
ចំណាត់ថ្នាក់ក្រុម:20th-century births	Kategorie:Geboren (20. Jahrhundert)
ទំព័រគំរូ:Dmoz	Vorlage:Dmoz
ចំណាត់ថ្នាក់ក្រុម:ពហុកោណ	Kategorie:Polygon
ទំព័រគំរូ:Fide	Vorlage:FIDE
ទំព័រគំរូ:User lb-1	Vorlage:User lb-1
ទំព័រគំរូ:User fr-4	Vorlage:User fr-4
ទំព័រគំរូ:អាស៊ីហ្គេម	Vorlage:Navigationsleiste Asienspiele
ទំព័រគំរូ:User la-1	Vorlage:User la-1
ចំណាត់ថ្នាក់ក្រុម:ឯកសារអំពី ទំព័រគំរូ	Kategorie:Vorlage:nur Dokumentation
ចំណាត់ថ្នាក់ក្រុម:User pdc	Kategorie:User pdc
ចំណាត់ថ្នាក់ក្រុម:User et	Kategorie:User et
ចំណាត់ថ្នាក់ក្រុម:User fr	Kategorie:User fr
ចំណាត់ថ្នាក់ក្រុម:User id	Kategorie:User id
ចំណាត់ថ្នាក់ក្រុម:User ja	Kategorie:User ja
ចំណាត់ថ្នាក់ក្រុម:User km	Kategorie:User km
ចំណាត់ថ្នាក់ក្រុម:User la	Kategorie:User la
ចំណាត់ថ្នាក់ក្រុម:User li	Kategorie:User li
ចំណាត់ថ្នាក់ក្រុម:User sv	Kategorie:User sv
ចំណាត់ថ្នាក់ក្រុម:User th	Kategorie:User th
ចំណាត់ថ្នាក់ក្រុម:User fr-3	Kategorie:User fr-3
ចំណាត់ថ្នាក់ក្រុម:User it-3	Kategorie:User it-3
ចំណាត់ថ្នាក់ក្រុម:User ja-3	Kategorie:User ja-3
ចំណាត់ថ្នាក់ក្រុម:User tr-3	Kategorie:User tr-3
ចំណាត់ថ្នាក់ក្រុម:User pdc-1	Kategorie:User pdc-1
ចំណាត់ថ្នាក់ក្រុម:User et-1	Kategorie:User et-1
ចំណាត់ថ្នាក់ក្រុម:User li-1	Kategorie:User li-1
ចំណាត់ថ្នាក់ក្រុម:User nl-1	Kategorie:User nl-1
ចំណាត់ថ្នាក់ក្រុម:User tr-1	Kategorie:User tr-1
ចំណាត់ថ្នាក់ក្រុម:User ko-4	Kategorie:User ko-4
ចំណាត់ថ្នាក់ក្រុម:User fr-4	Kategorie:User fr-4
ចំណាត់ថ្នាក់ក្រុម:User it-4	Kategorie:User it-4
ចំណាត់ថ្នាក់ក្រុម:User fr-2	Kategorie:User fr-2
ចំណាត់ថ្នាក់ក្រុម:User it-2	Kategorie:User it-2
ចំណាត់ថ្នាក់ក្រុម:User ja-2	Kategorie:User ja-2
ចំណាត់ថ្នាក់ក្រុម:User la-2	Kategorie:User la-2
ចំណាត់ថ្នាក់ក្រុម:User tr-2	Kategorie:User tr-2
ចំណាត់ថ្នាក់ក្រុម:User fr-N	Kategorie:User fr-M
ចំណាត់ថ្នាក់ក្រុម:User it-N	Kategorie:User it-M
ចំណាត់ថ្នាក់ក្រុម:User nl-N	Kategorie:User nl-M
ចំណាត់ថ្នាក់ក្រុម:User ru-N	Kategorie:User ru-M
ចំណាត់ថ្នាក់ក្រុម:កំសាន្ត	Kategorie:Unterhaltung
ទំព័រគំរូ:IncreaseNegative	Vorlage:GestiegenNegativ
ចំណាត់ថ្នាក់ក្រុម:User af	Kategorie:User af
ចំណាត់ថ្នាក់ក្រុម:User af-1	Kategorie:User af-1
ចំណាត់ថ្នាក់ក្រុម:User bar	Kategorie:User bar
ចំណាត់ថ្នាក់ក្រុម:User bar-1	Kategorie:User bar-1
ចំណាត់ថ្នាក់ក្រុម:កោះ	Kategorie:Insel
ចំណាត់ថ្នាក់ក្រុម:User de	Kategorie:User de
ចំណាត់ថ្នាក់ក្រុម:User de-2	Kategorie:User de-2
ចំណាត់ថ្នាក់ក្រុម:User de-3	Kategorie:User de-3
ចំណាត់ថ្នាក់ក្រុម:User de-4	Kategorie:User de-4
ចំណាត់ថ្នាក់ក្រុម:User de-N	Kategorie:User de-M
ចំណាត់ថ្នាក់ក្រុម:User el	Kategorie:User el
ចំណាត់ថ្នាក់ក្រុម:User en-3	Kategorie:User en-3
ចំណាត់ថ្នាក់ក្រុម:User en-N	Kategorie:User en-M
ចំណាត់ថ្នាក់ក្រុម:User es	Kategorie:User es
ចំណាត់ថ្នាក់ក្រុម:User es-1	Kategorie:User es-1
ចំណាត់ថ្នាក់ក្រុម:User es-2	Kategorie:User es-2
ចំណាត់ថ្នាក់ក្រុម:User es-4	Kategorie:User es-4
ចំណាត់ថ្នាក់ក្រុម:User es-N	Kategorie:User es-M
ចំណាត់ថ្នាក់ក្រុម:User fi	Kategorie:User fi
ចំណាត់ថ្នាក់ក្រុម:User fi-N	Kategorie:User fi-M
ចំណាត់ថ្នាក់ក្រុម:User gsw	Kategorie:User gsw
ទំព័រគំរូ:N/a	Vorlage:N/A-Feld
ចំណាត់ថ្នាក់ក្រុម:User id-1	Kategorie:User id-1
ចំណាត់ថ្នាក់ក្រុម:User id-2	Kategorie:User id-2
ចំណាត់ថ្នាក់ក្រុម:User id-3	Kategorie:User id-3
ទំព័រគំរូ:Beijing	Vorlage:Navigationsleiste Kreisebene Pekings
ទំព័រគំរូ:Multiple image	Vorlage:Mehrere Bilder
ចំណាត់ថ្នាក់ក្រុម:ធរណីមាត្រ	Kategorie:Geometrie
ទំព័រគំរូ:ប្រអប់ព័ត៌មាន រោគ-ជំងឺ	Vorlage:Infobox ICD
ទំព័រគំរូ:Weather box	Vorlage:Klimatabelle
វិគីភីឌា:អត្ថបទ​ប្រចាំ​ថ្ងៃ	Wikipedia:Hauptseite/Artikel des Tages
ចំណាត់ថ្នាក់ក្រុម:User it	Kategorie:User it
ចំណាត់ថ្នាក់ក្រុម:User it-1	Kategorie:User it-1
ចំណាត់ថ្នាក់ក្រុម:User ja-1	Kategorie:User ja-1
ចំណាត់ថ្នាក់ក្រុម:User km-1	Kategorie:User km-1
ចំណាត់ថ្នាក់ក្រុម:User km-2	Kategorie:User km-2
ចំណាត់ថ្នាក់ក្រុម:User km-3	Kategorie:User km-3
ចំណាត់ថ្នាក់ក្រុម:User km-4	Kategorie:User km-4
ចំណាត់ថ្នាក់ក្រុម:User km-N	Kategorie:User km-M
ចំណាត់ថ្នាក់ក្រុម:User ko	Kategorie:User ko
ចំណាត់ថ្នាក់ក្រុម:User ko-1	Kategorie:User ko-1
ចំណាត់ថ្នាក់ក្រុម:User ko-2	Kategorie:User ko-2
ចំណាត់ថ្នាក់ក្រុម:User ko-3	Kategorie:User ko-3
ចំណាត់ថ្នាក់ក្រុម:User ksh	Kategorie:User ksh
ចំណាត់ថ្នាក់ក្រុម:User ksh-N	Kategorie:User ksh-M
ចំណាត់ថ្នាក់ក្រុម:User la-1	Kategorie:User la-1
ចំណាត់ថ្នាក់ក្រុម:User lb	Kategorie:User lb
ចំណាត់ថ្នាក់ក្រុម:User lb-1	Kategorie:User lb-1
ទំព័រគំរូ:Cite doi	Vorlage:BibDOI
ទំព័រគំរូ:ប្រអប់ព័ត៌មាន រូបិយវត្ថុ	Vorlage:Infobox Währungseinheit
ទំព័រគំរូ:Lang-vi	Vorlage:ViS
ទំព័រគំរូ:Infobox programming language	Vorlage:Infobox Programmiersprache
បញ្ជីរាយនាម ជ័យលាភីរង្វាន់ណូបែល ផ្នែកអក្សរសាស្ត្រ	Liste der Nobelpreisträger für Literatur
ទំព័រគំរូ:Information	Vorlage:Information
ចំណាត់ថ្នាក់ក្រុម:User ru-1	Kategorie:User ru-1
ទំព័រគំរូ:TOC limit	Vorlage:TOC limit
វិគីភីឌា:បាបេល	Wikipedia:Babel
ទំព័រគំរូ:Tdeprecated	Vorlage:Veraltete Vorlage
ទំព័រគំរូ:Infobox particle	Vorlage:Infobox Teilchen
ចំណាត់ថ្នាក់ក្រុម:User ms-2	Kategorie:User ms-2
ចំណាត់ថ្នាក់ក្រុម:សមុទ្រ	Kategorie:Meer
ទំព័រគំរូ:User WikiProject Templates	Wikipedia:WikiProjekt Vorlagen/Babel
ទំព័រគំរូ:IPA-all	Vorlage:IPA2
ទំព័រគំរូ:Lang-it	Vorlage:ItS
ចំណាត់ថ្នាក់ក្រុម:User nds	Kategorie:User nds
ទំព័រគំរូ:Sect1911	Vorlage:Britannica 1911
ចំណាត់ថ្នាក់ក្រុម:User nds-1	Kategorie:User nds-1
ជំនួយ:Archiving a talk page	Hilfe:Archivieren
វិគីភីឌា:WikiProject Computing	Wikipedia:Redaktion Informatik
ចំណាត់ថ្នាក់ក្រុម:អង្គការអន្តរជាតិ	Kategorie:Internationale Organisation
ជំនួយ:សៀវភៅ	Hilfe:Buchfunktion
ចំណាត់ថ្នាក់ក្រុម:សមីការឌីផេរ៉ង់ស្យែល	Kategorie:Differentialgleichungen
ចំណាត់ថ្នាក់ក្រុម:ខេត្តក្រុងខ្មែរ	Kategorie:Provinz (Kambodscha)
ចំណាត់ថ្នាក់ក្រុម:User zh-min-nan	Kategorie:User zh-min-nan
ចំណាត់ថ្នាក់ក្រុម:User zh-min-nan-3	Kategorie:User zh-min-nan-3
ចំណាត់ថ្នាក់ក្រុម:ឧទ្ធម្ភាគចក្រ	Kategorie:Hubschrauber
ចំណាត់ថ្នាក់ក្រុម:វិទ្យាសាស្ត្រសង្គម	Kategorie:Sozialwissenschaft
ឈាន	Dhyana
ចំណាត់ថ្នាក់ក្រុម:ឆ្នាំកំណើត ១៩៥១	Kategorie:Geboren 1951
ទំព័រគំរូ:Infobox government agency	Vorlage:Infobox Behörde
វិគីភីឌា:Tools	Wikipedia:Helferlein
ទំព័រគំរូ:User ru-2	Vorlage:User ru-2
ចំណាត់ថ្នាក់ក្រុម:User ru	Kategorie:User ru
ចំណាត់ថ្នាក់ក្រុម:User ru-2	Kategorie:User ru-2
ចំណាត់ថ្នាក់ក្រុម:User ru-3	Kategorie:User ru-3
ចំណាត់ថ្នាក់ក្រុម:វត្តអារាមព្រះពុទ្ធសាសនា	Kategorie:Buddhistischer Tempel
ចំណាត់ថ្នាក់ក្រុម:User sxu	Kategorie:User sxu
ចំណាត់ថ្នាក់ក្រុម:User sxu-1	Kategorie:User sxu-1
ទំព័រគំរូ:Apollo program	Vorlage:Navigationsleiste Apollo
ចំណាត់ថ្នាក់ក្រុម:User th-1	Kategorie:User th-1
ចំណាត់ថ្នាក់ក្រុម:User th-N	Kategorie:User th-M
ចំណាត់ថ្នាក់ក្រុម:User tr	Kategorie:User tr
ចំណាត់ថ្នាក់ក្រុម:User tr-4	Kategorie:User tr-4
ចំណាត់ថ្នាក់ក្រុម:User tr-N	Kategorie:User tr-M
ចំណាត់ថ្នាក់ក្រុម:User vls	Kategorie:User vls
ចំណាត់ថ្នាក់ក្រុម:User vls-1	Kategorie:User vls-1
បញ្ជីរាយនាម នាយករដ្ឋមន្ត្រីកម្ពុជា	Liste der Premierminister von Kambodscha
ទំព័រគំរូ:Nay	Vorlage:Nein
ទំព័រគំរូ:ប្រអប់ភាសា	Vorlage:Lang
ទំព័រគំរូ:FishBase species alt	Vorlage:Fishbase
ជំនួយ:Files	Wikipedia:Artikel illustrieren
ទំព័រគំរូ:Str index	Vorlage:Str index
ទំព័រគំរូ:TakeNote	Vorlage:Info
ទំព័រគំរូ:Copyright by Wikimedia	Vorlage:Bild-WikimediaCopyright
ចំណាត់ថ្នាក់ក្រុម:ធរណីមាត្រត្រីកោណ	Kategorie:Dreiecksgeometrie
ទំព័រគំរូ:BLP	Vorlage:Artikel über lebende Person
ទំព័រគំរូ:Bar percent	Vorlage:Balken Prozent
ទំព័រគំរូ:Str find	Vorlage:Str find
ទំព័រគំរូ:Lang-hi	Vorlage:HiS
ចំណាត់ថ្នាក់ក្រុម:ទំព័រគំរូសំរាប់ចំនងជើង	Kategorie:Vorlage:mit absoluter Positionierung
ទំព័រគំរូ:EST	Vorlage:EST
ទំព័រគំរូ:Football squad end	Vorlage:Football squad end
ទំព័រគំរូ:IAFD name	Vorlage:IAFD Name
ទំព័រគំរូ:ទិន្នន័យ​នៃប្រទេសរុស្ស៊ី	Vorlage:RUS
ទំព័រគំរូ:Five Oceans	Vorlage:Navigationsleiste Ozeane
ទំព័រគំរូ:CHL	Vorlage:CHL
ទំព័រគំរូ:Campaign	Vorlage:Kampagne
ទំព័រគំរូ:ទិន្នន័យ​នៃប្រទេសស៊ីរី	Vorlage:SYR
ទំព័រគំរូ:Check mark templates	Vorlage:Diskussionsbausteine
ទំព័រគំរូ:Familytree/step2	Vorlage:Stammbaum/step2
ទំព័រគំរូ:ENG	Vorlage:ENG
ចំណាត់ថ្នាក់ក្រុម:Tracking categories	Kategorie:Wikipedia:Wartungskategorie
ទំព័រគំរូ:User la-2	Vorlage:User la-2
ទំព័រគំរូ:User ru-1	Vorlage:User ru-1
ទំព័រគំរូ:User tr-1	Vorlage:User tr-1
ទំព័រគំរូ:User zh-1	Vorlage:User zh-1
ទំព័រគំរូ:User zh-2	Vorlage:User zh-2
ទំព័រគំរូ:User zh-3	Vorlage:User zh-3
ទំព័រគំរូ:User zh-4	Vorlage:User zh-4
ចំណាត់ថ្នាក់ក្រុម:គមនាគមន៍នៅប្រទេសជប៉ុន	Kategorie:Verkehr (Japan)
ចំណាត់ថ្នាក់ក្រុម:ប្រទេសហ្សំប៊ី	Kategorie:Sambia
ចំណាត់ថ្នាក់ក្រុម:ការអប់រំនៅប្រទេសជប៉ុន	Kategorie:Bildung in Japan
ចំណាត់ថ្នាក់ក្រុម:ការអប់រំនៅកម្ពុជា	Kategorie:Bildung in Kambodscha
ចំណាត់ថ្នាក់ក្រុម:User nl	Kategorie:User nl
ចំណាត់ថ្នាក់ក្រុម:User zh-1	Kategorie:User zh-1
ចំណាត់ថ្នាក់ក្រុម:User zh-4	Kategorie:User zh-4
ចំណាត់ថ្នាក់ក្រុម:User zh-3	Kategorie:User zh-3
ចំណាត់ថ្នាក់ក្រុម:User zh-2	Kategorie:User zh-2
ចំណាត់ថ្នាក់ក្រុម:ព្រឹត្តិការណ៍កីឡាចំរុះ	Kategorie:Multisportveranstaltung
ទំព័រគំរូ:User wikipedia/autopatrolled	Vorlage:Benutzer Passiver Sichter
ចំណាត់ថ្នាក់ក្រុម:ចំនួនគត់រឺឡាទីប	Kategorie:Ganze Zahl
ចំណាត់ថ្នាក់ក្រុម:ស៊ីហ្គេម	Kategorie:Südostasienspiele
ចំណាត់ថ្នាក់ក្រុម:ត្រីកោណមាត្រ	Kategorie:Trigonometrie
ចំណាត់ថ្នាក់ក្រុម:ទ្រឹស្តីបទគណិតវិទ្យា	Kategorie:Satz (Mathematik)
ចំណាត់ថ្នាក់ក្រុម:អាកាសយានដ្ឋាន	Kategorie:Flughafen
ចំណាត់ថ្នាក់ក្រុម:រង្វាន់ណូបែល	Kategorie:Nobelpreis
ទំព័រគំរូ:User pfl-1	Vorlage:User pfl-1
ចំណាត់ថ្នាក់ក្រុម:ប្រទេសកម្ពុជា	Kategorie:Kambodscha
ចំណាត់ថ្នាក់ក្រុម:អ្នកនយោបាយប៉ាគីស្ថាន	Kategorie:Politiker (Pakistan)
ទំព័រគំរូ:Lang-hy	Vorlage:HyS
ចំណាត់ថ្នាក់ក្រុម:អ្នកនយោបាយខ្មែរ	Kategorie:Politiker (Kambodscha)
ចំណាត់ថ្នាក់ក្រុម:ស្រីលង្កា	Kategorie:Sri Lanka
ចំណាត់ថ្នាក់ក្រុម:ទំព័រគំរូឈ្មោះភាសា	Kategorie:Vorlage:Fremdsprachenunterstützung
ចំណាត់ថ្នាក់ក្រុម:ទំព័រគំរូក្នុងរូបវិទ្យា	Kategorie:Vorlage:Physik
វិគីភីឌា:ត្រូវការអំណះអំណាង	Wikipedia:Citation needed
ទំព័រគំរូ:FeaturedPicture	Vorlage:Exzellentes Bild
ចំណាត់ថ្នាក់ក្រុម:អុនសេន	Kategorie:Thermalquelle
ចំណាត់ថ្នាក់ក្រុម:អនុគមន៍	Kategorie:Mathematische Funktion
ចំណាត់ថ្នាក់ក្រុម:ភាសាជប៉ុន	Kategorie:Japanische Sprache
ចំណាត់ថ្នាក់ក្រុម:មធ្យម	Kategorie:Mittelwert
ចំណាត់ថ្នាក់ក្រុម:ចតុកោណ	Kategorie:Viereck
ចំណាត់ថ្នាក់ក្រុម:ត្រីកោណ	Kategorie:Dreieck
ចំណាត់ថ្នាក់ក្រុម:សំភារៈ​សំណង់	Kategorie:Baustoff
ពន្ធលើប្រាក់បៀវត្ស	Lohnsteuer (Deutschland)
ចំណាត់ថ្នាក់ក្រុម:ស្ពាននៅប្រទេសជប៉ុន	Kategorie:Brücke in Japan
ចំណាត់ថ្នាក់ក្រុម:User pfl-1	Kategorie:User pfl-1
ចំណាត់ថ្នាក់ក្រុម:វិភាគគណិតវិទ្យា	Kategorie:Analysis
ចំណាត់ថ្នាក់ក្រុម:វិសមភាព	Kategorie:Ungleichung
ចំណាត់ថ្នាក់ក្រុម:ឧទ្យានជាតិ	Kategorie:Nationalpark
ចំណាត់ថ្នាក់ក្រុម:កោះស៊ូម៉ាត្រា	Kategorie:Sumatra
ចំណាត់ថ្នាក់ក្រុម:មីក្រូសេដ្ឋកិច្ច	Kategorie:Mikroökonomie
ចំណាត់ថ្នាក់ក្រុម:HTML	Kategorie:HTML
ចំណាត់ថ្នាក់ក្រុម:អាស៊ីហ្គេម	Kategorie:Asienspiele
ចំណាត់ថ្នាក់ក្រុម:អេឡិចត្រូស្តាទិច	Kategorie:Elektrostatik
ចំណាត់ថ្នាក់ក្រុម:អ៊ីសាក់ ញូតុន	Kategorie:Isaac Newton
ចំណាត់ថ្នាក់ក្រុម:អាកាសចរណ៍	Kategorie:Verkehrswesen
ចំណាត់ថ្នាក់ក្រុម:ទ្រឹស្តីបទលេខ	Kategorie:Zahlentheorie
ទំព័រគំរូ:ប្រអប់ព័ត៌មាន ភាសា	Vorlage:Infobox Sprache
ទំព័រគំរូ:Wikiversity	Vorlage:Wikiversity
ចំណាត់ថ្នាក់ក្រុម:ភាសាអ៊ីតាលី	Kategorie:Italienische Sprache
ចំណាត់ថ្នាក់ក្រុម:ភាសាអេស្ប៉ាញ	Kategorie:Spanische Sprache
ចំណាត់ថ្នាក់ក្រុម:រថក្រោះ	Kategorie:Panzer
ចំណាត់ថ្នាក់ក្រុម:កោះរបស់ឥណ្ឌូនេស៊ី	Kategorie:Insel (Indonesien)
ទំព័រគំរូ:Update after	Vorlage:Zukunft
ខេត្តលង់ហោរ	Vĩnh Long (Provinz)
ចំណាត់ថ្នាក់ក្រុម:ភ្នំពេញ	Kategorie:Phnom Penh
ចំណាត់ថ្នាក់ក្រុម:ទំព័រគំរូសំរាប់ទង់ជាតិ	Kategorie:Vorlage:Land mit Flagge
វិគីភីឌា:ឯកសារកម្មទំព័រគំរូ	Hilfe:Vorlagendokumentation
ទំព័រគំរូ:CompactTOC8	Vorlage:TOC
តូក្យូ	Tokio
ទំព័រគំរូ:JD	Vorlage:GetJD
ទំព័រគំរូ:ទិន្នន័យ​នៃប្រទេសអ៊ូបេគីស្ថាន	Vorlage:UZB
ទំព័រគំរូ:OnHold	Vorlage:Abwartend
បញ្ជីរាយនាម ជ័យលាភីរង្វាន់ណូបែល ផ្នែកគីមីវិទ្យា	Liste der Nobelpreisträger für Chemie
ទំព័រគំរូ:ខេត្ត-រាជធានីកម្ពុជា	Vorlage:Navigationsleiste Provinzen Kambodschas
ទំព័រគំរូ:Pad	Vorlage:Pad
ទំព័រគំរូ:Conservation status	Vorlage:Erhaltungszustand
ទំព័រគំរូ:Lang-pl	Vorlage:PlS
ទំព័រគំរូ:Str right	Vorlage:Str right
ទំព័រគំរូ:Diff	Vorlage:Diff
ចំណាត់ថ្នាក់ក្រុម:ភាសាអង់គ្លេស	Kategorie:Englische Sprache
ទំព័រគំរូ:G8	Vorlage:Navigationsleiste G8
ទំព័រគំរូ:User vi-2	Vorlage:User vi-2
ទំព័រគំរូ:User vi-1	Vorlage:User vi-1
ទំព័រគំរូ:User zh-min-nan-4	Vorlage:User zh-min-nan-4
ទំព័រគំរូ:User zh-min-nan-2	Vorlage:User zh-min-nan-2
ទំព័រគំរូ:User id-2	Vorlage:User id-2
ទំព័រគំរូ:PDB	Vorlage:PDB
ទំព័រគំរូ:Nav book tool	Vorlage:Navigationsleiste Buchfunktion
ទំព័រគំរូ:Lang-th	Vorlage:ThS
ទំព័រគំរូ:Lang-sq	Vorlage:SqS
ទំព័រគំរូ:Lang-es	Vorlage:EsS
ទំព័រគំរូ:Lang-ca	Vorlage:CaS
ទំព័រគំរូ:Lang-az	Vorlage:AzS
ចំណាត់ថ្នាក់ក្រុម:ក្រុមហ៊ុនអាកាសចរណ៍	Kategorie:Verkehrsflugzeug
ចំណាត់ថ្នាក់ក្រុម:ពិជគណិត	Kategorie:Algebra
ចំណាត់ថ្នាក់ក្រុម:នព្វន្ធ	Kategorie:Arithmetik
Module:Citation	Modul:Citation
ចំណាត់ថ្នាក់ក្រុម:ស្ពាននៅអាស៊ី	Kategorie:Brücke in Asien
សិទ្ធិកុមារ	Kinderrechte
ចំណាត់ថ្នាក់ក្រុម:អាស៊ីខាងកើត	Kategorie:Ostasien
ចំណាត់ថ្នាក់ក្រុម:អេឡិចត្រូម៉ាញ៉េទិច	Kategorie:Elektrodynamik
ទំព័រគំរូ:Lang-mn	Vorlage:MnS
ទំព័រគំរូ:Lang-sa	Vorlage:SaS
ទំព័រគំរូ:Lang-sv	Vorlage:SvS
វិគីភីឌា:វិគីគម្រោងប្រវត្តិសាស្ត្រ	Wikipedia:Redaktion Geschichte
វិគីភីឌា:WikiProject Education	Wikipedia:WikiProjekt Bildung
វិគីភីឌា:វិគីគម្រោង សាកលវិទ្យាល័យ	Wikipedia:WikiProjekt Universitäten
ចំណាត់ថ្នាក់ក្រុម:បណ្ណាល័យ	Kategorie:Bibliothek
ចំណាត់ថ្នាក់ក្រុម:មេរថក្រោះសមរភូមិ	Kategorie:Kampfpanzer
ជំនួយ:Books/Frequently Asked Questions	Hilfe:Buchfunktion/Fragen und Antworten
ជំនួយ:Books/for experts	Hilfe:Buchfunktion/für Experten
ចំណាត់ថ្នាក់ក្រុម:យន្តហោះយោធាគ្រូបណ្តុះបណ្តាល	Kategorie:Militärisches Schulflugzeug
ទំព័រគំរូ:ទិន្នន័យ​នៃប្រទេសម៉ុងហ្គោល	Vorlage:MNG
ចំណាត់ថ្នាក់ក្រុម:User pfl	Kategorie:User pfl
ចំណាត់ថ្នាក់ក្រុម:ទំព័រគំរូTOC	Kategorie:Vorlage:TOC
ទំព័រគំរូ:Image label begin	Vorlage:Image label begin
ចំណាត់ថ្នាក់ក្រុម:រង្វង់និងស៊្វែរ	Kategorie:Kreis
វិគីភីឌា:Requests	Wikipedia:Anfragen
ចំណាត់ថ្នាក់ក្រុម:កងកម្លាំងអាកាស	Kategorie:Nationale Luftstreitkraft
ចំណាត់ថ្នាក់ក្រុម:សាកលវិទ្យាល័យនៅប្រទេសជប៉ុន	Kategorie:Universität in Japan
វិគីភីឌា:សារ ទំព័រគំរូ/បោសសំអាត	Wikipedia:Bewertungsbausteine
ចំណាត់ថ្នាក់ក្រុម:វប្បធម៌ខ្មែរ	Kategorie:Kultur (Kambodscha)
ចំណាត់ថ្នាក់ក្រុម:User en-1	Kategorie:User en-1
ចំណាត់ថ្នាក់ក្រុម:User de-1	Kategorie:User de-1
ទំព័រគំរូ:ShadowsCommons	Vorlage:ShadowsCommons
ទំព័រគំរូ:ែដលកំពុងរឺកចំេរីន	Vorlage:Baustelle
ទំព័រគំរូ:Pipe	Vorlage:Pipe
វិគីភីឌា:Tutorial/Keep in mind	Wikipedia:Tutorial/1
ទំព័រគំរូ:Organisation of Islamic Cooperation	Vorlage:Navigationsleiste Mitgliedstaaten OIC
ចំណាត់ថ្នាក់ក្រុម:កោះជ្វា	Kategorie:Java (Insel)
ទំព័រគំរូ:Frac	Vorlage:Bruch
ជំនួយ:របារឧបករណ៍កែប្រែ	Hilfe:Symbolleisten
វិគីភីឌា:គម្រោងវិគីជាបងប្អូន	Wikipedia:Schwesterprojekte
ទំព័រគំរូ:MediaWiki	Vorlage:MediaWiki
ចំណាត់ថ្នាក់ក្រុម:ការធ្វើសេចក្ដីរាយការណ៏ពត៌មាន	Bericht (Journalismus)
ទំព័រគំរូ:User zh-min-nan-3	Vorlage:User zh-min-nan-3
ទំព័រគំរូ:Isfdb name	Vorlage:ISFDB name
ទំព័រគំរូ:User km-1	Vorlage:User km-1
ទំព័រគំរូ:User km-3	Vorlage:User km-3
ទំព័រគំរូ:User km-4	Vorlage:User km-4
ទំព័រគំរូ:User km	Vorlage:User km
ទំព័រគំរូ:User km-2	Vorlage:User km-2
ទំព័រគំរូ:Last edited by	Vorlage:Letzter Bearbeiter
វិគីភីឌា:Tutorial/Wrap-up and more info	Wikipedia:Tutorial/6
វិគីភីឌា:Project namespace	Hilfe:Wikipedia-Namensraum
វិគីភីឌា:Kindness Campaign	Wikipedia:Archiv/Wikipedianer für Inhalte
ទំព័រគំរូ:Infobox file format	Vorlage:Infobox Dateiformat
វិគីភីឌា:Version 1.0 Editorial Team	Wikipedia:Archiv/WP 1.0
ទំព័រគំរូ:សមាជិកសហភាពអឺរ៉ុប	Vorlage:Imagemap Mitgliedstaaten der Europäischen Union
វិគីភីឌា:Birthday Committee	Wikipedia:Geburtstagsliste
ទំព័រគំរូ:EC number	Vorlage:EC
ទំព័រគំរូ:វប្បធ៌មបុរេប្រវត្តិវៀតណាម	Vorlage:Prähistorische Kulturen Vietnam
ទំព័រគំរូ:ប្រធានបទរាជវង្សចូវ	Vorlage:Navigationsleiste Frühlings- und Herbstannalen
ទំព័រគំរូ:User id-1	Vorlage:User id-1
ការប្រាស្រ័យទាក់ទងអន្តរបុគ្គល	Zwischenmenschliche Kommunikation
ទំព័រគំរូ:Working	Vorlage:In Arbeit
ទំព័រគំរូ:Worldcat id	Vorlage:Worldcat id
វិគីភីឌា:Babel/km-0	Wikipedia:Babel/de-0
ចំណាត់ថ្នាក់ក្រុម:យន្តហោះប្រដេញ	Kategorie:Jagdflugzeug
ទំព័រគំរូ:Weather box/colpastel	Vorlage:Weather box/colpastel
រូបភាពដែលបាត់បង់	Das fehlende Bild
កំប្រុកព័ណ៌	Prevost-Hörnchen
ជំនួយ:ការប្តូរទីតាំងទំព័រ	Hilfe:Weiterleitung
ទំព័រគំរូ:CURRENTCALENDAR	Vorlage:Kalender
ទំព័រគំរូ:Page tabs	Vorlage:Tabs
ព្យុះហៃយ៉ាន	Taifun Haiyan
ពិសេស:បំលាស់ប្ដូរថ្មីៗ	Spezial:Letzte Änderungen
ខេត្តត្បូងឃ្មុំ	Tbong Khmum (Provinz)
Module:HtmlBuilder	Modul:HtmlBuilder
អាណាខេត្ត និងក្រុងនៃប្រទេសជប៉ុន	Liste der Präfekturen Japans
Call of Duty: Advanced Warfare	Call of Duty: Advanced Warfare
បញ្ជីនៃទង់ជាតិអង្គភាពរដ្ឋបាលរាជវង្សង្វៀនរបស់	Flaggen der Verwaltungseinheiten der Nguyen-Dynastie
