Afrika	Afrika
Ġappun	Japan
Norveġja	Norwegen
Ingilterra	England
Skozja	Schottland
Irlanda ta' Fuq	Nordirland
Repubblika tal-Irlanda	Irland
Ungerija	Ungarn
Spanja	Spanien
Stati Uniti	Vereinigte Staaten
Belġju	Belgien
Lussemburgu	Luxemburg
Art	Erde
Mewt	Tod
Bniedem	Mensch
Tim Berners-Lee	Tim Berners-Lee
Finlandja	Finnland
Żvezja	Schweden
Danimarka	Dänemark
Polonja	Polen
Litwanja	Litauen
Italja	Italien
Żvizzera	Schweiz
Awstrija	Österreich
Greċja	Griechenland
Turkija	Türkei
Portugall	Portugal
Ewropa	Europa
Asja	Asien
Wikipedija	Wikipedia
Pajjiżi l-Baxxi	Niederlande
Berlin	Berlin
Kompjuter	Computer
Barack Obama	Barack Obama
Urugwaj	Uruguay
Londra	London
Messiku	Mexiko
Oċean Atlantiku	Atlantischer Ozean
Oċean Paċifiku	Pazifischer Ozean
Jannar	Januar
Frar	Februar
Marzu	März
Marte (pjaneta)	Mars (Planet)
Kenja	Kenia
Etjopja	Äthiopien
Gana	Ghana
April	April
Mejju	Mai
Ġunju	Juni
Lulju	Juli
Awwissu	August
Settembru	September
Ottubru	Oktober
Novembru	November
Diċembru	Dezember
Iljun	Löwe
Franza	Frankreich
Kelb	Haushund
Renju Unit	Vereinigtes Königreich
Qattus	Hauskatze
Ċina	Volksrepublik China
Wikizzjunarju	Wiktionary
Brażil	Brasilien
François Hollande	François Hollande
Russja	Russland
Wiki	Wiki
Fondazzjoni Wikimedia	Wikimedia
Jimmy Wales	Jimmy Wales
Ġermanja	Deutschland
Bjelorussja	Weißrussland
Il Canto degli italiani	Fratelli d’Italia
Iżlanda	Island
Estonja	Estland
Saturnu (pjaneta)	Saturn (Planet)
Latvja	Lettland
Ukraina	Ukraine
Ċekja	Tschechien
Slovakkja	Slowakei
Slovenja	Slowenien
Vilnius	Vilnius
Moldova	Moldawien
Rumanija	Rumänien
Bulgarija	Bulgarien
Ruma	Rom
Repubblika tal-Maċedonja	Mazedonien
Albanija	Albanien
Kroazja	Kroatien
Bożnija u Ħerżegovina	Bosnien und Herzegowina
Ażerbajġan	Aserbaidschan
Andorra	Andorra
Ċipru	Republik Zypern
Ġeorġja	Georgien
Każakistan	Kasachstan
Malta	Malta
Monako	Monaco
Montenegro	Montenegro
Belt tal-Vatikan	Vatikanstadt
San Marino	San Marino
Brussell	Stadt Brüssel
Kuba	Kuba
Beliże	Belize
Torri Eiffel	Eiffelturm
Barbados	Barbados
Volkswagen	Volkswagen
Indoneżja	Indonesien
Wolfgang Amadeus Mozart	Wolfgang Amadeus Mozart
Ludwig van Beethoven	Ludwig van Beethoven
Afrika t'Isfel	Südafrika
Alġerija	Algerien
Wikisors	Wikisource
Varsavja	Warschau
Festival tal-Eurovision	Eurovision Song Contest
Injam	Holz
Pornografija	Pornografie
Ċili	Chile
Ġesù	Jesus Christus
Galileo Galilei	Galileo Galilei
Merkurju (pjaneta)	Merkur (Planet)
Storja	Geschichte
Venere (pjaneta)	Venus (Planet)
Imħabba	Liebe
Ġove (pjaneta)	Jupiter (Planet)
Triq ta' Sant'Anna	Milchstraße
Uranu (pjaneta)	Uranus (Planet)
Nettunu (pjaneta)	Neptun (Planet)
Astronomija	Astronomie
Singapor	Singapur
Xjenza	Wissenschaft
Liechtenstein	Liechtenstein
Sport	Sport
Adolf Hitler	Adolf Hitler
Facebook	Facebook
L-Ewwel Gwerra Dinjija	Erster Weltkrieg
It-Tieni Gwerra Dinjija	Zweiter Weltkrieg
Wikotba	Wikibooks
Wikikwota	Wikiquote
Wikiversità	Wikiversity
Skopje	Skopje
Szczecin	Stettin
Matematika	Mathematik
Lingwa Latina	Latein
Baħrejn	Bahrain
Armenja	Armenien
Serbja	Serbien
Qamar	Mond
Awstralja	Australien
Arġentina	Argentinien
Perù	Peru
Bijoloġija	Biologie
Kambodja	Kambodscha
Faxxa ta' Kuiper	Kuipergürtel
Koran	Koran
Dinosawru	Dinosaurier
Iżlam	Islam
Ljubljana	Ljubljana
Unjoni Ewropea	Europäische Union
Plovdiv	Plowdiw
Mara	Frau
Poeżija	Poesie
Lumija	Zitrone
Émile Zola	Émile Zola
Napuljun I ta' Franza	Napoleon Bonaparte
Vesuvju	Vesuv
Xemx	Sonne
Sena dawl	Lichtjahr
Oċeanja	Ozeanien
Sistema Solari	Sonnensystem
Idroġenu	Wasserstoff
Wikimedia Commons	Wikimedia Commons
Lejl	Nacht
Oslo	Oslo
Katowice	Katowice
Toqba sewda	Schwarzes Loch
Lionel Messi	Lionel Messi
Karbonju	Kohlenstoff
Ażotu	Stickstoff
Ossiġenu	Sauerstoff
Inter Milan	Inter Mailand
Pjaneta	Planet
Kleopatra VII	Kleopatra VII.
Mużika	Musik
Moska	Moskau
Lingwa Taljana	Italienische Sprache
Ċad	Tschad
New Zealand	Neuseeland
Indja	Indien
Tuvalu	Tuvalu
Ħadid	Eisen
Tonga	Tonga
Samoa	Samoa
Gżejjer Solomon	Salomonen
Vanwatu	Vanuatu
Molière	Molière
Papwa Gwinea l-Ġdida	Papua-Neuguinea
William Shakespeare	William Shakespeare
Nawru	Nauru
Kiribati	Kiribati
Fiġi	Fidschi
Veneżwela	Venezuela
Genghis Khan	Dschingis Khan
Żiemel	Hauspferd
Annimal	Tier
Surinam	Suriname
Paragwaj	Paraguay
Gujana	Guyana
Arti	Kunst
Ekwador	Ecuador
Kolombja	Kolumbien
Buddiżmu	Buddhismus
Bolivja	Bolivien
Trinidad u Tobago	Trinidad und Tobago
Saint Vincent u l-Grenadini	St. Vincent und die Grenadinen
Santa Luċija	St. Lucia
Leonardo da Vinci	Leonardo da Vinci
Saint Kitts u Nevis	St. Kitts und Nevis
Ġamajka	Jamaika
Grenada	Grenada
Gwatemala	Guatemala
Baħamas	Bahamas
Antigwa u Barbuda	Antigua und Barbuda
Ħonduras	Honduras
Dominika	Dominica
Repubblika Dominikana	Dominikanische Republik
Ħaiti	Haiti
El Salvador	El Salvador
Iran	Iran
Iraq	Irak
Kosta Rika	Costa Rica
Iżrael	Israel
Panama	Panama
Jemen	Jemen
Lingwa pollakka	Polnische Sprache
Ġordan	Jordanien
Nikaragwa	Nicaragua
Libanu	Libanon
Maldive	Malediven
Malażja	Malaysia
Burma	Myanmar
Pakistan	Pakistan
Qatar	Katar
Arabja Sawdija	Saudi-Arabien
Sri Lanka	Sri Lanka
Josif Stalin	Josef Stalin
YouTube	YouTube
Aristotli	Aristoteles
Emirati Għarab Magħquda	Vereinigte Arabische Emirate
Vjetnam	Vietnam
Korea t'Isfel	Südkorea
Afganistan	Afghanistan
Bangladexx	Bangladesch
Mali	Mali
Angola	Angola
Butan	Bhutan
Brunej	Brunei
Tanżanija	Tansania
Repubblika Ċentru-Afrikana	Zentralafrikanische Republik
Isaac Newton	Isaac Newton
Isfar	Gelb
Mekkanika kwantistika	Quantenmechanik
Togo	Togo
Tuneżija	Tunesien
Żambja	Sambia
Żimbabwe	Simbabwe
Sudan t'Isfel	Südsudan
Benin	Benin
Botswana	Botswana
Wikiħbarijiet	Wikinews
Burkina Faso	Burkina Faso
Burundi	Burundi
Komoros	Komoren
Repubblika tal-Kongo	Republik Kongo
Repubblika Demokratika tal-Kongo	Demokratische Republik Kongo
Ġibuti	Dschibuti
Bavarja	Bayern
Ginea Ekwatorjali	Äquatorialguinea
Eritrea	Eritrea
Papa Ġwanni Pawlu II	Johannes Paul II.
Gabon	Gabun
Mahatma Gandhi	Mohandas Karamchand Gandhi
Gambja	Gambia
Ginea	Guinea
Ginea Bissaw	Guinea-Bissau
Kosta tal-Avorju	Elfenbeinküste
Kamerun	Kamerun
Kap Verde	Kap Verde
Lesoto	Lesotho
Liberja	Liberia
Libja	Libyen
Madagaskar	Madagaskar
Malawi	Malawi
Mawritanja	Mauretanien
Mawrizju	Mauritius
Marokk	Marokko
Możambik	Mosambik
Namibja	Namibia
Niġer	Niger
Niġerja	Nigeria
Charles Darwin	Charles Darwin
Uganda	Uganda
Rwanda	Ruanda
São Tomé u Príncipe	São Tomé und Príncipe
Senegal	Senegal
Seychelles	Seychellen
Sierra Leone	Sierra Leone
Somalja	Somalia
Sudan	Sudan
Sważiland	Swasiland
Amburgu	Hamburg
Evoluzzjoni	Evolution
Ġnus Magħquda	Vereinte Nationen
Dante Alighieri	Dante Alighieri
Ġeografija	Geographie
Qalb	Herz
Praga	Prag
Ikħal	Blau
Limburgu (Belġju)	Provinz Limburg (Belgien)
Fjandri tal-Punent	Provinz Westflandern
Fjandri tal-Lvant	Provinz Ostflandern
Antwerp (provinċja)	Provinz Antwerpen
Brabant Fjamming	Provinz Flämisch-Brabant
Merkurju (mitoloġija)	Mercurius
Hector Berlioz	Hector Berlioz
Giorgio Napolitano	Giorgio Napolitano
Francesco Cossiga	Francesco Cossiga
Oċean Indjan	Indischer Ozean
Kosovo	Kosovo
Frédéric Chopin	Frédéric Chopin
Kategorija:Prinċipali	Kategorie:!Hauptkategorie
Dortmund	Dortmund
The Beatles	The Beatles
Osama Bin Laden	Osama bin Laden
Lingwa Spanjola	Spanische Sprache
Montevideo	Montevideo
Johann Sebastian Bach	Johann Sebastian Bach
Brimba	Webspinnen
Virġilju	Vergil
Uetersen	Uetersen
Karozza	Automobil
Żagreb	Zagreb
Sqallija	Autonome Region Sizilien
Maurits Cornelis Escher	M. C. Escher
Buenos Aires	Buenos Aires
Belt tal-Messiku	Mexiko-Stadt
Tokjo	Präfektur Tokio
Barċellona	Barcelona
Ateni	Athen
AC Milan	AC Mailand
Ħavana	Havanna
Édith Piaf	Édith Piaf
Kopenħagen	Kopenhagen
Stokkolma	Stockholm
Ħelsinki	Helsinki
Dublin	Dublin
Rejkjavik	Reykjavík
Tallinn	Tallinn
Riga	Riga
Bratislava	Bratislava
Gdańsk	Danzig
Lussemburgu (belt)	Luxemburg (Stadt)
Bibbja	Bibel
Ho Chi Minh (belt)	Ho-Chi-Minh-Stadt
Knisja Vera ta' Ġesù	Wahre Jesus-Kirche
Dong Hoi	Đồng Hới
Concepción (Ċili)	Concepción (Chile)
Atalanta BC	Atalanta Bergamo
Bolonja	Bologna
Bologna FC 1909	FC Bologna
Cagliari	Cagliari
Kiev	Kiew
Cagliari Calcio	Cagliari Calcio
Karim Benzema	Karim Benzema
Patrice Evra	Patrice Evra
Końskowola	Końskowola
2014	2014
2015	2015
2007	2007
ACF Fiorentina	AC Florenz
Serp	Schlangen
1 ta' Jannar	1. Januar
2 ta' Jannar	2. Januar
Rivoluzzjoni Industrijali	Industrielle Revolution
Imperu Ruman	Römische Kaiserzeit
Minsk	Minsk
Microsoft	Microsoft
8 ta' Diċembru	8. Dezember
Kurów	Kurów
Kimika	Chemie
19 ta' Marzu	19. März
Papa Benedittu XVI	Benedikt XVI.
Papa Piju XII	Pius XII.
Watford FC	FC Watford
Futbol	Fußball
L-Olokawst	Holocaust
Madrid	Madrid
Michael Jackson	Michael Jackson
5 ta' Settembru	5. September
4 ta' Settembru	4. September
Santiago (Ċili)	Santiago de Chile
25 ta' Ottubru	15. Oktober
5 ta' Novembru	5. November
22 ta' Novembru	22. November
Aħdar	Grün
Aħmar	Rot
Lourdes	Lourdes
Rabat (Marokk)	Rabat
Kometa	Komet
Belgrad	Belgrad
Kategorija:Mudelli	Kategorie:Vorlage:
George Sand	George Sand
Nikosija	Nikosia
Asterojde	Asteroid
Manama	Manama
Eklissi solari	Sonnenfinsternis
Wikipedija:Paġna tal-provi	Wikipedia:Spielwiese
Nettunu (mitoloġija)	Neptun (Mythologie)
Alġebra	Algebra
Ajruport Dong Hoi	Flughafen Dong Hoi
Miley Cyrus	Miley Cyrus
Curitiba	Curitiba
Pangea	Pangaea
Kategorija:1888	Kategorie:1888
Pika Alpina	Altai-Pfeifhase
Konfuċju	Konfuzius
Corbin Bleu	Corbin Bleu
Kategorija:Matematika	Kategorie:Mathematik
Gżejjer Faroe	Färöer
Ġove (mitoloġija)	Jupiter (Mythologie)
Sherlock Holmes	Sherlock Holmes
Rinaxximent	Renaissance
Kategorija:Twieldu fl-1888	Kategorie:Geboren 1888
Ewro	Euro
Baħar Mediterran	Mittelmeer
Kristjaneżmu	Christentum
Mudell:Favur	Vorlage:Pro
Għasfur	Vögel
Belt kapitali	Hauptstadt
Monzón	Monzón
Mustafa Kemal Atatürk	Mustafa Kemal Atatürk
Mudell:Portal	Vorlage:Portal
Huang Xianfan	Huang Xianfan
Bill Gates	Bill Gates
Struttura .NET	.NET
Enċiklopedija	Enzyklopädie
Il-Paġna prinċipali	Wikipedia:Hauptseite
Baskitbol	Basketball
Francisco Goya	Francisco de Goya
Albrecht Dürer	Albrecht Dürer
Frida Kahlo	Frida Kahlo
Mikelanġlu	Michelangelo
Miguel de Cervantes	Miguel de Cervantes
Charles Dickens	Charles Dickens
Mekka	Mekka
Che Guevara	Che Guevara
Mao Zedong	Mao Zedong
Johann Wolfgang von Goethe	Johann Wolfgang von Goethe
Filosofija	Philosophie
Jimi Hendrix	Jimi Hendrix
Kategorija:Proposti għat-tħassir minnufih	Kategorie:Wikipedia:Schnelllöschen
Hebe Camargo	Hebe Camargo
Komuniżmu	Kommunismus
Saħara tal-Punent	Westsahara
Kartaġni	Karthago
Kategorija:Astronomija	Kategorie:Astronomie
UTC−3:30	UTC−3:30
Søren Kierkegaard	Søren Kierkegaard
Bolzano	Bozen
Rivoluzzjoni Franċiża	Französische Revolution
Saħara	Sahara
Strażburgu	Straßburg
Lingwa Kroata	Kroatische Sprache
UTC+1	UTC+1
Omeru	Homer
UTC+2	UTC+2
UTC+3	UTC+3
Lena Meyer-Landrut	Lena Meyer-Landrut
Seklu XVII	17. Jahrhundert
Ateiżmu	Atheismus
Ekoloġija	Ökologie
FC Barcelona	FC Barcelona
Marie Curie	Marie Curie
Premju Nobel	Nobelpreis
Alan Turing	Alan Turing
Ideoloġija	Ideologie
Ada Lovelace	Ada Lovelace
Franz Schubert	Franz Schubert
Igor' Stravinskij	Igor Fjodorowitsch Strawinski
Pëtr Il'ič Čajkovskij	Pjotr Iljitsch Tschaikowski
Giuseppe Verdi	Giuseppe Verdi
Kristofru Kolombu	Christoph Kolumbus
Nagħġa	Hausschaf
Mammiferu	Säugetiere
Naħla	Bienen
Speċi	Art (Biologie)
Tifel	Kind
Napuljun III	Napoleon III.
Vladimir Putin	Wladimir Wladimirowitsch Putin
Analisi matematika	Analysis
Commonwealth tan-Nazzjonijiet	Commonwealth of Nations
Organizzazzjoni Dinjija tas-Saħħa	Weltgesundheitsorganisation
Demm	Blut
Pulmun	Lunge
Casablanca	Casablanca
Xjenza Naturali	Naturwissenschaft
Santu Wistin	Augustinus von Hippo
Nelson Mandela	Nelson Mandela
Martin Luther King Jr.	Martin Luther King
Ġeometrija	Geometrie
Atmosfera	Atmosphäre (Astronomie)
Kategorija:Bulgarija	Kategorie:Bulgarien
Kategorija:Franza	Kategorie:Frankreich
Kategorija:Mużika	Kategorie:Musik
Elf Lejla u Lejla	Tausendundeine Nacht
Kategorija:Letteratura	Kategorie:Literatur
Ilijade	Ilias
Alessandru Manju	Alexander der Große
Edukazzjoni	Bildung
Hugo Chávez	Hugo Chávez
Raġel	Mann
Otto von Bismarck	Otto von Bismarck
Abort	Schwangerschaftsabbruch
Skjavitù	Sklaverei
Logħob Olimpiku tas-sajf 2008	Olympische Sommerspiele 2008
US Sassuolo Calcio	US Sassuolo Calcio
Logħob Olimpiku tas-sajf 2016	Olympische Sommerspiele 2016
Gwerra Ċivili Amerikana	Sezessionskrieg
Imperu Brittaniku	Britisches Weltreich
Real Madrid CF	Real Madrid
Sivilja	Sevilla
Rivoluzzjoni Russa	Russische Revolution
Arkimede	Archimedes
Thomas Edison	Thomas Alva Edison
Ewklide	Euklid
Bit	Bit
Parlament Ewropew	Europäisches Parlament
Kostellazzjoni	Sternbild
Karl Marx	Karl Marx
Voltaire	Voltaire
Ħinduiżmu	Hinduismus
Erwin Schrödinger	Erwin Schrödinger
Lingwa Maltija	Maltesische Sprache
Reliġjon	Religion
René Descartes	René Descartes
Pawlu minn Tarsu	Paulus von Tarsus
Immanuel Kant	Immanuel Kant
Guy de Maupassant	Guy de Maupassant
Friedrich Nietzsche	Friedrich Nietzsche
Fwied	Leber
Kilwa	Niere
Fenek	Kaninchen
Psikoloġija	Psychologie
Gautama Buddha	Siddhartha Gautama
Premier League	Premier League
Muħammed	Mohammed
Probabbiltà	Wahrscheinlichkeit
Martin Luteru	Martin Luther
Xigħa	Schia
Knisja Kattolika	Römisch-katholische Kirche
Chelsea FC	FC Chelsea
Arsenal FC	FC Arsenal
Sistema diġestiva	Verdauungstrakt
Logħob Olimpiku tax-xitwa 2010	Olympische Winterspiele 2010
Reġina Eliżabetta II	Elisabeth II.
Alfabett	Alphabet
Ronald Reagan	Ronald Reagan
Francisco Varallo	Francisco Varallo
Festival tal-Eurovision 2005	Eurovision Song Contest 2005
Festival tal-Eurovision 2006	Eurovision Song Contest 2006
Festival tal-Eurovision 2007	Eurovision Song Contest 2007
Festival tal-Eurovision 2008	Eurovision Song Contest 2008
Festival tal-Eurovision 2009	Eurovision Song Contest 2009
Festival tal-Eurovision 2010	Eurovision Song Contest 2010
Festival tal-Eurovision 2011	Eurovision Song Contest 2011
Festival tal-Eurovision 2012	Eurovision Song Contest 2012
Festival tal-Eurovision 2013	Eurovision Song Contest 2013
Main-Spessart	Landkreis Main-Spessart
Catherine Middleton	Catherine, Duchess of Cambridge
David Beckham	David Beckham
Ryan Giggs	Ryan Giggs
Frankonja t'Isfel	Unterfranken
Tom Cleverley	Tom Cleverley
Ben Foster	Ben Foster (Fußballspieler)
Ashley Young	Ashley Young
Kim Jong-il	Kim Jong-il
Kategorija:Veneżwela	Kategorie:Venezuela
Belfast	Belfast
Tavla perjodika	Periodensystem
Tórshavn	Tórshavn
Manuel Almunia	Manuel Almunia
Attakki tal-11 ta' Settembru	Terroranschläge am 11. September 2001
Chordata	Chordatiere
Kultura	Kultur
Trattat ta' Maastricht	Vertrag von Maastricht
Mediċina	Medizin
Sarajevo	Sarajevo
Ekwazzjoni differenzjali	Differentialgleichung
Kategorija:Brażil	Kategorie:Brasilien
Kategorija:Rumanija	Kategorie:Rumänien
Element kimiku	Chemisches Element
Funzjonijiet (matematika)	Funktion (Mathematik)
Kimika organika	Organische Chemie
Mekkanika klassika	Klassische Mechanik
Arti marzjali	Kampfkunst
Rota	Fahrrad
Relatività ristretta	Spezielle Relativitätstheorie
Ħġieġ	Glas
Karta	Papier
Kilogramm	Kilogramm
Cristiano Ronaldo	Cristiano Ronaldo
Metru	Meter
Pittura	Malerei
Skultura	Bildhauerkunst
Żfin	Tanz
Pajjiżi tad-dinja	Liste der Staaten der Erde
Preistorja	Urgeschichte
Silvio Berlusconi	Silvio Berlusconi
Eric Saade	Eric Saade
4′33″	4′33″
Kolera	Cholera
Skerma	Fechten
Sfera ċelesti	Himmelskugel
Malarja	Malaria
AIDS	AIDS
Tuberkulożi	Tuberkulose
Inna	Inna (Sängerin)
Mona Lisa	Mona Lisa
Teorija tan-numri	Zahlentheorie
Kileb	Konsole (Bauwesen)
Biżantini	Byzantinisches Reich
Kruċjata	Kreuzzug
Imperu Ottoman	Osmanisches Reich
Malgrat de Mar	Malgrat de Mar
Stephan El Shaarawy	Stephan El Shaarawy
Tuta tal-għollieq	Brombeeren
Kurgan (belt)	Kurgan (Stadt)
Trapani	Trapani
Wikispeċi	Wikispecies
Lingwa Għarbija	Arabische Sprache
Jum ir-Ringrazzjament	Thanksgiving
Lingwa Oċċitanija	Okzitanische Sprache
Lingwa tas-Sinjali Amerikana	American Sign Language
Kategorija:Provinċji tal-Italja	Italienische Provinzen
Alkoħoliżmu	Alkoholkrankheit
FC Bayern Munich	FC Bayern München
Serie A	Serie A
Queen	Queen (Band)
Provinċja ta' Agrigento	Provinz Agrigent
Provinċja ta' Bergamo	Provinz Bergamo
Provinċja ta' Kaltanissetta	Provinz Caltanissetta
Provinċja ta' Lodi	Provinz Lodi
Wikipedija:Vetrina	Wikipedia:Exzellente Artikel
Dinja	Welt
Wikipedija:Pjazza	Wikipedia:Projektdiskussion
Takson	Taxon
Papa Pawlu VI	Paul VI.
Etna	Ätna
Clube de Regatas do Flamengo	Flamengo Rio de Janeiro
Gerard Piqué	Gerard Piqué
San Lawrenz	Laurentius von Rom
Martin Schulz	Martin Schulz
KAA Gent	KAA Gent
Mudell Standard	Standardmodell
Teorija ta' kollox	Weltformel
Tamworth FC	FC Tamworth
Mafja	Mafia
Manchester United FC	Manchester United
Aston Villa FC	Aston Villa
West Ham United FC	West Ham United
UEFA Champions League	UEFA Champions League
UEFA Europa League	UEFA Europa League
Fenek tal-istrixxi ta' Sumatra	Sumatra-Kaninchen
Tazza tad-Dinja tal-Futbol	Fußball-Weltmeisterschaft
Daniel Parejo Muñoz	Dani Parejo
Blackburn Rovers FC	Blackburn Rovers
Wolverhampton Wanderers FC	Wolverhampton Wanderers
Rafael Correa	Rafael Correa
R. Charleroi SC	Sporting Charleroi
FC Twente	FC Twente Enschede
Motorhead	Motörhead
Milied	Weihnachten
Lingwi Romaniċi	Romanische Sprachen
Steve Jobs	Steve Jobs
Lady Gaga	Lady Gaga
Indoewropew	Indogermanische Sprachen
Muammar al-Gaddafi	Muammar al-Gaddafi
Francesco Totti	Francesco Totti
Chișinău	Chișinău
Soċjoloġija	Soziologie
Şalom	Şalom
Didelphidae	Beutelratten
Caenolestidae	Mausopossums
Trojja	Troja
The Pirate Bay	The Pirate Bay
Kampjonati Ewropej tal-Futbol 2012	Fußball-Europameisterschaft 2012
Dasyuridae	Raubbeutler
Audi	Audi
Abkażja	Abchasien
Antropoloġija	Anthropologie
Baħar l-Aħmar	Rotes Meer
Octave Mirbeau	Octave Mirbeau
Abjad	Weiß
Iswed	Schwarz
Lordi	Lordi
Lingwa uffiċjali	Amtssprache
Provinċja ta' Quảng Bình	Quảng Bình
Entrena	Entrena
Mérida (Veneżwela)	Mérida (Venezuela)
Benito Mussolini	Benito Mussolini
LOST (Serje televiżiva)	Lost (Fernsehserie)
Ġebla tal-ġir	Kalkstein
Valletta	Valletta
Papa Ġwanni XXIII	Johannes XXIII.
Benetice (Světlá nad Sázavou)	Benetice (Světlá nad Sázavou)
Prixtina	Priština
Curaçao	Curaçao
Coccinellidae	Marienkäfer
Metatheria	Beuteltiere
Pangolin	Schuppentiere
Lagomorpha	Hasenartige
Baqra tal-baħar	Seekühe
Eutheria	Höhere Säugetiere
Fenek Ewropew	Wildkaninchen
Leporidae	Hasen
Imperu Kushan	Kuschana
Qlugħ	Segel
Klaas-Jan Huntelaar	Klaas-Jan Huntelaar
Proboscidea	Rüsseltiere
Università Niccolò Cusano	Università degli Studi Niccolò Cusano
FK Radnik Bijeljina	FK Radnik Bijeljina
Fażijiet lunari	Mondphase
Fariżej	Pharisäer
M'Baye Niang	M’Baye Niang
Liebru Ewropew	Feldhase
Lepisma saccharina	Silberfischchen
Membru tal-Parlament Ewropew	Mitglied des Europäischen Parlaments
Laurasiatheria	Laurasiatheria
Afrotheria	Afrotheria
Ewropa t'Isfel	Südeuropa
Ewropa Ċentrali	Mitteleuropa
Lingwa tas-Sinjali Adamorobe	Adamorobe-Gebärdensprache
Kristadelfjani	Christadelphian
Tim nazzjonali tal-futbol tal-Eġittu	Ägyptische Fußballnationalmannschaft
Maja	Maya
Chow Chow	Chow-Chow
FC Kuban Krasnodar	FK Kuban Krasnodar
Kwalifikazzjoni għall-Kampjonati Ewropej tal-Futbol 2008	Fußball-Europameisterschaft 2008/Qualifikation
Chris Smalling	Chris Smalling
Jonny Evans	Jonny Evans
Michael Carrick	Michael Carrick
Multilingwiżmu	Mehrsprachigkeit
Lingwa Sileżjana	Schlesisch (polnischer Dialekt)
Avril Lavigne	Avril Lavigne
Mikhail Gorbachev	Michail Sergejewitsch Gorbatschow
Slogan	Slogan
Madre Tereża ta' Kalkutta	Mutter Teresa
UEFA Champions League 2013–14	UEFA Champions League 2013/14
Rudolf Clausius	Rudolf Clausius
Auguste Rodin	Auguste Rodin
Blogg	Blog
Oscar Wilde	Oscar Wilde
Krakovja	Krakau
Malala Yousafzai	Malala Yousafzai
Carlos Alonso González	Carlos Alonso González
Marsa FC	Marsa FC
Valery Leontiev	Waleri Jakowlewitsch Leontjew
Lingwa tas-Sinjali Franċiża	Langue des signes française
Mużew	Museum
Du Fu	Du Fu
Popolazzjoni	Bevölkerung
Arċipelagu	Archipel
Lingwa Sqallija	Sizilianische Sprache
Valparaíso	Valparaíso
Nju	Niue
Tim nazzjonali tal-futbol tal-Iskozja	Schottische Fußballnationalmannschaft
Lingwa Leoniża	Leonesische Sprache
Żews	Zeus
Lingwa tas-Sinjali	Gebärdensprache
Astroloġija	Astrologie
Mošovce	Mošovce
Saint-Dié-des-Vosges	Saint-Dié-des-Vosges
Boris Yeltsin	Boris Nikolajewitsch Jelzin
Hirohito	Hirohito
Baħar Eġew	Ägäisches Meer
J.K. Rowling	Joanne K. Rowling
Hiroshima	Hiroshima
Mitoloġija Griega	Griechische Mythologie
Ġeneru (tassonomija)	Gattung (Biologie)
Xjenzi soċjali	Sozialwissenschaften
Lista ta' kodiċi telefoniċi	Ländervorwahlliste sortiert nach Nummern
Lista ta' bliet kapitali	Liste der Hauptstädte der Erde
Noemi (kantanta)	Noemi (Sängerin)
Sit elettroniku	Website
Odissea	Odyssee
Lingwa Ido	Ido (Sprache)
Etimoloġija	Etymologie
Nikita Krushchev	Nikita Sergejewitsch Chruschtschow
Kia Motors	Kia Motors
Familja (bijoloġija)	Familie (Biologie)
UEFA	UEFA
Arthur Conan Doyle	Arthur Conan Doyle
Sport Club Corinthians Paulista	Corinthians São Paulo
Lingwa Kopta	Koptische Sprache
Folklor	Folklore
Siligo	Siligo
Mark Zuckerberg	Mark Zuckerberg
Lingwa tas-Sinjali Newzealander	Neuseeländische Gebärdensprache
Neolitiku	Jungsteinzeit
Katerina II tar-Russja	Katharina II. (Russland)
Guglielmo Marconi	Guglielmo Marconi
Ordni (bijoloġija)	Ordnung (Biologie)
Cork	Cork
Renju (bijoloġija)	Reich (Biologie)
Novial	Novial
Aung San Suu Kyi	Aung San Suu Kyi
Kompożitur	Komponist
Influwenza tal-majjali	Schweineinfluenza
Serbja u Montenegro	Serbien und Montenegro
Romantiċiżmu	Romantik
It-Trinita' Mqaddsa	Dreifaltigkeit
Faragħun	Pharao
Mariupol	Mariupol
Tazza tad-Dinja tal-Futbol 2006	Fußball-Weltmeisterschaft 2006
Klaus Ebner	Klaus Ebner
Klassi (bijoloġija)	Klasse (Biologie)
Campora San Giovanni	Campora San Giovanni
Bălţi	Bălți
Auckland Grammar School	Auckland Grammar School
Bolla postali	Briefmarke
Era (mitoloġija)	Hera
Premju Nobel għall-Fiżika	Nobelpreis für Physik
Enya	Enya
Phylum	Stamm (Biologie)
Enriku VIII tal-Ingilterra	Heinrich VIII. (England)
São Paulo FC	FC São Paulo
Kelb tal-Fenek	Pharaonenhund
Baħar Tirren	Tyrrhenisches Meer
Leeds	Leeds
NK Čelik Zenica	NK Čelik Zenica
Surrealiżmu	Surrealismus
San Ġwann (Malta)	San Ġwann
Ħaż-Żabbar	Żabbar
Mosta	Mosta
Tas-Sliema	Sliema
Ħal Qormi	Qormi
Birkirkara	Birkirkara
Radio Studio 54 Network	Radio Studio 54 Network
Lamantin tal-Karibew	Karibik-Manati
Atti ta' l-Appostli	Apostelgeschichte des Lukas
Żodjaku	Tierkreiszeichen
Paulínia	Paulínia
Il-100 ktieb tas-seklu skont Le Monde	Die 100 Bücher des Jahrhunderts von Le Monde
Fonoloġija	Phonologie
Kim Il-sung	Kim Il-sung
Jan Vermeer	Jan Vermeer
Borussia Dortmund	Borussia Dortmund
Għenba tax-xewk	Stachelbeere
Michel de Montaigne	Michel de Montaigne
Golf ta' Biskaja	Biskaya
Sorċid	Spitzmäuse
Feniċi	Phönizien
Akille	Achilleus
Gramma	Gramm
.mt	.mt
Michelangelo Merisi da Caravaggio	Michelangelo Merisi da Caravaggio
Tim nazzjonali tal-futbol ta' Spanja	Spanische Fußballnationalmannschaft
Martin Weinek	Martin Weinek
Björk	Björk
H. G. Wells	H. G. Wells
Tumas More	Thomas Morus
Fernando Torres	Fernando Torres
Lamantin	Rundschwanzseekühe
Baħar Liguri	Ligurisches Meer
Dima Bilan	Dima Bilan
Lega Anżejatika	Hanse
Fażi eliminatorja tal-Kampjonati Ewropej tal-Futbol 2008	Fußball-Europameisterschaft 2008/Finalrunde
Kubiżmu	Kubismus
Qawwiet tal-Assi tat-Tieni Gwerra Dinjija	Achsenmächte
Wikipedija:Mistoqsijiet rikorrenti	Hilfe:FAQ
Għar ta' Thien Duong	Thiên-Đường-Höhle
Tim nazzjonali tal-futbol tal-Ġermanja	Deutsche Fußballnationalmannschaft
Gustave Flaubert	Gustave Flaubert
San Mattew	Matthäus (Evangelist)
Sant'Ambroġju	Ambrosius von Mailand
Ġwanni Kriżostmu	Johannes Chrysostomos
Papa Piju X	Pius X.
Papa Ljun XIII	Leo XIII.
Rasputin	Grigori Jefimowitsch Rasputin
San Girgor Nażjanżenu	Gregor von Nazianz
Egon Schiele	Egon Schiele
Duminku ta' Guzmán	Dominikus
Hamit Altıntop	Hamit Altıntop
Maximilien Robespierre	Maximilien de Robespierre
Ġlormu	Hieronymus (Kirchenvater)
San Bażilju	Basilius der Große
Michel Foucault	Michel Foucault
Daniel Van Buyten	Daniel Van Buyten
Ilarju ta' Poitiers	Hilarius von Poitiers
Rabat (Malta)	Rabat (Malta)
Fgura	Fgura
Żejtun	Żejtun
Naxxar	Naxxar
Iż-Żurrieq	Żurrieq
John Henry Newman	John Henry Newman
Ħ'Attard	Attard
Ħaż-Żebbuġ	Żebbuġ
Morus (botanika)	Maulbeeren
Son Doong	Sơn-Đoòng-Höhle
Alex Ferguson	Alex Ferguson
Erwin Hoffer	Erwin Hoffer
Arkanġlu Mikiel	Michael (Erzengel)
Titan	Titan (Mythologie)
Kardinal	Kardinal
Iżabella ta' Kastilja	Isabella I. (Kastilien)
Liebru	Echte Hasen
Felix Mendelssohn	Felix Mendelssohn Bartholdy
Orikteropu	Erdferkel
Leonardo Araújo	Leonardo Nascimento de Araújo
Espoo	Espoo
Bijodiversità	Biodiversität
Kannella (kulur)	Braun
Tizjanu	Tizian
Matteo Renzi	Matteo Renzi
Venere (mitoloġija)	Venus (Mythologie)
Tazza tad-Dinja tal-Futbol 2002	Fußball-Weltmeisterschaft 2002
Tim nazzjonali tal-futbol tal-Ingilterra	Englische Fußballnationalmannschaft
Tim nazzjonali tal-futbol ta' Franza	Französische Fußballnationalmannschaft
Sid Vicious	Sid Vicious
Mario Monti	Mario Monti
Stojċiżmu	Stoa
Martin Heidegger	Martin Heidegger
Tazza tad-Dinja tal-Futbol 1930	Fußball-Weltmeisterschaft 1930
Università ta' New York	New York University
Giulio Andreotti	Giulio Andreotti
Park Ji-Sung	Park Ji-sung
Slaten Maġi	Heilige Drei Könige
Charles de Foucauld	Charles de Foucauld
Pajjiżi Nordiċi	Nordische Länder
Kategorija:Mudelli tal-kimika	Kategorie:Vorlage:Chemie
Trattat ta' Liżbona	Vertrag von Lissabon
Claudio Monteverdi	Claudio Monteverdi
Iraċ	Schliefer
Sami Khedira	Sami Khedira
FC Baku	FK Baku
Provinċja ta' Soria	Provinz Soria
Arkanġlu Rafel	Raphael (Erzengel)
George Abela	George Abela
Moħammed VI	Mohammed VI. (Marokko)
Jum l-Indipendenza	Nationalfeiertag
Lawrence Gonzi	Lawrence Gonzi
Għaxaq FC	FC Għaxaq
Assedju ta' Malta (1565)	Belagerung von Malta (1565)
CONMEBOL	CONMEBOL
Erbivoru	Pflanzenfresser
Herbert von Bismarck	Herbert von Bismarck
Schönhausen	Schönhausen (Elbe)
Oskar Schindler	Oskar Schindler
Enejide	Aeneis
Flamurtari Vlorë	KS Flamurtari Vlora
Besa Kavajë	KS Besa Kavaja
KF Laçi	KF Laçi
Affiss	Affix (Linguistik)
Norberto Murara Neto	Norberto Murara Neto
L-Għanja tal-Milied	A Christmas Carol
Semitiku	Semiten
Marrara	Gallenblase
Sottospeċi	Unterart
Ħassan II	Hassan II.
It-Tielet Repubblika Franċiża	Dritte Französische Republik
Joyeux Noël	Merry Christmas (Film)
FK Kukësi	FK Kukësi
KF Skënderbeu Korçë	KF Skënderbeu Korça
Carlos Bacca	Carlos Bacca
Bank Ċentrali ta' Malta	Bank Ċentrali ta’ Malta
Yıldıray Baştürk	Yıldıray Baştürk
Alfred Wegener	Alfred Wegener
Juli Zeh	Juli Zeh
Żingari	Zigeuner
Edith Stein	Edith Stein
Friedrich Carl von Savigny	Friedrich Carl von Savigny
Walter Andreas Schwarz	Walter Andreas Schwarz
Johanna von Puttkamer	Johanna von Puttkamer
Wilhelm von Humboldt	Wilhelm von Humboldt
Wikipedija:Vetrina/Senjalazzjonijiet	Wikipedia:Kandidaturen von Artikeln, Listen und Portalen
Tazza tad-Dinja tal-Futbol 2014	Fußball-Weltmeisterschaft 2014
Coronel Fabriciano	Coronel Fabriciano
Senglea Athletic FC	Senglea Athletics
Miroslav Klose	Miroslav Klose
Alla Pugacheva	Alla Borissowna Pugatschowa
Dante Bonfim Costa Santos	Dante Bonfim Costa Santos
Isco	Isco
Fes	Fès
Liebru taż-żarbuna tas-silġ	Schneeschuhhase
Greenpeace	Greenpeace
KS Vllaznia Shkodër	KS Vllaznia Shkodra
Teuta Durrës	KS Teuta Durrës
Ragħaj	Schäferei
Arkanġlu Gabrijel	Gabriel (Erzengel)
Mata Hari	Mata Hari
Fußball-Bundesliga	Fußball-Bundesliga
Pressjoni tad-demm	Blutdruck
Feria del Sol (Mérida)	Feria del Sol
Enea	Aeneas
Politiku	Politiker
David Villa	David Villa
Demenzja	Demenz
Jürgen Klopp	Jürgen Klopp
Tazza tan-Nazzjonijiet Afrikani	Fußball-Afrikameisterschaft
Romeo u Ġuljetta	Romeo und Julia
Konfederazzjoni Ażjatika tal-Futbol	Asian Football Confederation
Robin Williams	Robin Williams
Normanni	Normannen
Tim nazzjonali tal-futbol tal-Brażil	Brasilianische Fußballnationalmannschaft
Grupp (matematika)	Gruppe (Mathematik)
Mesut Özil	Mesut Özil
Isabel Allende	Isabel Allende
Wes Brown	Wes Brown
It-Tempesta	Der Sturm (Shakespeare)
Jum l-Indipendenza (Stati Uniti)	Unabhängigkeitstag (Vereinigte Staaten)
Mudell:Ċita ktieb	Vorlage:Literatur
Robert Tappan Morris	Robert Tappan Morris
Divorzju	Scheidung
Chrzanów	Chrzanów
Impuls FC Dilijan	Impuls Dilidschan
Medjugori	Međugorje
Suffiss	Suffix
Artiklu (grammatika)	Artikel (Wortart)
Australopithecus	Australopithecus
Festival tal-Eurovision tat-Tfal	Junior Eurovision Song Contest
Kaspar Capparoni	Kaspar Capparoni
Ħolma ta’ Lejla Sajfija	Ein Sommernachtstraum
Berthe Morisot	Berthe Morisot
Manuel Neuer	Manuel Neuer
Penny Black	One Penny Black
Armistizju	Waffenstillstand
KV Mechelen	KV Mechelen
Heiko Westermann	Heiko Westermann
Montenegro fil-Festival tal-Eurovision	Montenegro beim Eurovision Song Contest
Papa Ċelestinu V	Coelestin V.
Luftëtari Gjirokastër	KS Luftëtari Gjirokastra
Amedeo Modigliani	Amedeo Modigliani
Appendiċite	Appendizitis
Marco Streller	Marco Streller
Hakan Yakın	Hakan Yakin
Ludovic Magnin	Ludovic Magnin
Diego Benaglio	Diego Benaglio
Daniel Bernoulli	Daniel Bernoulli
Jacob Bernoulli	Jakob I. Bernoulli
Stella Mwangi	Stella Mwangi
Dziecinów	Dziecinów (Powiat Otwocki)
Pajjiż interkjuż	Binnenstaat
Marcel Bezençon	Marcel Bezençon
Jacob II Bernoulli	Jakob II. Bernoulli
Johann III Bernoulli	Johann III. Bernoulli
Nicolaus I Bernoulli	Nikolaus I. Bernoulli
Johann II Bernoulli	Johann II. Bernoulli
Nicolaus II Bernoulli	Nikolaus II. Bernoulli
Gwerer Puniċi	Punische Kriege
Ġunone	Juno (Mythologie)
Massimo Oddo	Massimo Oddo
Fraizer Campbell	Fraizer Campbell
Allianz Arena	Allianz Arena
San Ġużepp	Josef von Nazaret
Hidetoshi Nakata	Hidetoshi Nakata
FK Borac Banja Luka	FK Borac Banja Luka
L-Aħħar Ċena (Leonardo)	Das Abendmahl (Leonardo da Vinci)
Macroscelididae	Rüsselspringer
Dugongu	Dugong
Galway	Galway
Mario Balotelli	Mario Balotelli
Marvin Compper	Marvin Compper
Fenek ta' denbu qotni tal-muntanji	Berg-Baumwollschwanzkaninchen
Macbeth	Macbeth (Shakespeare)
Theria	Theria
Akropoli ta' Ateni	Akropolis (Athen)
Filatelija	Philatelie
Stromboli	Stromboli
The Fame	The Fame
FK Austria Wien	FK Austria Wien
SK Rapid Wien	SK Rapid Wien
Venere ta' Willendorf	Venus von Willendorf
Bandiera ta' Malta	Flagge Maltas
Teorija tal-grafi	Graphentheorie
Lola Pagnani	Lola Pagnani
Bitcoin	Bitcoin
Tim nazzjonali tal-futbol tad-Danimarka	Dänische Fußballnationalmannschaft
Black metal	Black Metal
Ġeroglifiċi Eġizzjani	Ägyptische Hieroglyphen
Pika ta' Kozlov	Ochotona koslowi
Sataniżmu	Satanismus
Grawnd Nazzjonali ta' Bejġing	Nationalstadion Peking
Stadio Giuseppe Meazza	Giuseppe-Meazza-Stadion
SC Wiener Neustadt	SC Wiener Neustadt
Plotinu	Plotin
Tim nazzjonali tal-futbol tal-Kroazja	Kroatische Fußballnationalmannschaft
Eomanis	Eomanis
Tim nazzjonali tal-futbol tal-Greċja	Griechische Fußballnationalmannschaft
Pika ta' Muli	Ochotona muliensis
Tazza tad-Dinja tal-Futbol tal-Klabbs 2006	FIFA-Klub-Weltmeisterschaft 2006
Tazza tad-Dinja tal-Futbol tal-Klabbs 2007	FIFA-Klub-Weltmeisterschaft 2007
Tazza tad-Dinja tal-Futbol tal-Klabbs 2009	FIFA-Klub-Weltmeisterschaft 2009
Tazza tad-Dinja tal-Futbol tal-Klabbs 2008	FIFA-Klub-Weltmeisterschaft 2008
Fenek tal-bassasa	Marschkaninchen
Yarala	Yarala
Fenek ta' denbu qotni tal-muntanji ta' Appalach	Sylvilagus obscurus
Fenek ta' denbu qotni tal-muntanji ta' Manzano	Sylvilagus cognatus
Neymar	Neymar
Nimbacinus	Nimbacinus
Brendi	Weinbrand
Dominju (bijoloġija)	Domäne (Biologie)
Kassisa	Schwarze Johannisbeere
Daniel Schneidermann	Daniel Schneidermann
Dragan Đokanović	Dragan Đokanović
David de Gea	David de Gea
Westfalenstadion	Signal Iduna Park
Robert Lewandowski	Robert Lewandowski
Kunflitt Iżraeli-Palestinjan	Israelisch-Palästinensischer Konflikt
Għajnuna:Kif timmodifika artiklu	Hilfe:Seite bearbeiten
Lidl	Lidl
Jupp Heynckes	Jupp Heynckes
Plutone (mitoloġija)	Pluton
Eddie Fenech Adami	Edward Fenech Adami
Riccardo Montolivo	Riccardo Montolivo
Ġnien Botaniku ta' Mérida	Botanischer Garten von Mérida
Tazza tad-Dinja tal-Futbol tal-Klabbs 2010	FIFA-Klub-Weltmeisterschaft 2010
Cristian Zaccardo	Cristian Zaccardo
Gwerra totali	Totaler Krieg
Nickelodeon	Nickelodeon
Ugo Grozju	Hugo Grotius
René Adler	René Adler
Eruka	Garten-Senfrauke
Ablativ	Ablativ
Tazza Ażjatika tal-Futbol	Fußball-Asienmeisterschaft
Boomerang TV	Boomerang (Fernsehsender)
Internazzjonali Soċjalista	Sozialistische Internationale
Nannakola tas-seba' tikek	Siebenpunkt-Marienkäfer
Santa Sede	Heiliger Stuhl
Ettore	Hektor
WK	Anno Domini
Reġina ta' Saba	Königin von Saba
Alġebra astratta	Abstrakte Algebra
CONCACAF	CONCACAF
Skanderbeg	Skanderbeg
Tim nazzjonali tal-futbol tal-Iżvezja	Schwedische Fußballnationalmannschaft
Raducz	Raducz
Paul Allen	Paul Allen
Eroj	Held
Kuopio	Kuopio
Sirt	Sirte
Vittoriosa Stars FC	Vittoriosa Stars
Soccer City	FNB-Stadion
Tim nazzjonali tal-futbol tal-Awstrija	Österreichische Fußballnationalmannschaft
Tim nazzjonali tal-futbol tal-Irlanda	Irische Fußballnationalmannschaft
Nemanja Vidić	Nemanja Vidić
Derry	Derry
Ġuvni	Bachelor
Drużiżmu	Drusen
Carlos Vidal	Carlos Vidal
Omnivoru	Allesfresser
George Best	George Best
Oliver Twist	Oliver Twist
Juan Carreño	Juan Carreño
Javier Hernández Balcázar	Javier Hernández
Tim nazzjonali tal-futbol tal-Iżvizzera	Schweizer Fussballnationalmannschaft
Ekwazzjoni ta' Schrödinger	Schrödingergleichung
Priżma	Prisma (Optik)
Ballun tad-Deheb	Ballon d’Or
Tim nazzjonali tal-futbol tal-Polonja	Polnische Fußballnationalmannschaft
Foviżmu	Fauvismus
Tim nazzjonali tal-futbol tal-Belġju	Belgische Fußballnationalmannschaft
Dom Mintoff	Dom Mintoff
Sant'Antnin ta' Padova	Antonius von Padua
Eredivisie	Eredivisie
Ugo Mifsud Bonnici	Ugo Mifsud Bonniċi
Guido de Marco	Guido de Marco
Pawlu Xuereb	Paul Xuereb
Liebru iswed	Espiritu-Santo-Hase
Ċensu Tabone	Ċensu Tabone
Konfederazzjoni Afrikana tal-Futbol	Confédération Africaine de Football
Agatha Barbara	Agatha Barbara
Tim nazzjonali tal-futbol tar-Rumanija	Rumänische Fußballnationalmannschaft
Zeca Pagodinho	Zeca Pagodinho
Dimitar Berbatov	Dimitar Berbatow
Tim nazzjonali tal-futbol tal-Ukrajna	Ukrainische Fußballnationalmannschaft
Għawdex	Gozo
Tim nazzjonali tal-futbol tal-Ungerija	Ungarische Fußballnationalmannschaft
Natura mejta	Stillleben
Laura Pausini	Laura Pausini
Gwerra Anglo-Żanżibarjana	Britisch-Sansibarischer Krieg
Xgħajra Tornadoes FC	Xgħajra Tornadoes
Children of Bodom	Children of Bodom
Festival tal-Eurovision 1956	Eurovision Song Contest 1956
Tazza tal-Konfederazzjonijiet	FIFA-Konföderationen-Pokal
Tim nazzjonali tal-futbol tas-Slovenja	Slowenische Fußballnationalmannschaft
Darren Fletcher	Darren Fletcher
Gowler	Torwart
Mary Cassatt	Mary Cassatt
Frankinċens	Weihrauch
Cape Town Stadium	Kapstadt-Stadion
Xenarthra	Nebengelenktiere
Edward Scicluna	Edward Scicluna
Lira Maltija	Maltesische Lira
Antonio Valencia	Luis Antonio Valencia
Tim nazzjonali tal-futbol tas-Slovakkja	Slowakische Fußballnationalmannschaft
Tereża ta' Ávila	Teresa von Ávila
Guernica (pittura)	Guernica (Bild)
Tim nazzjonali tal-futbol ta' New Zealand	Neuseeländische Fußballnationalmannschaft
Kompjuter kwantistiku	Quantencomputer
Tazza tad-Dinja tal-Futbol 2010	Fußball-Weltmeisterschaft 2010
Andrea Palladio	Andrea Palladio
Heurelho Gomes	Heurelho Gomes
Moviment Brownjan	Brownsche Bewegung
Filosofija Presokratika	Vorsokratiker
Marvin Ogunjimi	Marvin Ogunjimi
Apparat Periferali	Peripheriegerät
Meknès	Meknès
Copa América	Copa América
Żebbuġ (Għawdex)	Żebbuġ (Gozo)
Serje ta' Fourier	Fourierreihe
Santa Katarina ta' Lixandra	Katharina von Alexandrien
Lipari	Liparische Inseln
Clayton Failla	Clayton Failla
Liebru tal-muntanji	Schneehase
Konfederazzjoni Oċeanika tal-Futbol	Oceania Football Confederation
Kwalifikazzjoni għall-Kampjonati Ewropej tal-Futbol 2012	Fußball-Europameisterschaft 2012/Qualifikation
Tim nazzjonali tal-futbol tal-Andorra	Andorranische Fußballnationalmannschaft
Tim nazzjonali tal-futbol tal-Ażerbajġan	Aserbaidschanische Fußballnationalmannschaft
Klassifika dinjija tal-FIFA	FIFA-Weltrangliste
Charlotte Perrelli	Charlotte Perrelli
Tim nazzjonali tal-futbol tal-Bulgarija	Bulgarische Fußballnationalmannschaft
Tim nazzjonali tal-futbol ta' Wales	Walisische Fußballnationalmannschaft
Atomium	Atomium
Tim nazzjonali tal-futbol tal-Bożnija u Ħerżegovina	Bosnisch-herzegowinische Fußballnationalmannschaft
Tereża ta' Lisieux	Therese von Lisieux
Tabella tal-midalji tal-Logħob Olimpiku tas-sajf 2008	Medaillenspiegel der Olympischen Sommerspiele 2008
Ellis Park Stadium	Ellis-Park-Stadion
Tazza Interkontinentali (futbol)	Weltpokal (Vereinsfußball)
Bing	Bing (Suchmaschine)
Plejer tas-Sena tal-FIFA	Weltfußballer des Jahres
Santa Luċija (qaddisa)	Lucia von Syrakus
Tim nazzjonali tal-futbol tal-Armenja	Armenische Fußballnationalmannschaft
San Bastjan	Sebastian (Heiliger)
Kolugo	Riesengleiter
Tim nazzjonali tal-futbol tal-Każakistan	Kasachische Fußballnationalmannschaft
Tazza tal-Konfederazzjonijiet 2009	FIFA-Konföderationen-Pokal 2009
Pika	Ochotona
Thomas Vermaelen	Thomas Vermaelen
UEFA Champions League 2009–10	UEFA Champions League 2009/10
Tim nazzjonali tal-futbol tal-Lussemburgu	Luxemburgische Fußballnationalmannschaft
Diġitigrad	Zehengänger
Gareth Bale	Gareth Bale
Inkwiżizzjoni Spanjola	Spanische Inquisition
Glen Johnson	Glen Johnson (Fußballspieler)
Manuel Rivera-Ortiz	Manuel Rivera-Ortiz
Tim nazzjonali tal-futbol ta' San Marino	San-marinesische Fußballnationalmannschaft
Pika tal-kullar	Alaska-Pfeifhase
Immakulata Kunċizzjoni	Unbefleckte Empfängnis
Nigel de Jong	Nigel de Jong
Tim nazzjonali tal-futbol tal-Bjelorussja	Weißrussische Fußballnationalmannschaft
Tim nazzjonali tal-futbol tal-Albanija	Albanische Fußballnationalmannschaft
Tim nazzjonali tal-futbol tal-Ġeorġja	Georgische Fußballnationalmannschaft
Tim nazzjonali tal-futbol tal-Litwanja	Litauische Fußballnationalmannschaft
Karmelitani	Karmeliten
UEFA Champions League 2007–08	UEFA Champions League 2007/08
Tim nazzjonali tal-futbol tal-Finlandja	Finnische Fußballnationalmannschaft
Tim nazzjonali tal-futbol tal-Liechtenstein	Liechtensteinische Fussballnationalmannschaft
Premier League 2008–09	Premier League 2008/09
Tim nazzjonali tal-futbol tal-Estonja	Estnische Fußballnationalmannschaft
Premier League 2010–11	Premier League 2010/11
Ħin supplementari	Verlängerung (Fußball)
Peter Mokaba Stadium	Peter-Mokaba-Stadion
Joe Hart	Joe Hart
Malena Ernman	Malena Ernman
Liechtenstein fil-Festival tal-Eurovision	Liechtenstein beim Eurovision Song Contest
Premier League 2007–08	Premier League 2007/08
RSC Anderlecht	RSC Anderlecht
Barriera	Steinbruch
Oroskopju	Horoskop
Eġizzjan demotiku	Demotische Schrift
Fatt	Tatsache
FK Partizan	FK Partizan Belgrad
Tim nazzjonali tal-futbol ta' Malta	Maltesische Fußballnationalmannschaft
Supereroj	Superheld
UEFA Champions League 2008–09	UEFA Champions League 2008/09
Tim nazzjonali tal-futbol ta' Ċipru	Zyprische Fußballnationalmannschaft
Premier League 2009–10	Premier League 2009/10
Tim nazzjonali tal-futbol tal-Montenegro	Montenegrinische Fußballnationalmannschaft
Andrey Korotayev	Andrei Witaljewitsch Korotajew
UEFA Champions League 2010–11	UEFA Champions League 2010/11
Rafael Pereira da Silva (twieled fl-1990)	Rafael Pereira da Silva
FA Community Shield	FA Community Shield
Tim nazzjonali tal-futbol tal-Iżlanda	Isländische Fußballnationalmannschaft
Tim nazzjonali tal-futbol tal-Unjoni Sovjetika	Fußballnationalmannschaft der UdSSR
Soċjaliżmu Demokratiku	Demokratischer Sozialismus
Tim nazzjonali tal-futbol tal-Latvja	Lettische Fußballnationalmannschaft
CONCACAF Gold Cup	CONCACAF Gold Cup
Pont du Gard	Pont du Gard
Sligo	Sligo
Emblema ta' Malta	Wappen Maltas
Benvenuto Cellini	Benvenuto Cellini
Ordni Militari Sovran ta' Malta	Souveräner Malteserorden
Standard Liège	Standard Lüttich
Club Brugge KV	FC Brügge
Jóhanna Guðrún Jónsdóttir	Jóhanna Guðrún Jónsdóttir
Tim nazzjonali tal-futbol tal-Irlanda ta' Fuq	Nordirische Fußballnationalmannschaft
Edward Sapir	Edward Sapir
Kemmuna	Comino
FC BATE Borisov	BATE Baryssau
Lucrezia Borgia	Lucrezia Borgia
Klara ta' Assisi	Klara von Assisi
Tim nazzjonali tal-futbol tal-Iżrael	Israelische Fußballnationalmannschaft
Gareth Barry	Gareth Barry
San Valentinu	Valentin von Terni
FK Ekranas	Ekranas Panevėžys
Mini ta' Cu Chi	Tunnel von Củ Chi
L-Innu Malti	L-Innu Malti
Midfilder	Mittelfeldspieler
Kwalifikazzjoni għat-Tazza tad-Dinja tal-Futbol 2010	Fußball-Weltmeisterschaft 2010/Qualifikation
Kate Ryan	Kate Ryan
Lys Assia	Lys Assia
Patri Piju	Pio von Pietrelcina
Analisi komplessa	Funktionentheorie
Martín Cáceres	Martín Cáceres
Opossum bugeddum skur	Ecuador-Opossummaus
Opossum ta' denbu qasir ta' Osgood	Osgoods Kurzschwanzopossum
Fenek ta' denbu qotni tal-muntanji ta' Davis	Sylvilagus robustus
Royale Union Saint-Gilloise	Royale Union Saint-Gilloise
Łobez	Łobez
Fertilizzazzjoni ''in vitro''	In-vitro-Fertilisation
Tim nazzjonali tal-futbol tal-Gżejjer Faroe	Färöische Fußballnationalmannschaft
Magnificat	Magnificat
Theofanis Gekas	Theofanis Gekas
Ażerbajġan fil-Festival tal-Eurovision	Aserbaidschan beim Eurovision Song Contest
Papat ta' Avignon	Avignonesisches Papsttum
G-14	G-14
Glen Vella	Glen Vella
Armenja fil-Festival tal-Eurovision	Armenien beim Eurovision Song Contest
Tereza Kerndlová	Tereza Kerndlová
Albanija fil-Festival tal-Eurovision	Albanien beim Eurovision Song Contest
Rush	Rush
Dundalk	Dundalk
Kumitat tar-Reġjuni	Ausschuss der Regionen
Id-Dsatax-il Emenda għall-Kostituzzjoni tal-Istati Uniti	19. Zusatzartikel zur Verfassung der Vereinigten Staaten
Mandejżmu	Mandäer
'O sole mio	’O sole mio
SK Sturm Graz	SK Sturm Graz
Il-Merkant ta’ Venezja	Der Kaufmann von Venedig
Hugo (film)	Hugo Cabret
Hapoel Tel Aviv FC	Hapoel Tel Aviv
UEFA Europa League 2009–10	UEFA Europa League 2009/10
Phil Jones	Phil Jones (Fußballspieler, 1992)
UEFA Europa League 2010–11	UEFA Europa League 2010/11
Olympe de Gouges	Olympe de Gouges
Giovanni Falcone	Giovanni Falcone
Mdina	Mdina
Vulcano	Vulcano
Tranquillo Barnetta	Tranquillo Barnetta
Liġi tan-numri kbar	Gesetz der großen Zahlen
Andorra fil-Festival tal-Eurovision	Andorra beim Eurovision Song Contest
Kitba jeratika	Hieratische Schrift
Rapidshare	Rapidshare
Batterija	Batterie
Kung fu	Kung Fu
San Marino fil-Festival tal-Eurovision	San Marino beim Eurovision Song Contest
Federico Macheda	Federico Macheda
Regola tal-gowls barra mid-dar	Auswärtstorregel
Las Meninas	Las Meninas
Ingólfr Arnarson	Ingólfur Arnarson
Talpa marsupjal ta' Nofs in-nhar	Großer Beutelmull
Talpa marsupjal tat-Tramuntana	Kleiner Beutelmull
Elezzjonijiet Ewropej 2009	Europawahl 2009
KF Tirana	KF Tirana
Superliga Albaniża	Kategoria Superiore
Kewkba ta' Betlehem	Stern von Betlehem
FC Dinamo Minsk	FK Dinamo Minsk
Nick Drake	Nick Drake
Marokk fil-Festival tal-Eurovision	Marokko beim Eurovision Song Contest
Zoran Tošić	Zoran Tošić
Golf	Golf
Palazz Belvedere	Schloss Belvedere
Andrea Poli	Andrea Poli
Bjelorussja fil-Festival tal-Eurovision	Weißrussland beim Eurovision Song Contest
Artemisia Gentileschi	Artemisia Gentileschi
Gżejjer Aran	Aran-Inseln
André Villas-Boas	André Villas-Boas
Samir Handanovič	Samir Handanovič
Ignazio Abate	Ignazio Abate
Gelson Fernandes	Gelson Fernandes
Idriss Carlos Kameni	Carlos Kameni
Marlee Matlin	Marlee Matlin
Dasyuromorphia	Raubbeutlerartige
Football League	The Football League
Fábio Pereira da Silva	Fábio Pereira da Silva
Antonio Nocerino	Antonio Nocerino
Mohamed Bouazizi	Mohamed Bouazizi
Anna Bergendahl	Anna Bergendahl
Denílson Pereira Neves	Denílson Pereira Neves
Emerson Ferreira da Rosa	Emerson Ferreira da Rosa
L-Ewwel Diviżjoni Belġjana	Pro League (Belgien)
KRC Genk	KRC Genk
Lied	Kunstlied
Kalkulu tal-varjazzjonijiet	Variationsrechnung
Ġgantija	Ġgantija
UNCLOS Konvenzjoni tal-Ġnus Magħquda dwar id-Dritt tal-Baħar	Seerechtsübereinkommen
Trama (narrattiva)	Handlung (Erzählkunst)
Filippu Neri	Philipp Neri
Neftchi Baku PFC	Neftçi Baku PFK
Fenek ta' denbu qotni tal-artijiet baxxi tal-Veneżwela	Sylvilagus varynaensis
Bundesliga (Awstrija)	Fußball-Bundesliga (Österreich)
Al-Fatiħa	Al-Fātiha
Tazza tal-Konfederazzjonijiet 2013	FIFA-Konföderationen-Pokal 2013
Giuseppe Rossi	Giuseppe Rossi (Fußballspieler)
Darron Gibson	Darron Gibson
Russja fil-Festival tal-Eurovision	Russland beim Eurovision Song Contest
Enzo Scifo	Enzo Scifo
Air Malta	Air Malta
F91 Dudelange	F91 Düdelingen
FC Santa Coloma	FC Santa Coloma
KSC Lokeren Oost-Vlaanderen	Sporting Lokeren
AZAL PFK	AZAL PFK Baku
Tito Vilanova	Tito Vilanova
Tazza tad-Dinja tal-Futbol tal-Klabbs	FIFA-Klub-Weltmeisterschaft
No (teatru)	Nō
AFC	AFC
CAF	CAF
Premier League (diżambigwazzjoni)	Premier League (Begriffsklärung)
Alessandro Nesta	Alessandro Nesta
Johann Bernoulli	Johann Bernoulli
Tribù (bijoloġija)	Tribus (Biologie)
Santa Katerina ta' Siena	Katharina von Siena
Alexa Internet	Alexa Internet
Tupaja	Spitzhörnchen
Liebru tal-Artiku	Polarhase
Żarbuna tad-Deheb	Goldener Schuh (UEFA)
Denis Law	Denis Law
Taljan	Italienisch
Al-Iħlas	Al-Ichlās
Notoryctemorphia	Beutelmulle
Daniele Bonera	Daniele Bonera
Incertae sedis	Incertae sedis
Ġużeppina Bakhita	Josefine Bakhita
Susanne Georgi	Susanne Georgi
Sofonisba Anguissola	Sofonisba Anguissola
Diana Gurtskaya	Diana Gurzkaia
Elena Gheorghe	Elena Gheorghe
Hadise	Hadise
Lavinia Fontana	Lavinia Fontana
Marie Myriam	Marie Myriam
Mira Awad	Mira Awad
Nicole Hohloch	Nicole (Sängerin, 1964)
Amanda Michalka	Amanda Michalka
Chiara Siracusa	Chiara Siracusa
Alyson Michalka	Alyson Michalka
Aysel Teymurzadeh	Aysel Teymurzadə
Olta Boka	Olta Boka
Magdalena Tul	Magdalena Tul
Premier League Armen	Bardsragujn chumb
Andrea Demirović	Andrea Demirović
Thea Garrett	Thea Garrett
Rosalba Carriera	Rosalba Carriera
4FUN	4 Fun
Al-naxid al-xarif	Hymne Chérifien
Ġeorġja fil-Festival tal-Eurovision	Georgien beim Eurovision Song Contest
FK Sarajevo	FK Sarajevo
Konvenzjoni ta' Vjenna dwar id-Dritt tat-Trattati	Wiener Übereinkommen über das Recht der Verträge
Mathé Altéry	Mathé Altéry
Grupp D tal-Kampjonati Ewropej tal-Futbol 2008	Fußball-Europameisterschaft 2008/Gruppe D
Muniti tal-ewro ta' Malta	Maltesische Euromünzen
Kampjonati Ewropej tal-Futbol 2008	Fußball-Europameisterschaft 2008
Myrmecobiidae	Numbat
Papessa Ġovanna	Päpstin Johanna
Ġwann Marija Vianney	Jean-Marie Vianney
Ottorino Respighi	Ottorino Respighi
Storja ta' Malta	Geschichte Maltas
Marmosa	Zwergbeutelratten
Fenek pigmew	Zwergkaninchen (Art)
FC Pyunik	FC Pjunik Jerewan
Mikrostat	Zwergstaat
Vinċenz de Paul	Vinzenz von Paul
Premier League Bjelorussu	Wyschejschaja Liha
Linfield FC	Linfield FC
Peramelemorphia	Nasenbeutler
Anders Lindegaard	Anders Lindegaard
Florentino Pérez	Florentino Pérez
Ċipru fil-Festival tal-Eurovision	Zypern beim Eurovision Song Contest
Marca	Marca (Begriffsklärung)
Diżugwaljanza ta' Čebyšëv	Tschebyscheff-Ungleichung
Rabat	Rabat (Begriffsklärung)
Anton Buttigieg	Anton Buttiġieġ
Halloween	Halloween
Kuruna tal-Avvent	Adventskranz
FIFA	FIFA
Dipendenza (Informatika)	Kopplung (Softwareentwicklung)
Primera Divisió	Primera Divisió
Liebru Etjopjan	Äthiopischer Hase
Liebru tal-altipjan tal-Etjopja	Äthiopischer Hochlandhase
Birżebbuġa	Birżebbuġa
Imblokk Kontinentali	Kontinentalsperre
Tupaia	Eigentliche Spitzhörnchen
Sumgayit PFC	Sumqayıt PFK
Kampjonati Ewropej tal-Futbol	Fußball-Europameisterschaft
Emmanuel Muscat	Emmanuel Muscat
FC Wacker Innsbruck (2002)	FC Wacker Innsbruck (2002)
Msida Saint-Joseph FC	FC Msida Saint Joseph
Constant Vanden Stock Stadium	Constant-Vanden-Stock-Stadion
Pangolin ta' denbu twil	Langschwanzschuppentier
NK Široki Brijeg	NK Široki Brijeg
SV Mattersburg	SV Mattersburg
Jean Parisot de la Valette	Jean de la Valette
Palazz Leopoldskron	Leopoldskron-Moos
Wayne Rooney	Wayne Rooney
Marsa	Marsa
Tim nazzjonali tal-futbol tal-Awstralja	Australische Fußballnationalmannschaft
Pangolin Malajan	Malaiisches Schuppentier
Nouvelle Fédération-Board	NF-Board
Alfonsu Marija de Liguori	Alfonso Maria de Liguori
Bulgarija fil-Festival tal-Eurovision	Bulgarien beim Eurovision Song Contest
Ukraina fil-Festival tal-Eurovision	Ukraine beim Eurovision Song Contest
Bożnija u Ħerżegovina fil-Festival tal-Eurovision	Bosnien und Herzegowina beim Eurovision Song Contest
Gwen John	Gwen John
Forma (botanika)	Form (Biologie)
Attakkant	Stürmer (Fußball)
Mario Grech	Mario Grech
Nihat Kahveci	Nihat Kahveci
Elisabetta Canalis	Elisabetta Canalis
Nela Pocisková	Nela Pocisková
Christina Metaxa	Christina Metaxa
Jetty Paerl	Jetty Paerl
Ira Losco	Ira Losco
Ilary Blasi	Ilary Blasi
Olivia Lewis	Olivia Lewis
Nicoleta Matei	Nicoleta Matei
Pika ta' Forrest	Ochotona forresti
Didelphis	Opossums
Hasse Jeppson	Hasse Jeppson
CE Principat	CE Principat
Piero Soderini	Piero Soderini
Istitut tal-Unjoni Ewropea għall-Istudji dwar is-Sigurtà	Institut der Europäischen Union für Sicherheitsstudien
Morena Camilleri	Morena Camilleri
Oscar Romero	Óscar Romero
Marte	Marte
Nickelodeon (Amerika)	Nickelodeon (Begriffsklärung)
Karl Shuker	Karl Shuker
Lisandro López	Lisandro López
Chris Eagles	Chris Eagles
Gianluca Ramazzotti	Gianluca Ramazzotti
ASEAN Football Federation	ASEAN Football Federation
Robertu Bellarmino	Robert Bellarmin
St. Georges FC	FC St. George’s
Fenek tax-xmara	Buschmannhase
Opossum ta' spallejh suwed	Binden-Wollbeutelratte
Fenek ta' Assam	Borstenkaninchen
Den Dreef	Stadion Den Dreef
Salve Reġina	Salve Regina
FK Liepājas Metalurgs	FK Liepājas Metalurgs
Michael Mifsud	Michael Mifsud
L-Iklin	Iklin
John O'Shea	John O’Shea
Guillermo Stábile	Guillermo Stábile
Massimo Busacca	Massimo Busacca
Ritchie De Laet	Ritchie De Laet
Manucho Gonçalves	Manucho
Diego Cavalieri	Diego Cavalieri
Bernd Leno	Bernd Leno
Urby Emanuelson	Urby Emanuelson
Pika ta' Nubra	Ochotona nubrica
Pika ta' Gaoligong	Ochotona gaoligongensis
Liebru tad-deżert	Lepus tibetanus
Cryptonanus	Cryptonanus
Pika ħamra taċ-Ċina	Ochotona erythrotis
Pika ta' Thomas	Ochotona thomasi
Gomphos	Gomphos
Pika sewda	Ochotona nigritia
Gracilinanus	Gracilinanus
Micromurexia	Micromurexia habbema
Pika ta' Tsing-ling	Ochotona huangensis
Pika tal-Ħimalaja	Ochotona himalayana
Gurban Gurbanov	Qurban Qurbanov
Paolo Borsellino	Paolo Borsellino
Żebbuġ Rangers FC	Żebbuġ Rangers
Żurrieq FC	FC Żurrieq
Martin de Porres	Martin von Porres
Jô	Jô
Grupp A tat-Tazza tad-Dinja tal-Futbol 2006	Fußball-Weltmeisterschaft 2006/Gruppe A
Adem Ljajić	Adem Ljajić
Lucien Laurent	Lucien Laurent
Sebastian Prödl	Sebastian Prödl
Julien Faubert	Julien Faubert
Danny Simpson	Danny Simpson
Ruġġieru I ta' Sqallija	Roger I. (Sizilien)
Michael Mancienne	Michael Mancienne
Dong Fangzhuo	Dong Fangzhuo
San Ġennaru	Januarius
Carlos Eugênio Simon	Carlos Simon
Frans Sammut	Frans Sammut
Pascal Zuberbühler	Pascal Zuberbühler
Stanislav Šesták	Stanislav Šesták
Franco Di Santo	Franco Di Santo
Luis Monti	Luis Monti
Patrick Müller	Patrick Müller
Bachir Gemayel	Bachir Gemayel
Digão	Digão
Leonardo Sciascia	Leonardo Sciascia
Edward Maya	Edward Maya
Grupp A tal-Kampjonati Ewropej tal-Futbol 2008	Fußball-Europameisterschaft 2008/Gruppe A
Federazzjoni tal-Futbol tal-Andorra	Federació Andorrana de Futbol
Gonzalo Javier Rodríguez	Gonzalo Rodríguez (Fußballspieler)
Tazza tad-Dinja VIVA	Viva World Cup
Premier League Malti	Maltese Premier League
Serebro	Serebro
Nicolas Douchez	Nicolas Douchez
Kroazja fil-Festival tal-Eurovision	Kroatien beim Eurovision Song Contest
La Liga	Primera División (Spanien)
Joel Obi	Joel Obi
Premier League Ażerbajġan	Premyer Liqası
Mike Bongiorno	Mike Bongiorno
Grupp Ġ tat-Tazza tad-Dinja tal-Futbol 2006	Fußball-Weltmeisterschaft 2006/Gruppe G
Grupp Ċ tat-Tazza tad-Dinja tal-Futbol 2006	Fußball-Weltmeisterschaft 2006/Gruppe C
Grupp E tat-Tazza tad-Dinja tal-Futbol 2006	Fußball-Weltmeisterschaft 2006/Gruppe E
Grupp F tat-Tazza tad-Dinja tal-Futbol 2006	Fußball-Weltmeisterschaft 2006/Gruppe F
Grupp D tat-Tazza tad-Dinja tal-Futbol 2006	Fußball-Weltmeisterschaft 2006/Gruppe D
George Anthony Frendo	George Anthony Frendo
Alleati tat-Tieni Gwerra Dinjija	Alliierte
Repubblika Ċeka fil-Festival tal-Eurovision	Tschechien beim Eurovision Song Contest
Valletta FC	FC Valletta
Serbja u Montenegro fil-Festival tal-Eurovision	Serbien und Montenegro beim Eurovision Song Contest
Jerzy Grotowski	Jerzy Grotowski
FC Ararat Yerevan	FC Ararat Jerewan
Gerald Strickland	Gerald Strickland, 1. Baron Strickland
Gustavo Gutiérrez	Gustavo Gutiérrez
Francesco Buhagiar	Francesco Buhagiar
Joe Sacco	Joe Sacco (Comiczeichner)
Difensur	Abwehrspieler
Liebru Abissinjan	Abyssinischer Hase
Achinoam Nini	Achinoam Nini
Ħamrun	Ħamrun
Ħamrun Spartans FC	Ħamrun Spartans
Caravaggio	Caravaggio (Begriffsklärung)
Jores Okore	Jores Okore
Gary Neville	Gary Neville
Balzan FC	Balzan Youths
Roland Linz	Roland Linz
Johnny Leoni	Johnny Leoni
San Staniżlaw Martri	Stanislaus von Krakau
Emiliano Insúa	Emiliano Insúa
Tim Matthys	Tim Matthys
Ritratt ta' Adele Bloch-Bauer I	Adele Bloch-Bauer I
Anthony Mamo	Anthony Mamo
Paul Van Himst	Paul Van Himst
György Garics	György Garics
Cercle Brugge KSV	Cercle Brügge
Adolfo Zumelzú	Adolfo Zumelzú
Assedju ta' Malta	Belagerung von Malta
Opossum ta' erba' għajnejn kannella	Nacktschwanzbeutelratte
Lista ta' klabbs tal-futbol f'Malta	Liste der maltesischen Fußballvereine
KV Oostende	KV Ostende
Memorial Day	Memorial Day
Mixja Neokatekumenali	Neokatechumenaler Weg
Unuri għall-klabbs tal-UEFA	UEFA Club Football Awards
Bloggosfera	Blogosphäre
Life of Pi	Schiffbruch mit Tiger
Lingwa tas-Sinjali Taljana	Italienische Gebärdensprache
SV Zulte Waregem	SV Zulte Waregem
Semih Şentürk	Semih Şentürk
Helder Camara	Hélder Câmara
Tupaja tat-Tramuntana	Nördliches Spitzhörnchen
Dasyurus	Beutelmarder
Mattia De Sciglio	Mattia De Sciglio
San Gejtanu	Kajetan von Thiene
Kurt Calleja	Kurt Calleja
Krassimir Avramov	Krassimir Awramow
Deividas Šemberas	Deividas Šemberas
Pawlu Miki	Paul Miki
UEFA Europa League 2012–13	UEFA Europa League 2012/13
Ivan Leko	Ivan Leko
Premier League Malti 1925–26	First Division (Malta) 1925/26
Ameridelphia	Ameridelphia
Marsaxlokk FC	FC Marsaxlokk
Servizz Awstrijak barra l-pajjiż	Auslandsdienst Österreichs
Pangolin Ġgant	Riesenschuppentier
Jamāhīriyya	Dschamahirija
Lamantin Afrikan	Afrikanischer Manati
Mario Corso	Mario Corso
Deloitte Football Money League	Deloitte Football Money League
Serbja fil-Festival tal-Eurovision	Serbien beim Eurovision Song Contest
Assoċjazzjoni tal-Futbol Albaniż	Federata Shqiptare e Futbollit
Mosta FC	FC Mosta
Inga u Anush Arshakyans	Inga & Anusch
Lista ta' vulkani fl-Italja	Liste von Vulkanen in Italien
Gżira United FC	Gżira United
Lija Athletic FC	Lija Athletics
Dingli Swallows FC	Dingli Swallows
Fenek ta' denbu qotni tal-Ingilterra l-Ġdida	Neuengland-Baumwollschwanzkaninchen
OFC	OFC
Leporidu	Hazen
Andrea Petagna	Andrea Petagna
Innu tal-Emirati Għarab Magħquda	ʿĪschī bilādī
Università ta' Malta	Universität Malta
Ħal Għaxaq	Għaxaq
Premier League Malti 1957–58	First Division (Malta) 1957/58
Liebru xkupa	Castroviejo-Hase
Ungerija fil-Festival tal-Eurovision	Ungarn beim Eurovision Song Contest
Pika tal-fidda	Ochotona argentata
Facundo Roncaglia	Facundo Roncaglia
Fredrik Stenman	Fredrik Stenman
Hilma af Klint	Hilma af Klint
Owen Hargreaves	Owen Hargreaves
Alternattiva Demokratika	Alternattiva Demokratika
Elvedin Džinić	Elvedin Džinič
Mario De Marco	Mario de Marco
Roderick Briffa	Roderick Briffa
Papa Franġisku	Franziskus (Papst)
Roman Kienast	Roman Kienast
Lamantin Amazoniku	Amazonas-Manati
Preguinho	Preguinho
SV Ried	SV Ried
Petr Elfimov	Pjotr Jalfimau
Fabio Coltorti	Fabio Coltorti
Frederick Russell Burnham	Frederick Russell Burnham
Guillermo Subiabre	Guillermo Subiabre
Il-Ktieb ta' Mormon	Buch Mormon
Santa Madalena Sofia Barat	Sophie Barat
Youddiph	Youddiph
Eddie Gustafsson	Eddie Gustafsson
Eva Gonzalès	Eva Gonzalès
Slovakkja fil-Festival tal-Eurovision	Slowakei beim Eurovision Song Contest
Lucia Anguissola	Lucia Anguissola
Carlos Peucelle	Carlos Peucelle
Fud Leclerc	Fud Leclerc
Yulia Savicheva	Julija Stanislawowna Sawitschewa
Mattia Preti	Mattia Preti
Prospero Grech	Prosper Grech
Víctor Fernández	Víctor Fernández
It-Twerżiqa	Der Schrei
Fabrizio Faniello	Fabrizio Faniello
Euarchontoglires	Euarchontoglires
Paramore	Paramore
Ħal Luqa	Luqa
Unguligrad	Spitzengänger
Klabb tal-futbol	Fußballverein
Grupp B tal-Kampjonati Ewropej tal-Futbol 2008	Fußball-Europameisterschaft 2008/Gruppe B
Pangolin ta' Temminck	Steppenschuppentier
Festival tal-Eurovision taż-Żgħar 2008	Junior Eurovision Song Contest 2008
Coritiba Foot Ball Club	Coritiba FC
Ajruport Internazzjonali ta' Tan Son Nhat	Flughafen Tan-Son-Nhat
L-Uffiċċju tal-Pubblikazzjonijiet tal-Unjoni Ewropea	Amt für Veröffentlichungen der Europäischen Union
Nani	Nani
Edwin van der Sar	Edwin van der Sar
Paolo Maldini	Paolo Maldini
Loreen	Loreen
Gonzalo Higuaín	Gonzalo Higuaín
Tim nazzjonali tal-futbol tat-Turkija	Türkische Fußballnationalmannschaft
Tim nazzjonali tal-futbol tar-Repubblika Ċeka	Tschechische Fußballnationalmannschaft
Tomasz Kuszczak	Tomasz Kuszczak
Anderson Luís de Abreu Oliveira	Anderson Luís de Abreu Oliveira
St. Andrews FC	FC St. Andrews
UEFA Champions League 2011–12	UEFA Champions League 2011/12
Charles Manson	Charles Manson
UEFA Champions League 2012–13	UEFA Champions League 2012/13
Arda Turan	Arda Turan
Patt tas-Sindki	Konvent der Bürgermeister
Oġġett (filosofija)	Objekt (Philosophie)
RAEC Mons	RAEC Mons
Renault Samsung Motors	Renault Samsung Motors
Linosa	Linosa
Tazza tad-Dinja tal-Futbol tal-Klabbs 2005	FIFA-Klub-Weltmeisterschaft 2005
Tazza tad-Dinja tal-Futbol tal-Klabbs 2000	FIFA-Klub-Weltmeisterschaft 2000
Andrew Cohen	Andrew Cohen (Fußballspieler)
Andrew Hogg	Andrew Hogg
Moldova fil-Festival tal-Eurovision	Moldawien beim Eurovision Song Contest
Latvja fil-Festival tal-Eurovision	Lettland beim Eurovision Song Contest
Nichi Vendola	Nichi Vendola
Waasland-Beveren	Waasland-Beveren
Liebru ta' Yarkand	Yarkand-Hase
KS Bylis Ballsh	KS Bylis Ballsh
Prolagus	Prolagus
Liebru ta' Granada	Iberischer Hase
Eurobandið	Eurobandið
Matías Suárez	Matías Suárez
Mircea Rednic	Mircea Rednic
Radja Nainggolan	Radja Nainggolan
Qormi FC	FC Qormi
Felipe Santana	Felipe Santana
Xgħajra	Xgħajra
André Maschinot	André Maschinot
André Schembri	André Schembri
Stade Charles Tondreau	Stade Charles Tondreau
Tibdil fil-Lingwa	Sprachwandel
Awstrija v Żvizzera (1954)	Hitzeschlacht von Lausanne
Ronaldo	Ronaldo
Patrick Ouchène	Patrick Ouchène
Kaká	Kaká
FC Shakhtyor Salihorsk	FK Schachzjor Salihorsk
Kalkara	Kalkara
Wied il-Għajn (Marsaskala)	Marsaskala
Pika ta' Ladak	Ladakh-Pfeifhase
Cofie Bekoe	Cofie Bekoe
Joseph Calleja	Joseph Calleja
Liebru l-ġebel aħmar ta' Smith	Rotkaninchen (Art)
Sant’Anġlu ta’ Sqallija	Angelus der Karmelit
Planigale	Flachkopf-Beutelmäuse
Liebru l-ġebel aħmar ta' Jameson	Rand-Wollschwanzhase
Rivalità bejn Liverpool FC u Manchester United FC	Rivalität zwischen Manchester United und Liverpool FC
Marietta Robusti	Marietta Robusti
FK Leotar	FK Leotar Trebinje
FC Neman Grodno	FK Njoman Hrodna
Rumanija fil-Festival tal-Eurovision	Rumänien beim Eurovision Song Contest
Mario Evaristo	Marino Evaristo
Trofew Bravo	Trofeo Bravo
Jelle Vossen	Jelle Vossen
Manuel Rosas	Manuel Rosas
Pawlu Cremona	Paul Cremona
Marcel Langiller	Marcel Langiller
Alfred Sant	Alfred Sant
Giuseppe Merisi	Giuseppe Merisi
Claudio Baglioni	Claudio Baglioni
Luka Peruzović	Luka Peruzović
Fenek tal-istrixxi ta' Annam	Annamitisches Streifenkaninchen
Annetto Depasquale	Annetto Depasquale
Finali tal-UEFA Champions League 2013	UEFA-Champions-League-Finale 2013
Ipertensjoni	Hypertonie
Dun Karm Psaila	Dun Karm Psaila
Liebru antilop	Antilopenhase
Liebru sufi	Tibetanischer Wollhase
Tupaja tal-Filippini	Philippinen-Spitzhörnchen
Senġi tal-buxxveld	Trockenland-Elefantenspitzmaus
Tupaja ta' Madras	Indisches Spitzhörnchen
Tupaja komuni	Gewöhnliches Spitzhörnchen
Fenek tal-art mistgħadra	Sumpfkaninchen
FC Mika	MIKA Aschtarak
Santa Venera	Santa Venera
Antoine Zahra	Antoine Zahra (Fußballspieler, 1977)
Pika tal-isteppa	Steppenpfeifhase
Munxar	Munxar
Partit Nazzjonalista (Malta)	Partit Nazzjonalista
FC Minsk	FK Minsk
Galea	Galea
Francesco Azzopardi	Francesco Azopardi
Premier League Malti 1953–54	First Division (Malta) 1953/54
Ħal Kirkop	Kirkop
Coccinella	Coccinella (Gattung)
Sannat	Sannat
Urugan Felix (2007)	Hurrikan Felix
Logħob tal-Pajjiżi ż-Żgħar tal-Ewropa 2009	Spiele der kleinen Staaten von Europa 2009
Xagħra	Xagħra
Dun Ġorġ Preca	George Preca
Fenek ta' denbu qotni tad-deżert	Audubon-Baumwollschwanzkaninchen
FC Encamp	FC Encamp
Kon-Katidral ta' San Ġwann	St. John’s Co-Cathedral
FIFA Puskás Award	FIFA Puskás-Preis
KV Kortrijk	KV Kortrijk
Nunzjatura Appostolika	Apostolische Nuntiatur
Wikipedija:Abbrevjazzjoni	Wikipedia:Shortcuts
Croagh Patrick	Croagh Patrick
Australidelphia	Australidelphia
Gżira (lokalità)	Gżira
Victoria Lines	Victoria Lines
UE Sant Julià	UE Sant Julià
The Kite Runner	Drachenläufer
Luzzu	Luzzu
Fenek ta' Bunyoro	Buschkaninchen
TM-XML	TM-XML
Liebru ta' denbu iswed	Eselhase
Leġjun ta' Marija	Legio Mariae
Battalja ta' Champaubert	Schlacht bei Champaubert
Madonna ta' Coromoto	Unsere Liebe Frau von Coromoto
Qerda tal-innoċenti	Kindermord in Betlehem
Senġi ta' Kap	Kap-Elefantenspitzmaus
Beerschot AC	Beerschot AC
UE Santa Coloma	UE Santa Coloma
Malta fil-Festival tal-Eurovision	Malta beim Eurovision Song Contest
Argosstadion Achter de Kazerne	Argosstadion Achter De Kazerne
Gianpaolo Bellini	Gianpaolo Bellini
Antechinus	Breitfuß-Beutelmäuse
Sminthopsis	Schmalfuß-Beutelmäuse
Mario Been	Mario Been
Alof de Wignacourt	Alof de Wignacourt
Ħal Safi	Safi (Malta)
Pika ħamra tat-Turkestan	Ochotona rutila
Mario Carević	Mario Carević
Japok	Schwimmbeutler
Glires	Glires
Cinco de Mayo	Cinco de Mayo
Premier League Malti 1959–60	First Division (Malta) 1959/60
Litwanja fil-Festival tal-Eurovision	Litauen beim Eurovision Song Contest
Liebru ta' Tehuantepec	Tehuantepec-Hase
Shirak FC	FC Schirak Gjumri
Fenek tal-vulkan	Vulkankaninchen
San Ġiljan (lokalità)	San Ġiljan
Xlendi	Xlendi
Arjan Swinkels	Arjan Swinkels
Ouija Board	Ouija
Kerċem	Kerċem
Iqbal Masih	Iqbal Masih
San Franġisk t'Assisi	Franz von Assisi
Tim nazzjonali tal-futbol tal-Italja	Italienische Fußballnationalmannschaft
Daknamstadion	Daknamstadion
European Border Breakers Awards	European Border Breakers Award
Pietà Hotspurs FC	Pietà Hotspurs
Justin Haber	Justin Haber
Premier League Malti 1950–51	First Division (Malta) 1950/51
Partit Laburista (Malta)	Partit Laburista
Pronolagus	Rotkaninchen
Trzebinia	Trzebinia
Fenek ta' Amami	Ryukyu-Kaninchen
Lovebugs	Lovebugs
Mġarr	Mġarr
Kolokolo	Chiloé-Beutelratte
Opossum tal-Patagonja	Patagonische Beutelratte
Wolfsberger AC	Wolfsberger AC
FK Khazar Lankaran	FK Xəzər Lənkəran
SV Grödig	SV Grödig
FC Admira Wacker Mödling	FC Admira Wacker Mödling
Bolla fiskali	Stempelmarke
Erich Hof	Erich Hof
SP Tre Penne	SP Tre Penne
FC Lusitanos	FC Lusitanos
Logan Bailly	Logan Bailly
Cartoon Network	Cartoon Network
De facto	De jure/de facto
Klad	Klade
David Carabott	David Carabott
Joe Brincat	Joe Brincat
AS (gazzetta)	As (Tageszeitung)
Grupp Ċ tal-Kampjonati Ewropej tal-Futbol 2008	Fußball-Europameisterschaft 2008/Gruppe C
Vadis Odjidja-Ofoe	Vadis Odjidja-Ofoe
Inter Baku PFC	FK İnter Baku
FK Qarabağ	FK Qarabağ Ağdam
Albert Hyzler	Albert Hyzler
Lierse SK	Lierse SK
Tim nazzjonali tal-futbol tar-Russja	Russische Fußballnationalmannschaft
FC Gomel	FK Homel
Floriana FC	FC Floriana
Euarchonta	Euarchonta
Assoċjazzjoni tal-Futbol ta' Malta	Malta Football Association
Inter Club d'Escaldes	Inter Club d’Escaldes
Ester	Königin Ester
Lorenzo Staelens	Lorenzo Staelens
Cobh	Cobh
John van den Brom	John van den Brom
Alex Thépot	Alex Thépot
Margaritu ta' Brindisi	Margaritos von Brindisi
Luke Dimech	Luke Dimech
Gintaras Staučė	Gintaras Staučė
Pawlu Boffa	Paul Boffa
Nicolò Isouard	Nicolas Isouard
Ġużeppi Moscati	Giuseppe Moscati
Rhynchocyon	Rüsselhündchen
Dendrohyrax	Gemeiner Baumschliefer
Filfla	Filfla
Ħal Tarxien	Tarxien
Gilbert Agius	Gilbert Agius
Ġużeppi Mercieca	Joseph Mercieca
Tupaja ta' denbu pinna	Federschwanz-Spitzhörnchen
Liebru ta' Kap	Kaphase
Fenek ta' denbu qotni	Baumwollschwanzkaninchen
Rabat Ajax FC	Rabat Ajax FC
Turan Tovuz PFC	PFK Turan Tovuz
JK Nõmme Kalju	FC Nõmme Kalju
Fond Soċjali Ewropew	Europäischer Sozialfonds
Birgu	Vittoriosa
Rabat (Għawdex)	Victoria (Malta)
Pangolin tas-siġar	Weißbauchschuppentier
Pangolin Indjan	Vorderindisches Schuppentier
Axxendent	Aszendent (Astrologie)
L-Ewwel Diviżjoni tal-Football League	Football League First Division
Mellieħa	Mellieħa
Gżejjer ta' San Pawl	Saint Paul’s Islands
FC Belshina Bobruisk	Belschyna Babrujsk
FC Torpedo-BelAZ Zhodino	Torpedo Schodsina
Bormla	Cospicua
FC Banants	FC Bananz Jerewan
Għajnsielem	Għajnsielem
Foeke Booy	Foeke Booy
Varjetà (botanika)	Varietät (Biologie)
Edward Herrera	Edward Herrera
It-Tieni Diviżjoni tal-Football League	Football League Second Division
FK Olimpic	FK Olimpic Sarajevo
Don Pino Puglisi	Giuseppe Puglisi
FC Brest	FK Dinamo Brest
Fenek ta' denbu qotni tal-Lvant	Florida-Waldkaninchen
Tim nazzjonali tal-futbol ta' Malta ta' taħt il-21 sena	Maltesische Fußballnationalmannschaft (U-21-Männer)
Marsaxlokk	Marsaxlokk
Ħal Lija	Lija
Tlacuatzin	Graue Zwergbeutelratte
John Buttigieg	John Buttigieg
Olivier Deschacht	Olivier Deschacht
Ħal Balzan	Balzan (Malta)
Festa della Repubblica	Festa della Repubblica
Birkirkara FC	FC Birkirkara
Trattat ta' Adeżjoni 2003	Beitrittsvertrag 2003
Dendrogale	Bergtupajas
Familja Bernoulli	Bernoulli
Lista ta' timijiet nazzjonali tal-futbol tal-irġiel	Liste der Fußballnationalmannschaften (Männer)
Furjana	Floriana
FC Dnepr Mogilev	Dnjapro Mahiljou
Grupp B tat-Tazza tad-Dinja tal-Futbol 2006	Fußball-Weltmeisterschaft 2006/Gruppe B
Dugongidae	Gabelschwanzseekühe
FC Naftan Novopolotsk	Naftan Nawapolazk
Ulisses FC	FC Ulisses Jerewan
Lista ta' lingwi uffiċjali	Liste der Amtssprachen
Regina (grupp)	Regina (Band)
It-Tripletta	Triple (Sport)
Partizani Tirana	FK Partizani Tirana
Kapaz PFC	PFK Kəpəz
Raħal Ġdid	Paola (Malta)
L-Isla	Senglea
East Asian Football Federation	East Asian Football Federation
Libanu fil-Festival tal-Eurovision	Libanon beim Eurovision Song Contest
L-Ewwel Diviżjoni Għawdxija	ONVOL First Division
Gandzasar FC	Gandsassar Kapan
Demografija ta' Malta	Bevölkerung Maltas
Liebru ta' Burma	Burmesischer Hase
Fenek ta' denbu qotni tal-foresta	Tapeti
Liebru tal-Alaska	Alaskahase
Borussia Dortmund II	Borussia Dortmund II
Analisi armonika	Harmonische Analyse
UEFA Jubilee Awards	UEFA Jubilee 52 Golden Players
Cleavon Frendo	Cleavon Frendo
Lemma ta’ Borel-Cantelli	Borel-Cantelli-Lemma
Ħad-Dingli	Dingli
Transnistrija	Transnistrien
Gabala FC	FK Qəbələ
Temi Zammit	Themistocles Żammit
Brian Said	Brian Said
Nesolagus	Streifenkaninchen
Għajnuna:Kontenut	Hilfe:Übersicht
Għajnuna:Gwida essenzjali	Wikipedia:Tutorial
Oud-Heverlee Leuven	Oud-Heverlee Löwen
Mellieħa SC	SC Mellieħa
Logħob tal-Pajjiżi ż-Żgħar tal-Ewropa	Spiele der kleinen Staaten von Europa
Marca (gazzetta)	Marca
UE Engordany	UE Engordany
Siġġiewi	Siġġiewi
Xewkija	Xewkija
Pika ta' Turuchan	Ochotona turuchanensis
Caruana	Caruana
Roberto Gayón	Roberto Gayón
Cristal Arena	Cristal Arena
Francis Dickoh	Francis Dickoh
Senġi ta' erbat iswaba	Rüsselratte
Tarxien Rainbows FC	Tarxien Rainbows
Liebru Taljan	Korsika-Hase
Liebru ta' denbu abjad	Präriehase
Pika ta' Moupin	Moupin-Pfeifhase
Hibernians FC	Hibernians Football Club
Joseph Muscat	Joseph Muscat
Malta fil-Festival tal-Eurovision taż-Żgħar	Malta beim Junior Eurovision Song Contest
Kamil Mikulčík	Kamil Mikulčík
Glen De Boeck	Glen De Boeck
Premier League Malti 1923–24	First Division (Malta) 1923/24
Gipsy.cz	Gipsy.cz
Jurgen Cavens	Jurgen Cavens
Premier League Malti 1935–36	First Division (Malta) 1935/36
Oliver Friggieri	Oliver Friggieri
Jonathan Caruana	Jonathan Caruana
Hany Ramzy	Hany Ramzy
Carmel Busuttil	Carmel Busuttil
Mario Muscat	Mario Muscat
Stade Maurice Dufrasne	Maurice-Dufrasne-Stadion
Vito Plut	Vito Plut
Soft law	Soft Law
William Camenzuli	William Camenzuli
Michael Essien	Michael Essien
Senġi ċċangjat	Geflecktes Rüsselhündchen
Bruno Pesaola	Bruno Pesaola
Ġorġ Borg Olivier	George Borġ Olivier
Ġiljan l-Ospitalier	Julianus Hospitator
Stephen Wellman	Stephen Wellman
Terence Scerri	Terence Scerri
Francesco Laparelli	Francesco Laparelli
Melchiorre Gafà	Melchiorre Cafà
Enrico Mizzi	Enrico Mizzi
FC Red Bull Salzburg	FC Red Bull Salzburg
Fontana (Għawdex)	Fontana (Malta)
Westport (Irlanda)	Westport (Irland)
Għasri	Għasri
Ta' Xbiex	Ta’ Xbiex
Liebru tax-xgħari	Buschhase
Opossum ta' denbu sufi	Buschschwanz-Beutelratte
Mqabba	Mqabba
Ħal Għargħur	Għargħur
Gudja	Gudja
Premier League Malti 1922–23	First Division (Malta) 1922/23
Premier League Malti 2010–11	Maltese Premier League 2010/11
Carlo Mamo	Carlo Mamo
Karmenu Mifsud Bonnici	Carmelo Mifsud Bonniċi (Malta Labour Party)
Pika ta' Sardinja	Sardischer Pfeifhase
Liebru l-ġebel aħmar ta' Natal	Natal-Wollschwanzhase
Simurq PFC	PFK Simurq Zaqatala
Chacodelphys	Chaco-Beutelratte
Markapaġna	Lesezeichen (Buch)
Madonna tal-Karmnu	Unsere Liebe Frau auf dem Berge Karmel
Statistika tat-Tazza tad-Dinja tal-Futbol 2010	Fußball-Weltmeisterschaft 2010/Statistik
Stejdjum Jan Breydel	Jan-Breydel-Stadion
Opossum bugeddum ta' mnieħru twil	Chilenische Opossummaus
Liebru Ċiniż	Chinesischer Hase
Santa Luċija, Malta	Santa Luċija
Manuel Pinto da Fonseca	Manuel Pinto de Fonseca
Mottu Olimpiku	Citius, altius, fortius
Premier League Malti 1909–10	First Division (Malta) 1909/10
Claude Mattocks	Claude Mattocks
Cynocephalus volans	Philippinen-Gleitflieger
Premier League Malti 1918–19	First Division (Malta) 1918/19
Premier League Malti 1916–17	First Division (Malta) 1916/17
Premier League Malti 1913–14	First Division (Malta) 1913/14
Premier League Malti 1914–15	First Division (Malta) 1914/15
Premier League Malti 1911–12	First Division (Malta) 1911/12
Premier League Malti 1917–18	First Division (Malta) 1917/18
Premier League Malti 1912–13	First Division (Malta) 1912/13
Laurent Ciman	Laurent Ciman
Premier League Malti 2000–01	Maltese Premier League 2000/01
Senġi ta' wiċċu griż	Graugesichtiges Rüsselhündchen
Luttu nazzjonali	Staatstrauer
Apolonia Fier	KF Apolonia Fier
Senġi ta' widnejh tondi tal-Karù	Kurzohrrüsselspringer
Liverpool FC	FC Liverpool
Premier League Malti 1921–22	First Division (Malta) 1921/22
Premier League Malti 1919–20	First Division (Malta) 1919/20
Premier League Malti 1924–25	First Division (Malta) 1924/25
Premier League Malti 1920–21	First Division (Malta) 1920/21
Flor-de-Lis	Flor-de-Lis
FIFPro	Fédération Internationale des Associations de Footballeurs Professionnels
Pika tat-Tramuntana	Nördlicher Pfeifhase
Antechinomys	Springbeutelmaus
Malcolm Macdonald	Malcolm Macdonald
Waldo's People	Waldo’s People
Plantigrad	Sohlengänger
Djalett Grieg-Kalabriż	Griechisch-kalabrischer Dialekt
Stade du Pays de Charleroi	Stade du Pays de Charleroi
Liebru Korean	Korea-Hase
West Asian Football Federation	West Asian Football Federation
Fortifikazzjonijiet ta' Żmien il-Kavallieri f'Malta	Festungen und militärische Anlagen Maltas
Bolla telegrafika	Telegrafenmarke
FC Slavia-Mozyr	FK Slawija-Masyr
Pika ta' Daurian	Daurischer Pfeifhase
Merlin (serje televiżiva)	Merlin – Die neuen Abenteuer
Mqabba FC	FC Mqabba
Torrijiet ta' de Redin	De Redin Towers
Demba Touré	Demba Touré
Tim nazzjonali tal-futbol ta' Malta (nisa)	Maltesische Fußballnationalmannschaft der Frauen
Premier League Malti 1928–29	First Division (Malta) 1928/29
Premier League Malti 1927–28	First Division (Malta) 1927/28
Premier League Malti 1926–27	First Division (Malta) 1926/27
Wikipedija:Ambaxxata	Wikipedia:Botschaft
Fenek ta' denbu qotni ta' Dice	Dice-Baumwollschwanzkaninchen
Lutreolina	Dickschwanzbeutelratte
Raimondo Vianello	Raimondo Vianello
Kampjonat tal-futbol Ingliż 1888-89	Football League 1888/89
Premier League Malti 1930–31	First Division (Malta) 1930/31
Premier League Malti 1929–30	First Division (Malta) 1929/30
Premier League Malti 1931–32	First Division (Malta) 1931/32
Premier League Malti 1932–33	First Division (Malta) 1932/33
Karmenu Vella	Karmenu Vella
Din l-Art Ħelwa	Dín l-Art Ħelwa
KS Lushnja	KS Lushnja
Philander	Vieraugenbeutelratten
Sliema Wanderers FC	Sliema Wanderers
Liebru ta' Yunnan	Yunnan-Hase
Caenolestes	Eigentliche Opossummäuse
Jamie Pace	Jamie Pace
Pika tal-Afganistan	Rötlicher Pfeifhase
Elephantulus	Elefantenspitzmäuse
Torri tal-Ħamrija	Hamrija Tower
Torri ta' Għajn Ħadid	Ghajn Hadid Tower
Torri tal-Madliena	Madliena Tower
Torri tal-Wardija	Wardija Tower
Scooch	Scooch
Senġi ta' taħt dahru dehebi	Goldenes Rüsselhündchen
KS Kastrioti	KS Kastrioti Kruja
Tupaja ta' Nikobar	Nikobaren-Spitzhörnchen
Pangolin ta' Palaw	Palawan-Schuppentier
Tazza Maltija	Maltesischer Fußballpokal
Opossum bugeddum Peruvjan	Peruanische Opossummaus
FK Tomori Berat	FK Tomori Berat
Kim Ojo	Kim Ojo
L-Ewwel Diviżjoni Maltija (nisa)	Maltesische Fußballmeisterschaft der Frauen
Shkumbini Peqin	KS Shkumbini Peqin
Cohesion	Kohäsion (Informatik)
Grawnd Nazzjonali Ta' Qali	Ta’ Qali-Stadion
Ekonomija ta' Malta	Wirtschaft Maltas
Liebru ta' Hainan	Hainan-Hase
Liebru ta' Tolai	Tolai-Hase
Liebru Ġappuniż	Japanischer Hase
Simon Busuttil	Simon Busuttil
Trofew Zarra	Trofeo Zarra
Candies (grupp)	Candies
Pika tax-xofftejn suwed	Schwarzlippiger Pfeifhase
Akrolett	Akrolekt
Palazz tal-Gran Mastru	Großmeisterpalast (Valletta)
Etienne Barbara	Etienne Barbara
ECHO (Kummissjoni Ewropea)	Europäisches Amt für humanitäre Hilfe
Ravan Baku FC	Rəvan Baku FK
FK Rudar Prijedor	FK Rudar Prijedor
Wikipedija:Glossarju	Hilfe:Glossar
Ugo Pasquale Mifsud	Ugo Pasquale Mifsud
Francis Ebejer	Francis Ebejer
Girolamo Abos	Girolamo Abos
Joseph Howard	Joseph Howard
Vulkan (diżambigwazzjoni)	Vulkan (Begriffsklärung)
Pseudantechinus	Fettschwanz-Beutelmäuse
Opossum ġurdien ta' denbu oħxon	Fettschwanzbeutelratten
Kategorija:Ġermanja	Kategorie:Deutschland
Kategorija:Italja	Kategorie:Italien
Kategorija:Stati Uniti	Kategorie:Vereinigte Staaten
Kategorija:Russja	Kategorie:Russland
Kategorija:Renju Unit	Kategorie:Vereinigtes Königreich
Kategorija:Spanja	Kategorie:Spanien
Kategorija:Indja	Kategorie:Indien
Kategorija:Turkija	Kategorie:Türkei
Kategorija:New Zealand	Kategorie:Neuseeland
Premier League Malti 1933–34	First Division (Malta) 1933/34
Premier League Malti 1934–35	First Division (Malta) 1934/35
Premier League Malti 1936–37	First Division (Malta) 1936/37
Premier League Malti 1937–38	First Division (Malta) 1937/38
Premier League Malti 1938–39	First Division (Malta) 1938/39
Pixxivoru	Fischfresser
Senġi iswed u aħmar	Rotschulter-Rüsselhündchen
Opossum ta' denbu qasir	Spitzmausbeutelratten
Flora ta' Malta	Flora und Vegetation der maltesischen Inseln
Phascolosorex	Streifenbeutelmäuse
It-Tielet Diviżjoni tal-Football League	Football League Third Division
Ian Azzopardi	Ian Azzopardi
Kategorija:Afganistan	Kategorie:Afghanistan
Kategorija:Alġerija	Kategorie:Algerien
Kategorija:Awstrija	Kategorie:Österreich
Kategorija:Pajjiżi l-Baxxi	Kategorie:Niederlande
Kategorija:Niġerja	Kategorie:Nigeria
Kategorija:Polonja	Kategorie:Polen
Kategorija:Portugall	Kategorie:Portugal
Kategorija:Żvizzera	Kategorie:Schweiz
Kategorija:Ukraina	Kategorie:Ukraine
Kategorija:Vjetnam	Kategorie:Vietnam
Kategorija:Fiżika	Kategorie:Physik
Kategorija:Bijoloġija	Kategorie:Biologie
Kategorija:Kimika	Kategorie:Chemie
Kategorija:Storja	Kategorie:Geschichte
Kategorija:Ġeografija	Kategorie:Geographie
Kategorija:Arti viżiva	Kategorie:Bildende Kunst
Kategorija:Reliġjon	Kategorie:Religion
Kategorija:Sport	Kategorie:Sport
Kategorija:Xjenza	Kategorie:Wissenschaft
Kategorija:Unjoni Ewropea	Kategorie:Europäische Union
Kategorija:Ċinema	Kategorie:Film
Kategorija:Komunikazzjoni	Kategorie:Kommunikation
Liebru Indjan	Schwarznackenhase
Liebru tal-ġnub bojod	Weißflankenhase
Liebru Manċurjan	Mandschurischer Hase
Opossum sufi	Wollbeutelratten
Plejer tas-Sena tal-MFA	Fußballer des Jahres (Malta)
MICHAEL	MICHAEL (Portal)
Myoictis	Streifenbeutelmarder
Premier League 2011–12	Premier League 2011/12
George Mallia	George Mallia
George Vella	George Vella
Fenek xkupilja	Strauchkaninchen
Lista ta' ħwawar u ħxejjex aromatiċi	Liste der Küchenkräuter und Gewürzpflanzen
Marco Ureña	Marco Ureña
Paramurexia	Rothschild-Neuguineabeutelmaus
Gohi Bi Zoro Cyriac	Gohi Bi Cyriac
Għawdex (stat indipendenti)	Gozo (Staat)
Assoċjazzjoni tal-futbol t'Għawdex	Gozo Football Association
Palazz ta' Sant'Anton	San Anton Palace
Grupp	Grupp
Torri tal-Għallis	Għallis Tower
Mikiel Gonzi	Michael Gonzi
Fenek ta' denbu qotni tal-Messiku	Mexikanisches Baumwollschwanzkaninchen
Liebru tas-savana Afrikana	Mosambik-Hase
Joseph Calleia	Joseph Calleia
Herman Vanderpoortenstadion	Herman Vanderpoortenstadion
Fenek ta' denbu qotni ta' Omiltemi	Omilteme-Baumwollschwanzkaninchen
Stat kostrutt	Status constructus
Miriam Spiteri Debono	Myriam Spiteri Debono
Jají	Jají
Jean Pierre Mifsud Triganza	Jean Pierre Mifsud Triganza
Jeffrey Chetcuti	Jeffrey Chetcuti
Kategorija:Mietu fl-2012	Kategorie:Gestorben 2012
Partit Nazzjonalista	Liste nationaler Parteien
Jules Ottenstadion	Jules Ottenstadion
Julio Alcorsé	Julio Alcorsé
Juvenes Translatores	Juvenes Translatores
Knisja Katidrali ta' Għawdex	Kathedrale Maria Himmelfahrt (Victoria)
Kevin Sammut	Kevin Sammut
Phascogale	Pinselschwanzbeutler
Ningaui	Ningauis
Marmosops	Schlankbeutelratten
Pika ta' Glover	Ochotona gloveri
Fenek tat-Tres Marias	Tres-Marias-Baumwollschwanzkaninchen
Pika ta' Royle	Ochotona roylei
Christian Brüls	Christian Brüls
Pika ta' Pallas	Mongolischer Pfeifhase
Senġi tal-blat tal-Lvant	Östliche Klippen-Elefantenspitzmaus
Pika ta' Hoffmann	Ochotona hoffmanni
Pika ta' Gansu	Gansu-Pfeifhase
Fenek xkupilja ta' San Jose	San-José-Strauchkaninchen
Pika tal-widnejn kbar	Ochotona macrotis
No. 5, 1948	No. 5, 1948
Superspeċi	Superspezies
Peter Pullicino	Peter Pulliciano
Kamra tad-Deputati ta' Malta	Repräsentantenhaus (Malta)
Quartissimo	Quartissimo
Liora	Liora
Nicklas Helenius	Nicklas Helenius
Regenboogstadion	Regenboogstadion
Aleksandar Tonev	Aleksandar Tonew
Louis Galea	Louis Galea
Louis Grech	Louis Grech
Premier League Malti 2012–13	Maltese Premier League 2012/13
Premier League Malti 2011–12	Maltese Premier League 2011/12
Massimo Grima	Massimo Grima
Merkurju	Mercure (Begriffsklärung)
Logħob tal-Pajjiżi ż-Żgħar tal-Ewropa 2011	Spiele der kleinen Staaten von Europa 2011
Mustapha Jarju	Mustapha Jarju
Kategorija:Ekoloġija	Kategorie:Ökologie
Granivoru	Samenfresser
Kategorija:Diżambigwazzjoni	Kategorie:Begriffsklärung
Kategorija:Olimpjadi	Kategorie:Olympische Spiele
Kategorija:Filosofija	Kategorie:Philosophie
Kategorija:Psikoloġija	Kategorie:Psychologie
Kategorija:Buddiżmu	Kategorie:Buddhismus
Kategorija:Kristjaneżmu	Kategorie:Christentum
Kategorija:Induiżmu	Kategorie:Hinduismus
Kategorija:Iżlam	Kategorie:Islam
Kategorija:Ġudaiżmu	Kategorie:Judentum
Oġġett	Objekt
Raymond Xuereb	Raymond Xuereb
Reuben Gauci	Reuben Gauci
Ronaldo (diżambigwazzjoni)	Ronaldo (Begriffsklärung)
Ryan Camilleri	Ryan Camilleri
Ryan Fenech	Ryan Fenech
Forti Sant’Anġlu	Fort St. Angelo
Shaun Bajada	Shaun Bajada
Michy Batshuayi	Michy Batshuayi
Premier League Malti 1946–47	First Division (Malta) 1946/47
Bochotnica	Bochotnica
Fede Galizia	Fede Galizia
Stat Iżlamiku	Islamischer Staat (Organisation)
Guillermo Burdisso	Guillermo Burdisso
Benedicta Boccoli	Benedicta Boccoli
Premier League Malti 1948–49	First Division (Malta) 1948/49
Premier League Malti 1945–46	First Division (Malta) 1945/46
Premier League Malti 1939–40	First Division (Malta) 1939/40
Premier League Malti 1947–48	First Division (Malta) 1947/48
Premier League Malti 1949–50	First Division (Malta) 1949/50
Premier League Malti 1969–70	First Division (Malta) 1969/70
Premier League Malti 1965–66	First Division (Malta) 1965/66
Premier League Malti 1955–56	First Division (Malta) 1955/56
Premier League Malti 1966–67	First Division (Malta) 1966/67
Premier League Malti 1952–53	First Division (Malta) 1952/53
Premier League Malti 1944–45	First Division (Malta) 1944/45
Premier League Malti 1956–57	First Division (Malta) 1956/57
Premier League Malti 1963–64	First Division (Malta) 1963/64
Premier League Malti 1961–62	First Division (Malta) 1961/62
Premier League Malti 1964–65	First Division (Malta) 1964/65
Premier League Malti 1962–63	First Division (Malta) 1962/63
Premier League Malti 1951–52	First Division (Malta) 1951/52
Premier League Malti 1954–55	First Division (Malta) 1954/55
Premier League Malti 1970–71	First Division (Malta) 1970/71
Premier League Malti 1967–68	First Division (Malta) 1967/68
Premier League Malti 1968–69	First Division (Malta) 1968/69
Premier League Malti 1958–59	First Division (Malta) 1958/59
Senġi tal-blat tal-Karù	Elephantulus pilicaudus
Opossum ġurdien sufi	Wollige Zwergbeutelratten
Yenz Cini	Yenz Cini
Alex Muscat	Alex Muscat
Għoti tal-penalties	Elfmeterschießen
Premier League Malti 1960–61	First Division (Malta) 1960/61
Albertparkstadion	Albertparkstadion
Kategorija:Kultura	Kategorie:Kultur
Kategorija:Snin	Kategorie:Jahr
Kategorija:Xjenzi soċjali	Kategorie:Geisteswissenschaft
Kategorija:Kontinenti	Kategorie:Kontinent
12 Years a Slave	12 Years a Slave
Għajnuna:Gwida essenzjali/Editjar	Wikipedia:Tutorial/3
Mudell:SistemaSolari	Vorlage:Navigationsleiste Sonnensystem
Wikipedija:Konvenzjonijiet ta' nomenklatura	Wikipedia:Namenskonventionen
Għajnuna:Kif tirreġistra	Hilfe:Anmelden
Għajnuna:Wikiketta	Wikipedia:Wikiquette
Kategorija:Bots tal-Wikipedija	Kategorie:Benutzer:Bot
Mudell:Kwota	Vorlage:Zitat
Kategorija:Nies Taljani	Kategorie:Italiener
Kategorija:Mużiċisti Amerikani	Kategorie:US-amerikanischer Musiker
Kategorija:Futbolers Ġermaniżi	Kategorie:Fußballspieler (Deutschland)
Mudell:Kaxxa tal-utent	Vorlage:Userbox
Sergio Mattarella	Sergio Mattarella
Terence Vella	Terence Vella
Wikipedija:Amministraturi	Wikipedia:Administratoren
Kategorija:Każakistan	Kategorie:Kasachstan
Wikipedija:Amministraturi/Kandidati	Wikipedia:Kandidaturen
Wikipedija:Bot	Wikipedia:Bots
Kategorija:Kategoriji moħbija	Kategorie:Kategorie:Versteckt
Kategorija:Internet	Kategorie:Internet
Kategorija:Botanika	Kategorie:Botanik
Kategorija:Politika	Kategorie:Politik
Kategorija:Arti	Kategorie:Kunst
Eġittu	Ägypten
Paul Fenech	Paul Fenech
Kategorija:2013	Kategorie:2013
Cassar	Cassar
Bryan Cristante	Bryan Cristante
Mudell:Bot	Vorlage:Bot
Kanada	Kanada
Kategorija:Ungerija	Kategorie:Ungarn
Kategorija:Stati membri tal-Unjoni Ewropea	Kategorie:Mitgliedstaat der Europäischen Union
Kategorija:Belġju	Kategorie:Belgien
Kategorija:Ċekja	Kategorie:Tschechien
Kategorija:Danimarka	Kategorie:Dänemark
Kategorija:Estonja	Kategorie:Estland
Kategorija:Finlandja	Kategorie:Finnland
Kategorija:Latvja	Kategorie:Lettland
Kategorija:Iżlanda	Kategorie:Island
Kategorija:Litwanja	Kategorie:Litauen
Kategorija:Malta	Kategorie:Malta
Kategorija:Żvezja	Kategorie:Schweden
Kategorija:Slovakkja	Kategorie:Slowakei
Kategorija:Slovenja	Kategorie:Slowenien
Kategorija:Repubblika tal-Irlanda	Kategorie:Irland
Kategorija:Artikli fil-vetrina	Kategorie:Wikipedia:Exzellent
Wikipedija:Rispons tal-esperjenza tal-utent	Wikipedia:Usability-Initiative/Feedback
Kategorija:Logħob elettroniku	Kategorie:Computerspiele
Wikipedija:Bot/Rikjesti	Wikipedia:Bots/Anfragen
Kategorija:Pajjiżi tal-Ewropa	Kategorie:Staat in Europa
Kategorija:Ewropa	Kategorie:Europa
Kategorija:Għajnuna	Kategorie:Wikipedia:Hilfe
Mudell:Dokumentazzjoni	Vorlage:Dokumentation
Wikipedija:Bot/Rikjesti għall-approvazzjoni	Wikipedia:Bots/Anträge auf Botflag
Wikipedija:Politika dwar il-protezzjoni	Wikipedia:Geschützte Seiten
Kategorija:Wikipedjani	Kategorie:Benutzer:
Wikipedija:Kunsens	Wikipedia:Konsens
Wikipedija:L-ebda attakk personali	Wikipedia:Keine persönlichen Angriffe
Wikipedija:Kuntatt	Wikipedia:Kontakt
Kategorija:Utenti skont il-lingwa	Kategorie:Benutzer:nach Sprache
Wikipedija:Sondaġġi	Wikipedia:Meinungsbilder
Wikipedija:Firem	Hilfe:Signatur
Wikipedija:Artikli rikjesti	Wikipedia:Artikelwünsche
Mudell:Softredirect	Vorlage:Interwiki redirect
Mudell:Ħassar minnufih	Vorlage:Löschen
Kategorija:Teknoloġija	Kategorie:Technologie
Kategorija:Lingwa	Kategorie:Einzelsprache als Thema
Għajnuna:Kif tibda artiklu	Hilfe:Neuen Artikel anlegen
Kategorija:Wikipedija	Kategorie:Wikipedia
Kanċillier tal-Ġermanja	Bundeskanzler (Deutschland)
Wikipedija:Ċaħda ġenerali	Wikipedia:Impressum
Wikipedija:Mudelli kollha	Wikipedia:Textbausteine
Kategorija:Avvenimenti kurrenti	Kategorie:Wikipedia:Laufendes Ereignis
Wikipedija:Manwal tal-istil	Wikipedia:Formatierung
Mudell:Navbox	Vorlage:Erweiterte Navigationsleiste
Mudell:Abbrevjazzjoni	Vorlage:Shortcut
Kategorija:Żoni tal-ħin	Kategorie:Zeitzone
Galeopterus variegatus	Malaien-Gleitflieger
Festival tal-Eurovision 2014	Eurovision Song Contest 2014
Mudell:!-	Vorlage:!-
Mudell:!!	Vorlage:!!
Mudell:Ċiklu	Vorlage:Grafische Zeitleiste/Loop
Mudell:0	Vorlage:0
Kategorija:Mudelli ta' formattjar	Kategorie:Vorlage:Formatierungshilfe
Mudell:Clear	Vorlage:Absatz
Il-Portal tad-Dejta Miftuħa tal-UE	Offenes Datenportal der EU
Mudell:Kulur	Vorlage:Blau
FK Mladost Velika Obarska	FK Mladost Velika Obarska
Wikipedija:Lista ta' artikli li kull Wikipedija għandu jkollha	Wikipedia:Artikel, die es in allen Wikipedias geben sollte
Kategorija:Afrika	Kategorie:Afrika
Kategorija:Elettronika	Kategorie:Elektronik
Kategorija:Xhur tas-sena	Kategorie:Monat
Mudell:Wikisors	Vorlage:Wikisource
Mudell:Babel	Vorlage:Babel
Mudell:Commons	Vorlage:Commons
Opossum ta' denbu qasir ta' strixxa waħda	Einstreifen-Spitzmausbeutelratte
Għajnuna:Esplora lill-Wikipedija	Hilfe:Suche
Mudell:Pajjiżi tal-Commonwealth	Vorlage:Navigationsleiste Mitgliedstaaten des Commonwealth of Nations
Mudell:Utent ar-1	Vorlage:User ar-1
Mudell:Utent az	Vorlage:User az
Mudell:Utent be-2	Vorlage:User be-2
Mudell:Utent da-1	Vorlage:User da-1
Mudell:Utent bg-1	Vorlage:User bg-1
Mudell:Utent eo-3	Vorlage:User eo-3
Mudell:Utent de	Vorlage:User de
Mudell:Utent de-1	Vorlage:User de-1
Mudell:Utent el	Vorlage:User el
Mudell:Utent es	Vorlage:User es
Mudell:Utent de-3	Vorlage:User de-3
Mudell:Utent en-3	Vorlage:User en-3
Mudell:Utent en-1	Vorlage:User en-1
Mudell:Utent en-2	Vorlage:User en-2
Mudell:Utent en-4	Vorlage:User en-4
Mudell:Utent en-0	Vorlage:User en-0
Mudell:Utent en	Vorlage:User en
Mudell:Utent de-2	Vorlage:User de-2
Mudell:Utent es-1	Vorlage:User es-1
Mudell:Utent fa	Vorlage:User fa
Mudell:Utent fr-1	Vorlage:User fr-1
Tim nazzjonali tal-futbol ta' Malta ta' taħt is-17-il sena	Maltesische Fußballnationalmannschaft (U-17-Junioren)
Mudell:Utent ia-2	Vorlage:User ia-2
Mudell:Utent hr	Vorlage:User hr
Mudell:Utent it-3	Vorlage:User it-3
Mudell:Utent grc-1	Vorlage:User grc-1
Mudell:Utent ja-4	Vorlage:User ja-4
Mudell:Utent sk	Vorlage:User sk
Mudell:Utent tr-2	Vorlage:User tr-2
Mudell:Utent fr-2	Vorlage:User fr-2
Mudell:Utent ja	Vorlage:User ja
Mudell:Utent it-1	Vorlage:User it-1
Mudell:Utent fr	Vorlage:User fr
Mudell:Ebda firma	Vorlage:Unsigniert
Kategorija:Turiżmu	Kategorie:Tourismus
Kategorija:1957	Kategorie:1957
Kategorija:1949	Kategorie:1949
Kategorija:1927	Kategorie:1927
Kategorija:1919	Kategorie:1919
Kategorija:Moldova	Kategorie:Moldawien
Kategorija:Ażerbajġan	Kategorie:Aserbaidschan
Mudell:Plejers fit-tim tal-futbol/nofs	Vorlage:Football squad mid
Kategorija:Asja	Kategorie:Asien
Kategorija:Ċili	Kategorie:Chile
Kategorija:Seklu 21	Kategorie:21. Jahrhundert
Kategorija:Mudelli ta' servizz	Kategorie:Vorlage:Wartungsbaustein
Kategorija:Utenti uk	Kategorie:User uk
Kategorija:1930	Kategorie:1930
Kategorija:Utenti uk-N	Kategorie:User uk-M
Kategorija:1936	Kategorie:1936
Kategorija:1947	Kategorie:1947
Kategorija:1937	Kategorie:1937
Kategorija:1940	Kategorie:1940
Kategorija:1934	Kategorie:1934
Kategorija:1960	Kategorie:1960
Kategorija:1943	Kategorie:1943
Kategorija:1951	Kategorie:1951
Kategorija:1942	Kategorie:1942
Kategorija:1959	Kategorie:1959
Kategorija:1938	Kategorie:1938
Kategorija:1928	Kategorie:1928
Kategorija:1913	Kategorie:1913
Kategorija:1918	Kategorie:1918
Kategorija:1954	Kategorie:1954
Kategorija:1941	Kategorie:1941
Kategorija:1955	Kategorie:1955
Kategorija:1950	Kategorie:1950
Kategorija:1921	Kategorie:1921
Kategorija:1977	Kategorie:1977
Kategorija:1946	Kategorie:1946
Kategorija:1948	Kategorie:1948
Kategorija:1932	Kategorie:1932
Mudell:Plejers fit-tim tal-futbol	Vorlage:Football squad player
Kategorija:Futbol	Kategorie:Fußball
Kategorija:1945	Kategorie:1945
Mudell:Mod	Vorlage:Modulo
Kategorija:1923	Kategorie:1923
Kategorija:1935	Kategorie:1935
Kategorija:1910	Kategorie:1910
Kategorija:1917	Kategorie:1917
Kategorija:1904	Kategorie:1904
Kategorija:1926	Kategorie:1926
Kategorija:1907	Kategorie:1907
Kategorija:1914	Kategorie:1914
Mudell:Utent sv	Vorlage:User sv
Kategorija:1929	Kategorie:1929
Kategorija:1920	Kategorie:1920
Mudell:Utent it	Vorlage:User it
Kategorija:1925	Kategorie:1925
Mudell:Utent uk	Vorlage:User uk
Kategorija:1905	Kategorie:1905
Kategorija:1915	Kategorie:1915
Mudell:Utent es-2	Vorlage:User es-2
Kategorija:1908	Kategorie:1908
Kategorija:1901	Kategorie:1901
Kategorija:1903	Kategorie:1903
Kategorija:1902	Kategorie:1902
Kategorija:1900	Kategorie:1900
Kategorija:1933	Kategorie:1933
Kategorija:1912	Kategorie:1912
Mudell:Xhur	Vorlage:Navigationsleiste Monate
Kategorija:Klabbs tal-futbol Ingliżi	Kategorie:Englischer Fußballverein
Kategorija:Mudelli tal-koordinati	Kategorie:Vorlage:mit Koordinate
Kategorija:Klabbs tal-futbol Spanjoli	Kategorie:Spanischer Fußballverein
Kategorija:1952	Kategorie:1952
Kategorija:Klabbs tal-futbol Ġermaniżi	Kategorie:Deutscher Fußballverein
Kategorija:Lingwistika	Kategorie:Sprachwissenschaft
Mudell:Football kit	Vorlage:Football kit
Kategorija:1911	Kategorie:1911
Kategorija:1922	Kategorie:1922
Kategorija:1924	Kategorie:1924
Kategorija:1906	Kategorie:1906
Kategorija:Klabbs tal-futbol	Kategorie:Fußballverein
Kategorija:Mudelli tal-futbol	Kategorie:Vorlage:Fußball
Kategorija:Utenti fr-1	Kategorie:User fr-1
Mudell:Wikiquote	Vorlage:Wikiquote
Kategorija:Innijiet Nazzjonali	Kategorie:Nationalhymne
Mudell:Afrika	Vorlage:Navigationsleiste Staaten in Afrika
Mudell:Edizzjoni Olimpika	Vorlage:Infobox Olympische Spiele
Mudell:Wikimedia	Vorlage:Navigationsleiste Wikimedia-Projekte
Mudell:WIP	Vorlage:In Bearbeitung
Mudell:Għall-aġġornament	Vorlage:Veraltet
Mudell:Infobox Pajjiż	Vorlage:Infobox Staat
Mudell:Mas	Vorlage:Max
Mudell:Fi	Vorlage:FiS
Mudell:Stampa kbira	Vorlage:Panorama
Mudell:Sar	Vorlage:Erl.
Mudell:Awdjo	Vorlage:Audio
Mudell:Vetrina	Vorlage:Exzellent
Mudell:Round4	Vorlage:Round4
Mudell:Portal bidu	Portal:Box-header
Kategorija:Utenti en-4	Kategorie:User en-4
Kategorija:Utenti en	Kategorie:User en
Kategorija:Utenti zh	Kategorie:User zh
Kategorija:Kroazja	Kategorie:Kroatien
Kategorija:Utenti zh-N	Kategorie:User zh-M
Kategorija:Utenti en-2	Kategorie:User en-2
Mudell:TOCright	Vorlage:TOCright
Kategorija:Mietu fl-1902	Kategorie:Gestorben 1902
Mudell:Utent zh	Vorlage:User zh
Mudell:Infobox Tim nazzjonali tal-futbol	Vorlage:Infobox Fußballnationalmannschaft
Mudell:Leġenda	Vorlage:Farblegende
Mudell:Ċita web	Vorlage:Cite web
Kategorija:Unuri tal-futbol	Kategorie:Ehrung (Fußball)
Kategorija:Kċina	Kategorie:Essen und Trinken
Mudell:Min	Vorlage:Min
Mudell:Subon	Vorlage:Einwechslung
Mudell:Wikizzjunarju	Vorlage:Wiktionary
Mudell:Utent nl-2	Vorlage:User nl-2
Mudell:Bar box	Vorlage:Balkendiagramm
Kategorija:Agrikoltura	Kategorie:Landwirtschaft
Kategorija:Utenti hi	Kategorie:User hi
Kategorija:Seklu 20	Kategorie:20. Jahrhundert
Kategorija:Politiċi	Kategorie:Politiker
Kategorija:Amerika	Kategorie:Amerika
Mudell:Użioħra	Vorlage:Begriffsklärungshinweis
Kategorija:Pangolin	Kategorie:Schuppentiere
Kategorija:Mudelli tal-lingwi tal-utenti	Kategorie:Vorlage:Babel-Sprache
Kategorija:Bliet tal-Marokk	Kategorie:Ort in Marokko
Mudell:Clade	Vorlage:Klade
Mudell:Proġetti oħra	Vorlage:Schwesterprojekte
Mudell:Sortname	Vorlage:SortKeyName
Kategorija:Twieldu fl-1879	Kategorie:Geboren 1879
Kategorija:Twieldu fl-1955	Kategorie:Geboren 1955
Kategorija:Twieldu fl-1963	Kategorie:Geboren 1963
Kategorija:Twieldu fl-1817	Kategorie:Geboren 1817
Kategorija:Twieldu fl-1998	Kategorie:Geboren 1998
Mudell:Siġra ġenealoġika/tmiem	Vorlage:Stammbaum/Ende
Kategorija:Seklu 19	Kategorie:19. Jahrhundert
Kategorija:Kittieba	Kategorie:Autor
Mudell:Yel	Vorlage:Gelb
Mudell:Tim ta' AC Milan	Vorlage:Navigationsleiste Kader des AC Mailand
Mudell:Nat fs g start	Vorlage:National football squad start (goals)
Mudell:Utent pt-1	Vorlage:User pt-1
Kategorija:1931	Kategorie:1931
Kategorija:1958	Kategorie:1958
Kategorija:1956	Kategorie:1956
Kategorija:1944	Kategorie:1944
Kategorija:Jiem ta' Jannar	Kategorie:Januar
Kategorija:1916	Kategorie:1916
Kategorija:1939	Kategorie:1939
Mudell:Tavla Perjodika kumpatta	Vorlage:Navigationsleiste Periodensystem
Kategorija:1909	Kategorie:1909
Kategorija:Klabbs tal-futbol Taljani	Kategorie:Italienischer Fußballverein
Kategorija:Mietu fl-1221	Kategorie:Gestorben 1221
Mudell:Utent no-2	Vorlage:User no-2
Mudell:Kategorijamoħbija	Vorlage:Wartungskategorie
Mudell:Nat fs g end	Vorlage:National football squad end
Mudell:Dokumentazzjoni mudell	Vorlage:Dokumentation/Dokuseite
Mudell:Bundesliga	Vorlage:Navigationsleiste Vereine der deutschen Fußball-Bundesliga
Mudell:CcTLD	Vorlage:Navigationsleiste ccTLD
Mudell:Klassifikazzjoni	Vorlage:Rating
Kategorija:Pittura	Kategorie:Malerei
Kategorija:Pajjiżi mhux rikonoxxuti	Kategorie:Nicht allgemein anerkannter Staat
Mudell:Goal	Vorlage:Tor
Mudell:Paġna utent	Vorlage:Wikipedia-Benutzer
Mudell:Logo	Vorlage:Bild-LogoSH
Kategorija:UEFA Europa League	Kategorie:UEFA Europa League
Mudell:Infobox Album	Vorlage:Infobox Musikalbum
Mudell:Utent	Vorlage:Benutzer
Kategorija:Ajruporti fil-Vjetnam	Kategorie:Flughafen in Vietnam
Mudell:Emerġenza-buttuna-tifi	Vorlage:Emergency-bot-shutoff
Mudell:Imdb	Vorlage:IMDb Name
Kategorija:Tuneżija	Kategorie:Tunesien
Mudell:Infobox Stadju	Vorlage:Infobox Stadion
Mudell:Wikibarijiet	Vorlage:Wikinews
Mudell:Rindirizz	Vorlage:Weiterleitungshinweis
Mudell:TwoLegStart	Vorlage:TwoLegStart
Mudell:Pajjiżi fil-Logħob Olimpiku tas-Sajf 2008	Vorlage:Navigationsleiste Teilnehmer Olympische Sommerspiele 2008
Mudell:Kontra	Vorlage:Kontra
Mudell:Coord/link	Vorlage:CoordinateLINK
Mudell:LTU	Vorlage:LTU
Mudell:Utent SUL	Vorlage:Benutzer SUL
Kategorija:Utenti ja-N	Kategorie:User ja-M
Kategorija:Futbolers Belġjani	Kategorie:Fußballspieler (Belgien)
Kategorija:Futbolers Sloveni	Kategorie:Fußballspieler (Slowenien)
Kategorija:Artikli kandidati għall-vetrina tal-Wikipedija	Kategorie:Wikipedia:Kandidatur von Artikeln, Listen und Portalen
Mudell:Dati pajjiż Ġermanja tal-Lvant	Vorlage:Olympiabilanz
Kategorija:Twieldu fl-1903	Kategorie:Geboren 1903
Kategorija:Twieldu fl-1925	Kategorie:Geboren 1925
Kategorija:Twieldu fl-1936	Kategorie:Geboren 1936
Kategorija:Twieldu fl-1916	Kategorie:Geboren 1916
Kategorija:Twieldu fl-1910	Kategorie:Geboren 1910
Kategorija:Twieldu fl-1939	Kategorie:Geboren 1939
Mudell:Siġra ġenealoġika/bidu	Vorlage:Stammbaum/Start
Mudell:Diżambigwazzjoni	Vorlage:Begriffsklärung
Kategorija:1962	Kategorie:1962
Mudell:Ma sarx	Vorlage:Nein-Feld
Kategorija:Mudelli infobox	Kategorie:Vorlage:Infobox
Mudell:Penmiss	Vorlage:Straffehl
Kategorija:Real Madrid CF	Kategorie:Real Madrid
Kategorija:Storja ta' l-isport	Kategorie:Sportgeschichte
Kategorija:Futbol fi Spanja	Kategorie:Fußball in Spanien
Mudell:Pengoal	Vorlage:Straftor
Kategorija:Mietu fl-2013	Kategorie:Gestorben 2013
Kategorija:Twieldu fl-1938	Kategorie:Geboren 1938
Mudell:Utent no-3	Vorlage:User no-3
Kategorija:Teoloġija	Kategorie:Theologie
Mudell:Infobox Organizzazzjoni	Vorlage:Infobox Verband
Robin Stjernberg	Robin Stjernberg
Kategorija:1663	Kategorie:1663
Kategorija:Mietu fl-1663	Kategorie:Gestorben 1663
Kategorija:Arkitettura	Kategorie:Architektur
Mudell:NATO	Vorlage:Navigationsleiste NATO-Mitglieder
Mudell:Utent it-2	Vorlage:User it-2
Kategorija:Bliet tal-Italja	Kategorie:Gemeinde in Italien
Mudell:Età	Vorlage:Alter
Kategorija:1953	Kategorie:1953
Mudell:Tim ta' AS Roma	Vorlage:Navigationsleiste Kader der AS Rom
Mudell:L-Ewwel Diviżjoni Belġjana	Vorlage:Navigationsleiste Vereine der belgischen Jupiler League
Mudell:Football League Championship	Vorlage:Navigationsleiste Vereine der englischen Football League Championship
Kategorija:Isqfijiet Kattoliċi Rumani	Kategorie:Römisch-katholischer Bischof
Mudell:Coord	Vorlage:Coordinate
Kategorija:Twieldu fis-seklu 20	Kategorie:Geboren (20. Jahrhundert)
Kategorija:Twieldu fis-seklu 19	Kategorie:Geboren (19. Jahrhundert)
Kategorija:Twieldu fis-seklu 21	Kategorie:Geboren (21. Jahrhundert)
Kategorija:Twieldu fis-seklu 18	Kategorie:Geboren (18. Jahrhundert)
Kategorija:Twieldu fis-seklu 17	Kategorie:Geboren (17. Jahrhundert)
Kategorija:Twieldu fis-seklu 16	Kategorie:Geboren (16. Jahrhundert)
Kategorija:Twieldu fis-seklu 15	Kategorie:Geboren (15. Jahrhundert)
Kategorija:Mudelli tal-klabbs tal-futbol Franċiżi	Kategorie:Vorlage:Navigationsleiste Fußballkader (Frankreich)
Kategorija:FIFA	Kategorie:FIFA
Kategorija:Futbolers Ivorjani	Kategorie:Fußballspieler (Elfenbeinküste)
Mudell:Timijiet nazzjonali tal-CAF	Vorlage:Navigationsleiste Afrikanische Fußballnationalmannschaften
Mudell:Utent bg	Vorlage:User bg
Kategorija:Mietu fl-1622	Kategorie:Gestorben 1622
Mudell:Ewropa	Vorlage:Navigationsleiste Staaten in Europa
Kategorija:Futbolers skont in-nazzjonalità	Kategorie:Fußballspieler nach Staat
Kategorija:Utenti yue	Kategorie:User zh-yue
Kategorija:Utenti hif	Kategorie:User hif
Kategorija:Utenti az	Kategorie:User az
Kategorija:Utenti be	Kategorie:User be
Kategorija:Utenti hr	Kategorie:User hr
Kategorija:Utenti eo	Kategorie:User eo
Kategorija:Utenti fr	Kategorie:User fr
Kategorija:Utenti cy	Kategorie:User cy
Kategorija:Utenti id	Kategorie:User id
Kategorija:Utenti ga	Kategorie:User ga
Kategorija:Utenti ja	Kategorie:User ja
Kategorija:Utenti nn	Kategorie:User nn
Kategorija:Utenti pt	Kategorie:User pt
Kategorija:Utenti scn	Kategorie:User scn
Kategorija:Utenti sv	Kategorie:User sv
Kategorija:Utenti fr-3	Kategorie:User fr-3
Kategorija:Utenti it-3	Kategorie:User it-3
Kategorija:Utenti no-3	Kategorie:User no-3
Kategorija:Utenti pl-3	Kategorie:User pl-3
Kategorija:Utenti scn-3	Kategorie:User scn-3
Kategorija:Utenti da-1	Kategorie:User da-1
Kategorija:Utenti ga-1	Kategorie:User ga-1
Kategorija:Utenti nl-1	Kategorie:User nl-1
Kategorija:Utenti scn-1	Kategorie:User scn-1
Kategorija:Utenti tr-1	Kategorie:User tr-1
Kategorija:Utenti ar-1	Kategorie:User ar-1
Kategorija:Utenti id-4	Kategorie:User id-4
Kategorija:Utenti it-4	Kategorie:User it-4
Kategorija:Utenti pl-4	Kategorie:User pl-4
Kategorija:Utenti be-2	Kategorie:User be-2
Kategorija:Utenti da-2	Kategorie:User da-2
Kategorija:Utenti fr-2	Kategorie:User fr-2
Kategorija:Utenti cy-2	Kategorie:User cy-2
Kategorija:Utenti hi-2	Kategorie:User hi-2
Kategorija:Utenti it-2	Kategorie:User it-2
Kategorija:Utenti ja-2	Kategorie:User ja-2
Kategorija:Utenti nl-2	Kategorie:User nl-2
Kategorija:Utenti pl-2	Kategorie:User pl-2
Kategorija:Utenti scn-2	Kategorie:User scn-2
Kategorija:Utenti tr-2	Kategorie:User tr-2
Kategorija:Utenti hif-N	Kategorie:User hif-M
Kategorija:Utenti be-N	Kategorie:User be-M
Kategorija:Utenti cs-N	Kategorie:User cs-M
Kategorija:Utenti hr-N	Kategorie:User hr-M
Kategorija:Utenti fr-N	Kategorie:User fr-M
Kategorija:Utenti it-N	Kategorie:User it-M
Kategorija:Utenti nl-N	Kategorie:User nl-M
Kategorija:Utenti no-N	Kategorie:User no-M
Kategorija:Utenti ru-N	Kategorie:User ru-M
Kategorija:Utenti scn-N	Kategorie:User scn-M
Kategorija:Divertiment	Kategorie:Unterhaltung
Kategorija:Utenti se-3	Kategorie:User se-3
Mudell:Nfteams	Vorlage:NFTPlayer/Meta
Kategorija:Klabbs tal-futbol xolti	Kategorie:Ehemaliger Fußballverein
Kategorija:UEFA Champions League	Kategorie:UEFA Champions League
Mudell:Utent yue	Vorlage:User zh-yue
Mudell:Utent pdc-1	Vorlage:User pdc-1
Kategorija:1220	Kategorie:1220
Kategorija:UEFA	Kategorie:UEFA
Kategorija:Utenti af	Kategorie:User af
Kategorija:Utenti af-3	Kategorie:User af-3
Kategorija:Utenti ar	Kategorie:User ar
Kategorija:Utenti az-N	Kategorie:User az-M
Kategorija:Pajjiżi fil-Festival tal-Eurovision	Kategorie:Eurovision Song Contest nach Staat
Kategorija:Utenti bg	Kategorie:User bg
Kategorija:Utenti bg-1	Kategorie:User bg-1
Kategorija:Utenti bg-N	Kategorie:User bg-M
Kategorija:Mużiċisti Awstrijaċi	Kategorie:Österreichischer Musiker
Kategorija:Utenti cs	Kategorie:User cs
Kategorija:Utenti da	Kategorie:User da
Kategorija:Provinċja ta' Quang Binh	Kategorie:Quảng Bình
Kategorija:Utenti de	Kategorie:User de
Kategorija:Utenti de-2	Kategorie:User de-2
Kategorija:Utenti de-3	Kategorie:User de-3
Kategorija:Utenti de-4	Kategorie:User de-4
Kategorija:Utenti de-N	Kategorie:User de-M
Kategorija:Utenti el	Kategorie:User el
Kategorija:Utenti el-N	Kategorie:User el-M
Kategorija:Utenti en-3	Kategorie:User en-3
Kategorija:Utenti en-N	Kategorie:User en-M
Kategorija:Utenti eo-3	Kategorie:User eo-3
Kategorija:Utenti es	Kategorie:User es
Kategorija:Utenti es-1	Kategorie:User es-1
Mudell:Pajjiżi tal-Unjoni Ewropea	Vorlage:Navigationsleiste EU-Staaten
Kategorija:Utenti es-2	Kategorie:User es-2
Kategorija:Utenti es-3	Kategorie:User es-3
Kategorija:Utenti es-N	Kategorie:User es-M
Kategorija:Utenti fa	Kategorie:User fa
Kategorija:Utenti fa-N	Kategorie:User fa-M
Kategorija:Utenti fi	Kategorie:User fi
Kategorija:Utenti fi-N	Kategorie:User fi-M
Kategorija:Utenti ga-2	Kategorie:User ga-2
Kategorija:Utenti ga-3	Kategorie:User ga-3
Kategorija:Utenti ga-N	Kategorie:User ga-M
Kategorija:Utenti grc	Kategorie:User grc
Kategorija:Utenti grc-1	Kategorie:User grc-1
Kategorija:Utenti hu	Kategorie:User hu
Kategorija:Utenti hu-1	Kategorie:User hu-1
Kategorija:1452	Kategorie:1452
Mudell:Tim ta' Bayer 04 Leverkusen	Vorlage:Navigationsleiste Kader von Bayer 04 Leverkusen
Kategorija:Plejers ta' Los Angeles Galaxy	Kategorie:Fußballspieler (Los Angeles Galaxy)
Kategorija:Mietu fl-1904	Kategorie:Gestorben 1904
Kategorija:Plejers ta' Grasshopper Club Zürich	Kategorie:Grasshopper Club Zürich
Kategorija:Politiċi Veneżwelani	Kategorie:Politiker (Venezuela)
Mudell:Tim ta' Málaga CF	Vorlage:Navigationsleiste Kader des FC Málaga
Kategorija:Utenti pl-N	Kategorie:User pl-M
Kategorija:Utenti pt-1	Kategorie:User pt-1
Kategorija:Mietu fl-1852	Kategorie:Gestorben 1852
Kategorija:Mietu fl-1880	Kategorie:Gestorben 1880
Kategorija:Ġeometrija	Kategorie:Geometrie
Kategorija:Mietu fl-1942	Kategorie:Gestorben 1942
Kategorija:Kampjonati Ewropej tal-Futbol 2012	Kategorie:Fußball-Europameisterschaft 2012
Għajnuna:Gwida essenzjali/Ifformattjar	Wikipedia:Tutorial/4
Kategorija:Utenti it	Kategorie:User it
Kategorija:Utenti it-1	Kategorie:User it-1
Kategorija:Futbolers Ażerbajġani	Kategorie:Fußballspieler (Aserbaidschan)
Kategorija:European Broadcasting Union	Kategorie:Europäische Rundfunkunion
Kategorija:Vulkani	Kategorie:Vulkan
Kategorija:Mietu fl-1564	Kategorie:Gestorben 1564
Kategorija:1564	Kategorie:1564
Kategorija:Edizzjonijiet tat-Tazza tad-Dinja tal-Futbol	Kategorie:Fußball-Weltmeisterschaft
Kategorija:Provinċji tal-Vjetnam	Kategorie:Provinz in Vietnam
Kategorija:1592	Kategorie:1592
Kategorija:Arti marzjali	Kategorie:Kampfkunst
Mudell:Informazzjoni	Vorlage:Information
Kategorija:Pitturi tar-Rinaxximent	Kategorie:Maler der Renaissance
Kategorija:Bijoloġi evoluzzjonarji	Kategorie:Evolutionsbiologe
Kategorija:Knisja Kattolika Rumana	Kategorie:Römisch-katholische Kirche
Kategorija:Kowċis Olandiżi	Kategorie:Fußballtrainer (Niederlande)
Kategorija:Mużiċisti Olandiżi	Kategorie:Niederländischer Musiker
Kategorija:Mietu fl-1794	Kategorie:Gestorben 1794
Kategorija:Mietu fl-1931	Kategorie:Gestorben 1931
Kategorija:Mietu fl-1827	Kategorie:Gestorben 1827
Kategorija:Utenti ru-1	Kategorie:User ru-1
Mudell:TOClimit	Vorlage:TOC limit
Wikipedija:Babel	Wikipedia:Babel
Kategorija:Mietu fl-1829	Kategorie:Gestorben 1829
Kategorija:Mietu fl-1778	Kategorie:Gestorben 1778
Kategorija:Mietu fl-1547	Kategorie:Gestorben 1547
Kategorija:1687	Kategorie:1687
Kategorija:1614	Kategorie:1614
Kategorija:1612	Kategorie:1612
Kategorija:Mietu fl-1612	Kategorie:Gestorben 1612
Kategorija:Mietu fl-1655	Kategorie:Gestorben 1655
Kategorija:Mietu fl-1616	Kategorie:Gestorben 1616
Kategorija:Mietu fl-1614	Kategorie:Gestorben 1614
Kategorija:Futbolers Olandiżi	Kategorie:Fußballspieler (Niederlande)
Kategorija:1655	Kategorie:1655
Kategorija:Utenti nb-1	Kategorie:User nb-1
Kategorija:Mietu fl-1994	Kategorie:Gestorben 1994
Kategorija:Twieldu fl-1906	Kategorie:Geboren 1906
Kategorija:Kompożituri tal-opra	Kategorie:Komponist (Oper)
Kategorija:Ibħra	Kategorie:Meer
Kategorija:Kompożituri skont in-nazzjonalità	Kategorie:Komponist nach Nationalität
Mudell:Bundesliga (Awstrija)	Vorlage:Navigationsleiste Vereine der österreichischen Fußball-Bundesliga
Kategorija:Futbolers f'Wales skont il-klabb	Kategorie:Fußballspieler (Wales) nach Verein
Kategorija:Mietu fl-2009	Kategorie:Gestorben 2009
Kategorija:Utenti nb-3	Kategorie:User nb-3
Kategorija:Sistema solari	Kategorie:Sonnensystem
Trasformata ta' Fourier	Fourier-Transformation
Kategorija:Entomoloġija	Kategorie:Entomologie
Mudell:PD-old-70	Vorlage:Bild-PD-alt
Kategorija:Carnivora	Kategorie:Raubtiere
Kategorija:Klabbs tal-futbol Torok	Kategorie:Türkischer Fußballverein
Kategorija:Mietu fl-1321	Kategorie:Gestorben 1321
Kategorija:Mietu fl-2005	Kategorie:Gestorben 2005
Kategorija:Twieldu fl-1983	Kategorie:Geboren 1983
Kategorija:Mietu fl-1592	Kategorie:Gestorben 1592
Kategorija:Futbolers Pollakki	Kategorie:Fußballspieler (Polen)
Kategorija:Mużiċisti Bulgari	Kategorie:Bulgarischer Musiker
Kategorija:Vandaliżmu tal-Wikipedija	Kategorie:Wikipedia:Vandalismus
Kategorija:Mietu fl-1991	Kategorie:Gestorben 1991
Kategorija:Mietu fl-1992	Kategorie:Gestorben 1992
Kategorija:Plejers ta' Sport Club Corinthians Paulista	Kategorie:Fußballspieler (Corinthians São Paulo)
Kategorija:Twieldu fl-1992	Kategorie:Geboren 1992
Kategorija:Utenti nb	Kategorie:User nb
Kategorija:Twieldu fl-1970	Kategorie:Geboren 1970
Kategorija:Mietu fl-1980	Kategorie:Gestorben 1980
Kategorija:Mietu fl-2008	Kategorie:Gestorben 2008
Kategorija:Mietu fl-1966	Kategorie:Gestorben 1966
Kategorija:Mietu fl-1946	Kategorie:Gestorben 1946
Kategorija:Mietu fl-1938	Kategorie:Gestorben 1938
Kategorija:Twieldu fl-1984	Kategorie:Geboren 1984
Kategorija:Mietu fl-1962	Kategorie:Gestorben 1962
Kategorija:Twieldu fl-1990	Kategorie:Geboren 1990
Kategorija:Mietu fl-1934	Kategorie:Gestorben 1934
Kategorija:Twieldu fl-1974	Kategorie:Geboren 1974
Kategorija:Mietu fl-1947	Kategorie:Gestorben 1947
Kategorija:Mietu fl-2007	Kategorie:Gestorben 2007
Kategorija:Twieldu fl-1965	Kategorie:Geboren 1965
Kategorija:Twieldu fl-1940	Kategorie:Geboren 1940
Kategorija:Twieldu fl-1898	Kategorie:Geboren 1898
Kategorija:Twieldu fl-1867	Kategorie:Geboren 1867
Kategorija:Twieldu fl-1871	Kategorie:Geboren 1871
Kategorija:Twieldu fl-1862	Kategorie:Geboren 1862
Kategorija:Twieldu fl-1977	Kategorie:Geboren 1977
Kategorija:Twieldu fl-1899	Kategorie:Geboren 1899
Kategorija:1844	Kategorie:1844
Kategorija:Twieldu fl-1931	Kategorie:Geboren 1931
Kategorija:Twieldu fl-1915	Kategorie:Geboren 1915
Kategorija:Twieldu fl-1929	Kategorie:Geboren 1929
Portal:Sport	Portal:Sport
Kategorija:Twieldu fl-1954	Kategorie:Geboren 1954
Kategorija:Xjenza soċjali	Kategorie:Sozialwissenschaft
Kategorija:Bjelorussja	Kategorie:Weißrussland
Kategorija:Twieldu fl-1960	Kategorie:Geboren 1960
Kategorija:Mudelli għall-kalkolu tad-dati	Kategorie:Vorlage:Datumsberechnung
Kategorija:Mietu fl-1830	Kategorie:Gestorben 1830
Kategorija:Ewropa tal-Lvant	Kategorie:Osteuropa
Kategorija:Mietu fl-1993	Kategorie:Gestorben 1993
Mudell:PortaliWikimedia	Vorlage:Portal-Schwesterprojekte
Kategorija:Pajjiżi tal-Afrika	Kategorie:Staat in Afrika
Kategorija:Mietu fl-1998	Kategorie:Gestorben 1998
Kategorija:Klabbs tal-futbol Ażerbajġani	Kategorie:Aserbaidschanischer Fußballverein
Kategorija:1170	Kategorie:1170
Kategorija:Twieldu fl-1170	Kategorie:Geboren 1170
Kategorija:Twieldu fl-1182	Kategorie:Geboren 1182
Kategorija:Twieldu fl-1185	Kategorie:Geboren 1185
Kategorija:Mietu fl-1220	Kategorie:Gestorben 1220
Kategorija:1226	Kategorie:1226
Kategorija:Mietu fl-1226	Kategorie:Gestorben 1226
Kategorija:1227	Kategorie:1227
Kategorija:Mietu fl-1227	Kategorie:Gestorben 1227
Kategorija:Twieldu fl-1951	Kategorie:Geboren 1951
Kategorija:Mietu fl-1882	Kategorie:Gestorben 1882
Kategorija:Mietu fl-1883	Kategorie:Gestorben 1883
Kategorija:1265	Kategorie:1265
Kategorija:Twieldu fl-1265	Kategorie:Geboren 1265
Kategorija:1296	Kategorie:1296
Kategorija:Mietu fl-1296	Kategorie:Gestorben 1296
Mudell:Storjafilosofija	Vorlage:Navigationsleiste Philosophiegeschichte
Mudell:Utent da-3	Vorlage:User da-3
Mudell:Tim ta' FC Barcelona	Vorlage:Navigationsleiste Kader des FC Barcelona
Mudell:Utent ja-2	Vorlage:User ja-2
Kategorija:1528	Kategorie:1528
Kategorija:1405	Kategorie:1405
Mudell:Utent ru-2	Vorlage:User ru-2
Kategorija:Twieldu fl-1405	Kategorie:Geboren 1405
Kategorija:1522	Kategorie:1522
Kategorija:1419	Kategorie:1419
Kategorija:1508	Kategorie:1508
Kategorija:1519	Kategorie:1519
Kategorija:Futbol fil-Polonja	Kategorie:Fußball in Polen
Kategorija:Futbolers fil-Polonja skont il-klabb	Kategorie:Fußballspieler (Polen) nach Verein
Kategorija:Twieldu fl-1452	Kategorie:Geboren 1452
Kategorija:1466	Kategorie:1466
Kategorija:1468	Kategorie:1468
Kategorija:Mietu fl-1468	Kategorie:Gestorben 1468
Kategorija:1471	Kategorie:1471
Kategorija:Twieldu fl-1471	Kategorie:Geboren 1471
Kategorija:1478	Kategorie:1478
Kategorija:Twieldu fl-1478	Kategorie:Geboren 1478
Kategorija:Twieldu fl-1480	Kategorie:Geboren 1480
Kategorija:1483	Kategorie:1483
Kategorija:1494	Kategorie:1494
Kategorija:Twieldu fl-1494	Kategorie:Geboren 1494
Kategorija:Utenti ru	Kategorie:User ru
Kategorija:Utenti ru-2	Kategorie:User ru-2
Kategorija:Utenti ru-3	Kategorie:User ru-3
Kategorija:Twieldu fl-1508	Kategorie:Geboren 1508
Kategorija:Utenti se	Kategorie:User se
Kategorija:Twieldu fl-1515	Kategorie:Geboren 1515
Kategorija:Mietu fl-1519	Kategorie:Gestorben 1519
Kategorija:1532	Kategorie:1532
Kategorija:Twieldu fl-1532	Kategorie:Geboren 1532
Kategorija:Twieldu fl-1533	Kategorie:Geboren 1533
Kategorija:Mietu fl-1535	Kategorie:Gestorben 1535
Kategorija:Mietu fl-1539	Kategorie:Gestorben 1539
Kategorija:1542	Kategorie:1542
Kategorija:Utenti sv-3	Kategorie:User sv-3
Kategorija:1547	Kategorie:1547
Kategorija:Utenti sv-N	Kategorie:User sv-M
Kategorija:Twieldu fl-1552	Kategorie:Geboren 1552
Kategorija:1562	Kategorie:1562
Kategorija:Twieldu fl-1564	Kategorie:Geboren 1564
Kategorija:1567	Kategorie:1567
Kategorija:1568	Kategorie:1568
Kategorija:Mietu fl-1568	Kategorie:Gestorben 1568
Kategorija:1573	Kategorie:1573
Kategorija:Twieldu fl-1573	Kategorie:Geboren 1573
Kategorija:1581	Kategorie:1581
Kategorija:Twieldu fl-1582	Kategorie:Geboren 1582
Kategorija:1591	Kategorie:1591
Kategorija:1593	Kategorie:1593
Kategorija:1597	Kategorie:1597
Kategorija:1600	Kategorie:1600
Kategorija:1616	Kategorie:1616
Kategorija:1621	Kategorie:1621
Kategorija:Utenti tr	Kategorie:User tr
Kategorija:Mietu fl-1621	Kategorie:Gestorben 1621
Kategorija:1625	Kategorie:1625
Kategorija:Mietu fl-1625	Kategorie:Gestorben 1625
Kategorija:Utenti uk-4	Kategorie:User uk-4
Kategorija:1636	Kategorie:1636
Kategorija:1643	Kategorie:1643
Kategorija:Mietu fl-1643	Kategorie:Gestorben 1643
Kategorija:1654	Kategorie:1654
Kategorija:Twieldu fl-1654	Kategorie:Geboren 1654
Kategorija:1656	Kategorie:1656
Kategorija:Mietu fl-1656	Kategorie:Gestorben 1656
Kategorija:Utenti yue-N	Kategorie:User zh-yue-M
Kategorija:1660	Kategorie:1660
Kategorija:1667	Kategorie:1667
Kategorija:Mietu fl-1667	Kategorie:Gestorben 1667
Kategorija:1670	Kategorie:1670
Kategorija:Mietu fl-1670	Kategorie:Gestorben 1670
Kategorija:1675	Kategorie:1675
Kategorija:1685	Kategorie:1685
Kategorija:Twieldu fl-1687	Kategorie:Geboren 1687
Kategorija:1694	Kategorie:1694
Kategorija:1695	Kategorie:1695
Kategorija:Twieldu fl-1696	Kategorie:Geboren 1696
Kategorija:Twieldu fl-1699	Kategorie:Geboren 1699
Kategorija:1700	Kategorie:1700
Mudell:Premier League Malti	Vorlage:Navigationsleiste Vereine der MIA Premier League
Kategorija:Mietu fl-1705	Kategorie:Gestorben 1705
Kategorija:1709	Kategorie:1709
Kategorija:1710	Kategorie:1710
Kategorija:Twieldu fl-1715	Kategorie:Geboren 1715
Kategorija:Twieldu fl-1724	Kategorie:Geboren 1724
Kategorija:Mużiċisti	Kategorie:Musiker
Kategorija:Twieldu fl-1881	Kategorie:Geboren 1881
Mudell:Timijiet nazzjonali tal-UEFA	Vorlage:Navigationsleiste Europäische Fußballnationalmannschaften
Mudell:Tim ta' Manchester United FC	Vorlage:Navigationsleiste Kader von Manchester United
Kategorija:Twieldu fl-1944	Kategorie:Geboren 1944
Kategorija:Twieldu fl-1932	Kategorie:Geboren 1932
Kategorija:Twieldu fl-1934	Kategorie:Geboren 1934
Kategorija:Twieldu fl-1935	Kategorie:Geboren 1935
Kategorija:Twieldu fl-1941	Kategorie:Geboren 1941
Kategorija:Soċjoloġija	Kategorie:Soziologie
Kategorija:Twieldu fis-seklu 12	Kategorie:Geboren (12. Jahrhundert)
Kategorija:Twieldu fis-seklu 13	Kategorie:Geboren (13. Jahrhundert)
Kategorija:Twieldu fis-seklu 14	Kategorie:Geboren (14. Jahrhundert)
Kategorija:Twieldu fl-1466	Kategorie:Geboren 1466
Kategorija:Twieldu fl-1483	Kategorie:Geboren 1483
Kategorija:Twieldu fl-1542	Kategorie:Geboren 1542
Kategorija:Twieldu fl-1547	Kategorie:Geboren 1547
Kategorija:Twieldu fl-1562	Kategorie:Geboren 1562
Kategorija:Twieldu fl-1567	Kategorie:Geboren 1567
Kategorija:Twieldu fl-1581	Kategorie:Geboren 1581
Kategorija:Twieldu fl-1591	Kategorie:Geboren 1591
Kategorija:Twieldu fl-1593	Kategorie:Geboren 1593
Kategorija:Twieldu fl-1600	Kategorie:Geboren 1600
Kategorija:Twieldu fl-1636	Kategorie:Geboren 1636
Kategorija:Twieldu fl-1643	Kategorie:Geboren 1643
Kategorija:Twieldu fl-1667	Kategorie:Geboren 1667
Kategorija:Twieldu fl-1675	Kategorie:Geboren 1675
Kategorija:Twieldu fl-1685	Kategorie:Geboren 1685
Kategorija:Twieldu fl-1694	Kategorie:Geboren 1694
Kategorija:Twieldu fl-1695	Kategorie:Geboren 1695
Kategorija:Twieldu fl-1700	Kategorie:Geboren 1700
Kategorija:Twieldu fl-1710	Kategorie:Geboren 1710
Kategorija:Twieldu fl-1744	Kategorie:Geboren 1744
Kategorija:Ġurnalisti Maltin	Kategorie:Journalist (Malta)
Kategorija:Twieldu fl-1748	Kategorie:Geboren 1748
Kategorija:Twieldu fl-1749	Kategorie:Geboren 1749
Kategorija:Twieldu fl-1756	Kategorie:Geboren 1756
Kategorija:Twieldu fl-1758	Kategorie:Geboren 1758
Kategorija:Twieldu fl-1759	Kategorie:Geboren 1759
Kategorija:Twieldu fl-1764	Kategorie:Geboren 1764
Kategorija:Twieldu fl-1767	Kategorie:Geboren 1767
Kategorija:Twieldu fl-1769	Kategorie:Geboren 1769
Kategorija:Twieldu fl-1770	Kategorie:Geboren 1770
Kategorija:Twieldu fl-1772	Kategorie:Geboren 1772
Kategorija:Twieldu fl-1773	Kategorie:Geboren 1773
Kategorija:Twieldu fl-1779	Kategorie:Geboren 1779
Kategorija:Twieldu fl-1786	Kategorie:Geboren 1786
Kategorija:Twieldu fl-1797	Kategorie:Geboren 1797
Kategorija:Twieldu fl-1801	Kategorie:Geboren 1801
Kategorija:Twieldu fl-1803	Kategorie:Geboren 1803
Kategorija:Twieldu fl-1808	Kategorie:Geboren 1808
Kategorija:Twieldu fl-1809	Kategorie:Geboren 1809
Kategorija:Twieldu fl-1813	Kategorie:Geboren 1813
Kategorija:Twieldu fl-1815	Kategorie:Geboren 1815
Kategorija:Twieldu fl-1818	Kategorie:Geboren 1818
Kategorija:Twieldu fl-1821	Kategorie:Geboren 1821
Kategorija:Twieldu fl-1822	Kategorie:Geboren 1822
Kategorija:Twieldu fl-1824	Kategorie:Geboren 1824
Kategorija:Twieldu fl-1840	Kategorie:Geboren 1840
Kategorija:Twieldu fl-1841	Kategorie:Geboren 1841
Kategorija:Twieldu fl-1844	Kategorie:Geboren 1844
Kategorija:Twieldu fl-1846	Kategorie:Geboren 1846
Kategorija:Twieldu fl-1847	Kategorie:Geboren 1847
Kategorija:Twieldu fl-1848	Kategorie:Geboren 1848
Kategorija:Twieldu fl-1849	Kategorie:Geboren 1849
Kategorija:Twieldu fl-1853	Kategorie:Geboren 1853
Kategorija:Twieldu fl-1854	Kategorie:Geboren 1854
Kategorija:Twieldu fl-1859	Kategorie:Geboren 1859
Kategorija:Twieldu fl-1860	Kategorie:Geboren 1860
Kategorija:Twieldu fl-1861	Kategorie:Geboren 1861
Kategorija:Twieldu fl-1864	Kategorie:Geboren 1864
Kategorija:Twieldu fl-1866	Kategorie:Geboren 1866
Kategorija:Twieldu fl-1869	Kategorie:Geboren 1869
Kategorija:Twieldu fl-1873	Kategorie:Geboren 1873
Kategorija:Twieldu fl-1874	Kategorie:Geboren 1874
Kategorija:Twieldu fl-1876	Kategorie:Geboren 1876
Kategorija:Twieldu fl-1877	Kategorie:Geboren 1877
Kategorija:Twieldu fl-1880	Kategorie:Geboren 1880
Kategorija:Twieldu fl-1883	Kategorie:Geboren 1883
Kategorija:Twieldu fl-1884	Kategorie:Geboren 1884
Kategorija:Twieldu fl-1885	Kategorie:Geboren 1885
Kategorija:Twieldu fl-1886	Kategorie:Geboren 1886
Kategorija:Twieldu fl-1887	Kategorie:Geboren 1887
Kategorija:Twieldu fl-1889	Kategorie:Geboren 1889
Kategorija:Twieldu fl-1890	Kategorie:Geboren 1890
Kategorija:Twieldu fl-1891	Kategorie:Geboren 1891
Kategorija:Twieldu fl-1892	Kategorie:Geboren 1892
Kategorija:Twieldu fl-1893	Kategorie:Geboren 1893
Kategorija:Twieldu fl-1894	Kategorie:Geboren 1894
Kategorija:Twieldu fl-1895	Kategorie:Geboren 1895
Kategorija:Twieldu fl-1896	Kategorie:Geboren 1896
Kategorija:Twieldu fl-1897	Kategorie:Geboren 1897
Kategorija:Twieldu fl-1900	Kategorie:Geboren 1900
Kategorija:Twieldu fl-1901	Kategorie:Geboren 1901
Kategorija:Twieldu fl-1902	Kategorie:Geboren 1902
Kategorija:Twieldu fl-1904	Kategorie:Geboren 1904
Kategorija:Twieldu fl-1905	Kategorie:Geboren 1905
Kategorija:Twieldu fl-1907	Kategorie:Geboren 1907
Kategorija:Twieldu fl-1908	Kategorie:Geboren 1908
Kategorija:Twieldu fl-1909	Kategorie:Geboren 1909
Kategorija:Twieldu fl-1912	Kategorie:Geboren 1912
Kategorija:Twieldu fl-1913	Kategorie:Geboren 1913
Kategorija:Twieldu fl-1914	Kategorie:Geboren 1914
Kategorija:Twieldu fl-1917	Kategorie:Geboren 1917
Kategorija:Twieldu fl-1918	Kategorie:Geboren 1918
Kategorija:Twieldu fl-1919	Kategorie:Geboren 1919
Kategorija:Twieldu fl-1922	Kategorie:Geboren 1922
Kategorija:Twieldu fl-1923	Kategorie:Geboren 1923
Kategorija:Twieldu fl-1927	Kategorie:Geboren 1927
Kategorija:Twieldu fl-1928	Kategorie:Geboren 1928
Kategorija:Twieldu fl-1942	Kategorie:Geboren 1942
Kategorija:Twieldu fl-1943	Kategorie:Geboren 1943
Kategorija:Twieldu fl-1945	Kategorie:Geboren 1945
Kategorija:Twieldu fl-1947	Kategorie:Geboren 1947
Kategorija:Twieldu fl-1949	Kategorie:Geboren 1949
Kategorija:Twieldu fl-1952	Kategorie:Geboren 1952
Kategorija:Twieldu fl-1953	Kategorie:Geboren 1953
Kategorija:Twieldu fl-1957	Kategorie:Geboren 1957
Kategorija:Twieldu fl-1958	Kategorie:Geboren 1958
Kategorija:Twieldu fl-1959	Kategorie:Geboren 1959
Kategorija:Twieldu fl-1961	Kategorie:Geboren 1961
Kategorija:Twieldu fl-1962	Kategorie:Geboren 1962
Kategorija:Twieldu fl-1966	Kategorie:Geboren 1966
Kategorija:Twieldu fl-1967	Kategorie:Geboren 1967
Kategorija:Twieldu fl-1968	Kategorie:Geboren 1968
Kategorija:Twieldu fl-1969	Kategorie:Geboren 1969
Kategorija:Twieldu fl-1971	Kategorie:Geboren 1971
Kategorija:Twieldu fl-1972	Kategorie:Geboren 1972
Kategorija:Twieldu fl-1973	Kategorie:Geboren 1973
Kategorija:Twieldu fl-1975	Kategorie:Geboren 1975
Kategorija:Twieldu fl-1976	Kategorie:Geboren 1976
Kategorija:Twieldu fl-1978	Kategorie:Geboren 1978
Kategorija:Twieldu fl-1979	Kategorie:Geboren 1979
Kategorija:Twieldu fl-1980	Kategorie:Geboren 1980
Kategorija:Twieldu fl-1981	Kategorie:Geboren 1981
Kategorija:Twieldu fl-1982	Kategorie:Geboren 1982
Kategorija:Twieldu fl-1985	Kategorie:Geboren 1985
Kategorija:Twieldu fl-1986	Kategorie:Geboren 1986
Kategorija:Twieldu fl-1987	Kategorie:Geboren 1987
Kategorija:Twieldu fl-1988	Kategorie:Geboren 1988
Kategorija:Twieldu fl-1989	Kategorie:Geboren 1989
Kategorija:Twieldu fl-1991	Kategorie:Geboren 1991
Kategorija:Twieldu fl-1993	Kategorie:Geboren 1993
Kategorija:Twieldu fl-1994	Kategorie:Geboren 1994
Kategorija:Twieldu fl-1995	Kategorie:Geboren 1995
Kategorija:Twieldu fl-1996	Kategorie:Geboren 1996
Kategorija:Twieldu fl-1997	Kategorie:Geboren 1997
Kategorija:Twieldu fl-1999	Kategorie:Geboren 1999
Kategorija:Twieldu fl-2000	Kategorie:Geboren 2000
Mudell:Tazza tad-Dinja tal-Futbol 2006	Vorlage:Navigationsleiste Spiele Fußball-Weltmeisterschaft 2006
Kategorija:1715	Kategorie:1715
Kategorija:1797	Kategorie:1797
Kategorija:1787	Kategorie:1787
Kategorija:1539	Kategorie:1539
Kategorija:1321	Kategorie:1321
Mudell:Tim ta' ACF Fiorentina	Vorlage:Navigationsleiste Kader der AC Florenz
Kategorija:Seklu 17	Kategorie:17. Jahrhundert
Kategorija:Deċennju tal-1260	Kategorie:1260er
Mudell:Tim ta' Arsenal FC	Vorlage:Navigationsleiste Kader des FC Arsenal
Mudell:CopyrightByWikimedia	Vorlage:Bild-WikimediaCopyright
Kategorija:1182	Kategorie:1182
Kategorija:1185	Kategorie:1185
Kategorija:1221	Kategorie:1221
Mudell:Premier League Ażerbajġan	Vorlage:Navigationsleiste Vereine in der aserbaidschanischen Premyer Liqası
Kategorija:Plejers ta' Celta de Vigo	Kategorie:Fußballspieler (Celta Vigo)
Mudell:Bar percent	Vorlage:Balken Prozent
Mudell:Tim ta' Bologna FC 1909	Vorlage:Navigationsleiste Kader des FC Bologna
Kategorija:2014	Kategorie:2014
Mudell:Utent sv-3	Vorlage:User sv-3
Mudell:Timijiet nazzjonali tal-CONMEBOL	Vorlage:Navigationsleiste Südamerikanische Fußballnationalmannschaften
Kategorija:1515	Kategorie:1515
Kategorija:Mietu fl-1522	Kategorie:Gestorben 1522
Kategorija:Portali	Kategorie:Portal:
Kategorija:Mietu fl-1528	Kategorie:Gestorben 1528
Kategorija:1533	Kategorie:1533
Kategorija:1535	Kategorie:1535
Kategorija:1546	Kategorie:1546
Kategorija:1552	Kategorie:1552
Kategorija:Futbolers Sud-Koreani	Kategorie:Fußballspieler (Südkorea)
Kategorija:1580	Kategorie:1580
Kategorija:Mietu fl-1580	Kategorie:Gestorben 1580
Kategorija:1582	Kategorie:1582
Kategorija:1595	Kategorie:1595
Mudell:Utent af-3	Vorlage:User af-3
Kategorija:1622	Kategorie:1622
Kategorija:1642	Kategorie:1642
Kategorija:Mietu fl-1642	Kategorie:Gestorben 1642
Kategorija:Mietu fl-1660	Kategorie:Gestorben 1660
Kategorija:1696	Kategorie:1696
Kategorija:1699	Kategorie:1699
Kategorija:1705	Kategorie:1705
Kategorija:1726	Kategorie:1726
Kategorija:Mietu fl-1726	Kategorie:Gestorben 1726
Kategorija:Mietu fl-1727	Kategorie:Gestorben 1727
Marie Louise Coleiro Preca	Marie Louise Coleiro Preca
Kategorija:Mietu fl-1748	Kategorie:Gestorben 1748
Kategorija:Mietu fl-1757	Kategorie:Gestorben 1757
Kategorija:Mietu fl-1759	Kategorie:Gestorben 1759
Kategorija:Mietu fl-1760	Kategorie:Gestorben 1760
Kategorija:1764	Kategorie:1764
Kategorija:1767	Kategorie:1767
Kategorija:1769	Kategorie:1769
Kategorija:Mietu fl-1772	Kategorie:Gestorben 1772
Kategorija:1779	Kategorie:1779
Kategorija:Mietu fl-1782	Kategorie:Gestorben 1782
Kategorija:Mietu fl-1787	Kategorie:Gestorben 1787
Kategorija:Mietu fl-1789	Kategorie:Gestorben 1789
Kategorija:Mietu fl-1790	Kategorie:Gestorben 1790
Kategorija:1778	Kategorie:1778
Kategorija:Mużika popolari	Kategorie:Weltmusik
Mudell:Artiklu prinċipali	Vorlage:Hauptartikel
Kategorija:Mudelli ta' kampjonati bl-eliminatorji	Kategorie:Vorlage:Turnierplan
Mudell:Plejers fit-tim tal-futbol/tmiem	Vorlage:Football squad end
Kategorija:Avvenimenti sportivi	Kategorie:Sportveranstaltung
Kategorija:It-Tieni Gwerra Dinjija	Kategorie:Zweiter Weltkrieg
Kategorija:L-Ewwel Gwerra Dinjija	Kategorie:Erster Weltkrieg
Kategorija:Plejers ta' AC Milan	Kategorie:Fußballspieler (AC Mailand)
Mudell:L-Ewwel fir-Rankings Mondjali tal-FIFA	Vorlage:Zeitleiste FIFA-Weltrangliste
Kategorija:Logħob tal-mejda	Kategorie:Brettspiel
Kategorija:Mudelli ta' ċitazzjoni tas-sorsi	Kategorie:Vorlage:Zitation
Kategorija:UC Sampdoria	Kategorie:Sampdoria Genua
Mudell:Tim ta' FC Bayern Munich	Vorlage:Navigationsleiste Kader des FC Bayern München
Kategorija:Klabbs tal-futbol Albaniżi	Kategorie:Albanischer Fußballverein
Kategorija:Klabbs tal-futbol Bjelorussi	Kategorie:Weißrussischer Fußballverein
Kategorija:Klabbs tal-futbol Latvjani	Kategorie:Lettischer Fußballverein
Kategorija:Klabbs tal-futbol Maltin	Kategorie:Maltesischer Fußballverein
Mudell:Round8	Vorlage:Turnierplan8-ohne-Datum
Mudell:Tim ta' Chelsea FC	Vorlage:Navigationsleiste Kader des FC Chelsea
Kategorija:Mietu fl-1937	Kategorie:Gestorben 1937
Kategorija:Mietu fl-1950	Kategorie:Gestorben 1950
Kategorija:Angola	Kategorie:Angola
Kategorija:Libja	Kategorie:Libyen
Kategorija:Marokk	Kategorie:Marokko
Kategorija:1480	Kategorie:1480
Kategorija:Mietu fl-1595	Kategorie:Gestorben 1595
Kategorija:Mietu fl-1597	Kategorie:Gestorben 1597
Kategorija:1610	Kategorie:1610
Kategorija:Mietu fl-1610	Kategorie:Gestorben 1610
Kategorija:Unuri u trofej sportivi	Kategorie:Sportliche Auszeichnung
Kategorija:Mietu fl-2011	Kategorie:Gestorben 2011
Kategorija:Mietu fl-1546	Kategorie:Gestorben 1546
Kategorija:1724	Kategorie:1724
Kategorija:1748	Kategorie:1748
Kategorija:1749	Kategorie:1749
Kategorija:1750	Kategorie:1750
Kategorija:Mietu fl-1750	Kategorie:Gestorben 1750
Kategorija:1756	Kategorie:1756
Kategorija:1757	Kategorie:1757
Kategorija:1758	Kategorie:1758
Kategorija:1759	Kategorie:1759
Kategorija:1760	Kategorie:1760
Kategorija:1770	Kategorie:1770
Kategorija:1772	Kategorie:1772
Kategorija:1773	Kategorie:1773
Kategorija:1782	Kategorie:1782
Kategorija:1786	Kategorie:1786
Kategorija:1791	Kategorie:1791
Kategorija:Mietu fl-1791	Kategorie:Gestorben 1791
Kategorija:1792	Kategorie:1792
Kategorija:Mietu fl-1792	Kategorie:Gestorben 1792
Kategorija:1794	Kategorie:1794
Kategorija:1801	Kategorie:1801
Kategorija:1803	Kategorie:1803
Kategorija:1804	Kategorie:1804
Kategorija:Mietu fl-1804	Kategorie:Gestorben 1804
Kategorija:1807	Kategorie:1807
Kategorija:Mietu fl-1807	Kategorie:Gestorben 1807
Kategorija:1809	Kategorie:1809
Kategorija:1813	Kategorie:1813
Kategorija:1815	Kategorie:1815
Kategorija:1818	Kategorie:1818
Kategorija:Mietu fl-1818	Kategorie:Gestorben 1818
Kategorija:Mietu fl-1821	Kategorie:Gestorben 1821
Kategorija:1827	Kategorie:1827
Kategorija:Mietu fl-1828	Kategorie:Gestorben 1828
Kategorija:1830	Kategorie:1830
Kategorija:Mietu fl-1832	Kategorie:Gestorben 1832
Kategorija:1835	Kategorie:1835
Kategorija:1840	Kategorie:1840
Kategorija:1842	Kategorie:1842
Kategorija:Mietu fl-1842	Kategorie:Gestorben 1842
Kategorija:1846	Kategorie:1846
Kategorija:1847	Kategorie:1847
Kategorija:Mietu fl-1847	Kategorie:Gestorben 1847
Kategorija:1848	Kategorie:1848
Kategorija:1849	Kategorie:1849
Kategorija:1852	Kategorie:1852
Kategorija:1853	Kategorie:1853
Kategorija:1854	Kategorie:1854
Kategorija:1859	Kategorie:1859
Kategorija:Mietu fl-1859	Kategorie:Gestorben 1859
Kategorija:1860	Kategorie:1860
Kategorija:1861	Kategorie:1861
Kategorija:Mietu fl-1861	Kategorie:Gestorben 1861
Kategorija:1862	Kategorie:1862
Kategorija:1864	Kategorie:1864
Kategorija:1866	Kategorie:1866
Kategorija:1869	Kategorie:1869
Kategorija:Mietu fl-1869	Kategorie:Gestorben 1869
Kategorija:1870	Kategorie:1870
Kategorija:1871	Kategorie:1871
Kategorija:1872	Kategorie:1872
Kategorija:Mietu fl-1873	Kategorie:Gestorben 1873
Kategorija:1874	Kategorie:1874
Kategorija:1875	Kategorie:1875
Kategorija:1876	Kategorie:1876
Kategorija:1877	Kategorie:1877
Kategorija:1879	Kategorie:1879
Kategorija:1880	Kategorie:1880
Kategorija:1881	Kategorie:1881
Kategorija:1882	Kategorie:1882
Kategorija:1883	Kategorie:1883
Kategorija:1884	Kategorie:1884
Kategorija:1885	Kategorie:1885
Kategorija:1886	Kategorie:1886
Kategorija:1887	Kategorie:1887
Kategorija:1889	Kategorie:1889
Kategorija:1890	Kategorie:1890
Kategorija:Mietu fl-1890	Kategorie:Gestorben 1890
Kategorija:1891	Kategorie:1891
Kategorija:1892	Kategorie:1892
Kategorija:1893	Kategorie:1893
Kategorija:Mietu fl-1893	Kategorie:Gestorben 1893
Kategorija:1894	Kategorie:1894
Kategorija:Mietu fl-1894	Kategorie:Gestorben 1894
Kategorija:1895	Kategorie:1895
Kategorija:Mietu fl-1895	Kategorie:Gestorben 1895
Kategorija:1897	Kategorie:1897
Kategorija:Mietu fl-1897	Kategorie:Gestorben 1897
Kategorija:Mietu fl-1898	Kategorie:Gestorben 1898
Kategorija:1899	Kategorie:1899
Kategorija:Mietu fl-1900	Kategorie:Gestorben 1900
Kategorija:Mietu fl-1901	Kategorie:Gestorben 1901
Kategorija:Mietu fl-1905	Kategorie:Gestorben 1905
Kategorija:Mietu fl-1915	Kategorie:Gestorben 1915
Kategorija:Mietu fl-1916	Kategorie:Gestorben 1916
Kategorija:Mietu fl-1917	Kategorie:Gestorben 1917
Kategorija:Mietu fl-1918	Kategorie:Gestorben 1918
Kategorija:Mietu fl-1920	Kategorie:Gestorben 1920
Kategorija:Mietu fl-1921	Kategorie:Gestorben 1921
Kategorija:Mietu fl-1925	Kategorie:Gestorben 1925
Kategorija:Mietu fl-1926	Kategorie:Gestorben 1926
Kategorija:Mietu fl-1927	Kategorie:Gestorben 1927
Kategorija:Mietu fl-1935	Kategorie:Gestorben 1935
Kategorija:Mietu fl-1936	Kategorie:Gestorben 1936
Kategorija:Mietu fl-1939	Kategorie:Gestorben 1939
Kategorija:Mietu fl-1940	Kategorie:Gestorben 1940
Kategorija:Mietu fl-1954	Kategorie:Gestorben 1954
Kategorija:1961	Kategorie:1961
Kategorija:1964	Kategorie:1964
Kategorija:Mietu fl-1964	Kategorie:Gestorben 1964
Kategorija:1965	Kategorie:1965
Kategorija:1966	Kategorie:1966
Kategorija:1967	Kategorie:1967
Kategorija:Mietu fl-1967	Kategorie:Gestorben 1967
Kategorija:Mietu fl-1968	Kategorie:Gestorben 1968
Kategorija:1969	Kategorie:1969
Kategorija:1970	Kategorie:1970
Kategorija:Mietu fl-1970	Kategorie:Gestorben 1970
Kategorija:Mietu fl-1971	Kategorie:Gestorben 1971
Kategorija:1972	Kategorie:1972
Kategorija:Mietu fl-1972	Kategorie:Gestorben 1972
Kategorija:1973	Kategorie:1973
Kategorija:Mietu fl-1973	Kategorie:Gestorben 1973
Kategorija:1974	Kategorie:1974
Kategorija:1975	Kategorie:1975
Kategorija:1976	Kategorie:1976
Kategorija:Mietu fl-1977	Kategorie:Gestorben 1977
Kategorija:1978	Kategorie:1978
Kategorija:1979	Kategorie:1979
Kategorija:1980	Kategorie:1980
Kategorija:1981	Kategorie:1981
Kategorija:1982	Kategorie:1982
Kategorija:Mietu fl-1982	Kategorie:Gestorben 1982
Kategorija:1983	Kategorie:1983
Kategorija:Mietu fl-1983	Kategorie:Gestorben 1983
Kategorija:1984	Kategorie:1984
Kategorija:Mietu fl-1984	Kategorie:Gestorben 1984
Kategorija:1985	Kategorie:1985
Kategorija:1986	Kategorie:1986
Kategorija:1987	Kategorie:1987
Kategorija:Mietu fl-1987	Kategorie:Gestorben 1987
Kategorija:1988	Kategorie:1988
Kategorija:1989	Kategorie:1989
Kategorija:Mietu fl-1989	Kategorie:Gestorben 1989
Kategorija:1990	Kategorie:1990
Kategorija:Mietu fl-1990	Kategorie:Gestorben 1990
Kategorija:1991	Kategorie:1991
Kategorija:1992	Kategorie:1992
Kategorija:1993	Kategorie:1993
Kategorija:1994	Kategorie:1994
Kategorija:1995	Kategorie:1995
Kategorija:Mietu fl-1995	Kategorie:Gestorben 1995
Kategorija:Fußball-Bundesliga	Kategorie:Fußball-Bundesliga
Kategorija:1996	Kategorie:1996
Kategorija:Mietu fl-1996	Kategorie:Gestorben 1996
Kategorija:1997	Kategorie:1997
Kategorija:Mietu fl-1997	Kategorie:Gestorben 1997
Kategorija:1999	Kategorie:1999
Kategorija:2000	Kategorie:2000
Kategorija:Mietu fl-2000	Kategorie:Gestorben 2000
Kategorija:2001	Kategorie:2001
Kategorija:Mietu fl-2001	Kategorie:Gestorben 2001
Kategorija:2002	Kategorie:2002
Kategorija:Mietu fl-2002	Kategorie:Gestorben 2002
Kategorija:Mietu fl-2003	Kategorie:Gestorben 2003
Kategorija:2004	Kategorie:2004
Kategorija:Mietu fl-2004	Kategorie:Gestorben 2004
Kategorija:2005	Kategorie:2005
Kategorija:2006	Kategorie:2006
Kategorija:Mietu fl-2006	Kategorie:Gestorben 2006
Kategorija:2007	Kategorie:2007
Kategorija:2008	Kategorie:2008
Kategorija:2009	Kategorie:2009
Kategorija:2010	Kategorie:2010
Kategorija:2011	Kategorie:2011
Kategorija:Ajruporti skont il-pajjiż	Kategorie:Flughafen nach Staat
Kategorija:Pajjiżi interkjużi	Kategorie:Binnenstaat
Kategorija:Politika ta' Malta	Kategorie:Politik (Malta)
Kategorija:Ġurnalisti Franċiżi	Kategorie:Journalist (Frankreich)
Kategorija:Grawnds tal-futbol fl-Italja	Kategorie:Fußballstadion in Italien
Kategorija:Futbol fil-Gambja	Kategorie:Fußball in Gambia
Kategorija:Futbol fil-Greċja	Kategorie:Fußball in Griechenland
Kategorija:Futbol fin-Niġerja	Kategorie:Fußball in Nigeria
Kategorija:Futbol fl-Afrika t'Isfel	Kategorie:Fußball in Südafrika
Kategorija:Futbol fil-Latvja	Kategorie:Fußball in Lettland
Kategorija:Futbol fir-Rumanija	Kategorie:Fußball in Rumänien
Kategorija:Futbol fil-Litwanja	Kategorie:Fußball in Litauen
Kategorija:Futbol fil-Montenegro	Kategorie:Fußball in Montenegro
Kategorija:Futbol f'Malta	Kategorie:Fußball in Malta
Kategorija:Futbol fl-Istati Uniti	Kategorie:Fußball in den Vereinigten Staaten
Kategorija:Futbol fil-Belġju	Kategorie:Fußball in Belgien
Kategorija:Futbol fil-Bożnija u Ħerżegovina	Kategorie:Fußball in Bosnien und Herzegowina
Kategorija:Futbol fil-Bulgarija	Kategorie:Fußball in Bulgarien
Kategorija:Futbol fis-Serbja	Kategorie:Fußball in Serbien
Kategorija:Futbol fl-Unjoni Sovjetika	Kategorie:Fußball in der Sowjetunion
Kategorija:Futbol fl-Iżvizzera	Kategorie:Fussball in der Schweiz
Kategorija:Futbol fl-Iskozja	Kategorie:Fußball in Schottland
Kategorija:Futbol fis-Slovakkja	Kategorie:Fußball in der Slowakei
Kategorija:Futbol fl-Arġentina	Kategorie:Fußball in Argentinien
Kategorija:Futbol fl-Iżlanda	Kategorie:Fußball in Island
Kategorija:Futbol fl-Albanija	Kategorie:Fußball in Albanien
Kategorija:Futbol fl-Angola	Kategorie:Fußball in Angola
Kategorija:Futbol fl-Estonja	Kategorie:Fußball in Estland
Kategorija:Futbol fl-Awstralja	Kategorie:Fußball in Australien
Kategorija:Futbol fl-Iżrael	Kategorie:Fußball in Israel
Kategorija:Futbol fiċ-Ċina	Kategorie:Fußball in China
Kategorija:Futbol fil-Kamerun	Kategorie:Fußball in Kamerun
Kategorija:Futbol fil-Kosta tal-Avorju	Kategorie:Fußball in der Elfenbeinküste
Kategorija:Futbol f'Ċipru	Kategorie:Fußball in Zypern
Mudell:Utent be	Vorlage:User be
Mudell:Utent ga-2	Vorlage:User ga-2
Mudell:Utent hu-1	Vorlage:User hu-1
Kategorija:Presidenti tar-Royal Society	Kategorie:Präsident der Royal Society
Mudell:Utent ru-1	Vorlage:User ru-1
Mudell:Utent tr-1	Vorlage:User tr-1
Mudell:Utent uk-4	Vorlage:User uk-4
Mudell:Utent zh-1	Vorlage:User zh-1
Kategorija:Mużiċisti skont in-nazzjonalità	Kategorie:Musiker nach Staat
Kategorija:Skulturi skont in-nazzjonalità tagħhom	Kategorie:Bildhauer nach Staat
Kategorija:Storja ta' Malta	Kategorie:Geschichte Maltas
Kategorija:Futbol fil-Gana	Kategorie:Fußball in Ghana
Kategorija:Futbol fl-Olanda	Kategorie:Fußball in den Niederlanden
Kategorija:Futbol fin-Norveġja	Kategorie:Fußball in Norwegen
Kategorija:Futbol fil-Ġermanja	Kategorie:Fußball in Deutschland
Kategorija:Futbol fil-Bjelorussja	Kategorie:Fußball in Weißrussland
Kategorija:Futbol fl-Irlanda ta' Fuq	Kategorie:Fußball in Nordirland
Kategorija:Futbol fil-Brażil	Kategorie:Fußball in Brasilien
Kategorija:Futbol fl-Armenja	Kategorie:Fußball in Armenien
Kategorija:Futbol fl-Ażerbajġan	Kategorie:Fußball in Aserbaidschan
Kategorija:Futbol fl-Awstrija	Kategorie:Fußball in Österreich
Kategorija:Futbol fl-Urugwaj	Kategorie:Fußball in Uruguay
Kategorija:Futbol fl-Italja	Kategorie:Fußball in Italien
Kategorija:Futbol fl-Ingilterra	Kategorie:Fußball in England
Kategorija:Futbol fir-Repubblika Ċeka	Kategorie:Fußball in Tschechien
Kategorija:Futbol fil-Każakistan	Kategorie:Fußball in Kasachstan
Kategorija:Futbol fil-Kolombja	Kategorie:Fußball in Kolumbien
Kategorija:Futbol fit-Turkija	Kategorie:Fußball in der Türkei
Kategorija:Futbol fil-Portugall	Kategorie:Fußball in Portugal
Kategorija:Futbol fl-Ungerija	Kategorie:Fußball in Ungarn
Mudell:TwoLegResult	Vorlage:TwoLegResult
Kategorija:Festival tal-Eurovision	Kategorie:Eurovision Song Contest
Kategorija:Kowċis Arġentini	Kategorie:Fußballtrainer (Argentinien)
Kategorija:Kowċis Awstrijaċi	Kategorie:Fußballtrainer (Österreich)
Kategorija:Kowċis Belġjani	Kategorie:Fußballtrainer (Belgien)
Kategorija:Kowċis Brażiljani	Kategorie:Fußballtrainer (Brasilien)
Kategorija:Kowċis Ingliżi	Kategorie:Fußballtrainer (England)
Kategorija:Kowċis Skoċċiżi	Kategorie:Fußballtrainer (Schottland)
Kategorija:Teatru	Kategorie:Theater
Kategorija:Kowċis Kroati	Kategorie:Fußballtrainer (Kroatien)
Kategorija:Kowċis Ġermaniżi	Kategorie:Fußballtrainer (Deutschland)
Kategorija:Kowċis Maltin	Kategorie:Fußballtrainer (Malta)
Kategorija:Kowċis Rumeni	Kategorie:Fußballtrainer (Rumänien)
Kategorija:Kowċis Spanjoli	Kategorie:Fußballtrainer (Spanien)
Kategorija:Futbolers Albaniżi	Kategorie:Fußballspieler (Albanien)
Kategorija:Futbolers Angoliżi	Kategorie:Fußballspieler (Angola)
Kategorija:Futbolers Arġentini	Kategorie:Fußballspieler (Argentinien)
Kategorija:Futbolers Armeni	Kategorie:Fußballspieler (Armenien)
Kategorija:Futbolers Awstraljani	Kategorie:Fußballspieler (Australien)
Kategorija:Futbolers Awstrijaċi	Kategorie:Fußballspieler (Österreich)
Kategorija:Futbolers Bożnijaċi	Kategorie:Fußballspieler (Bosnien und Herzegowina)
Kategorija:Futbolers Brażiljani	Kategorie:Fußballspieler (Brasilien)
Kategorija:Futbolers Ingliżi	Kategorie:Fußballspieler (England)
Mudell:Newtrali	Vorlage:Neutral
Kategorija:Utenti nl	Kategorie:User nl
Kategorija:Utenti nn-3	Kategorie:User nn-3
Kategorija:Utenti no-2	Kategorie:User no-2
Kategorija:Utenti no	Kategorie:User no
Kategorija:Utenti zh-1	Kategorie:User zh-1
Kategorija:Armenja	Kategorie:Armenien
Kategorija:Finanza	Kategorie:Finanzierung
Kategorija:Diskografiji	Kategorie:Diskografie
Kategorija:Kompetizzjonijiet tal-futbol	Kategorie:Fußballwettbewerb
Kategorija:Sports għal persuni b'diżabbilità	Kategorie:Behindertensport
Kategorija:Sports ta' studenti	Kategorie:Hochschulsport
Kategorija:Televiżjoni	Kategorie:Fernsehen
Kategorija:Prim Ministri ta' Malta	Kategorie:Premierminister (Malta)
Kategorija:Mietu fl-1945	Kategorie:Gestorben 1945
Kategorija:Mietu fl-1963	Kategorie:Gestorben 1963
Kategorija:1832	Kategorie:1832
Kategorija:Mietu fl-1930	Kategorie:Gestorben 1930
Kategorija:1822	Kategorie:1822
Kategorija:Skulturi	Kategorie:Bildhauer
Kategorija:Seklu 14	Kategorie:14. Jahrhundert
Kategorija:Sekli	Kategorie:Jahrhundert
Kategorija:Seklu 13	Kategorie:13. Jahrhundert
Kategorija:Seklu 16	Kategorie:16. Jahrhundert
Kategorija:Seklu 12	Kategorie:12. Jahrhundert
Kategorija:Seklu 18	Kategorie:18. Jahrhundert
Kategorija:Kompożituri Russi	Kategorie:Russischer Komponist
Kategorija:Kompożituri Franċiżi	Kategorie:Französischer Komponist
Kategorija:Kompożituri Barokki	Kategorie:Komponist (Barock)
Kategorija:Kompożituri Pollakki	Kategorie:Polnischer Komponist
Kategorija:Kompożituri Ġermaniżi	Kategorie:Deutscher Komponist
Kategorija:Kompożituri Awstrijaċi	Kategorie:Österreichischer Komponist
Kategorija:Mużiċisti Pollakki	Kategorie:Polnischer Musiker
Kategorija:Skulturi Taljani	Kategorie:Italienischer Bildhauer
Kategorija:Mużiċisti Norveġiżi	Kategorie:Norwegischer Musiker
Kategorija:Mużiċisti Daniżi	Kategorie:Dänischer Musiker
Kategorija:Mużiċisti Russi	Kategorie:Russischer Musiker
Kategorija:Mużiċisti Żvediżi	Kategorie:Schwedischer Musiker
Kategorija:Mużiċisti Irlandiżi	Kategorie:Irischer Musiker
Kategorija:Mużiċisti Brittaniċi	Kategorie:Britischer Musiker
Kategorija:Mużiċisti Taljani	Kategorie:Musiker (Italien)
Kategorija:Mużiċisti Ġeorġjani	Kategorie:Musiker (Georgien)
Kategorija:Mużiċisti Kanadiżi	Kategorie:Kanadischer Musiker
Kategorija:Mużiċisti Franċiżi	Kategorie:Französischer Musiker
Kategorija:1829	Kategorie:1829
Kategorija:Kompożituri Rumeni	Kategorie:Rumänischer Komponist
Kategorija:Kompożituri Taljani	Kategorie:Italienischer Komponist
Kategorija:Mużiċisti Ġermaniżi	Kategorie:Deutscher Musiker
Kategorija:Politiċi Maltin	Kategorie:Politiker (Malta)
Kategorija:Politiċi Taljani	Kategorie:Politiker (Italien)
Kategorija:Politiċi Franċiżi	Kategorie:Politiker (Frankreich)
Kategorija:Bavarja	Kategorie:Bayern
Kategorija:Futbolers Niġerjani	Kategorie:Fußballspieler (Nigeria)
Kategorija:Futbolers Rumeni	Kategorie:Fußballspieler (Rumänien)
Kategorija:Futbolers Bulgari	Kategorie:Fußballspieler (Bulgarien)
Kategorija:Futbolers Żvediżi	Kategorie:Fußballspieler (Schweden)
Kategorija:Futbolers Skoċċiżi	Kategorie:Fußballspieler (Schottland)
Kategorija:.NET	Kategorie:.NET
Kategorija:Futbolers Ekwadorjani	Kategorie:Fußballspieler (Ecuador)
Kategorija:Futbolers Urugwajani	Kategorie:Fußballspieler (Uruguay)
Kategorija:Futbolers Eġizzjani	Kategorie:Fußballspieler (Ägypten)
Kategorija:Futbolers Ċiniżi	Kategorie:Fußballspieler (China)
Kategorija:Futbolers Franċiżi	Kategorie:Fußballspieler (Frankreich)
Kategorija:Teorija tal-logħob	Kategorie:Spieltheorie
Kategorija:1789	Kategorie:1789
Kategorija:Mietu fl-1809	Kategorie:Gestorben 1809
Kategorija:1821	Kategorie:1821
Kategorija:1828	Kategorie:1828
Kategorija:1841	Kategorie:1841
Kategorija:1867	Kategorie:1867
Kategorija:1873	Kategorie:1873
Kategorija:1878	Kategorie:1878
Kategorija:1896	Kategorie:1896
Kategorija:1963	Kategorie:1963
Kategorija:Mietu fl-1981	Kategorie:Gestorben 1981
Kategorija:Mietu fl-1999	Kategorie:Gestorben 1999
Kategorija:2012	Kategorie:2012
Kategorija:Sportivi Sud-Koreani	Kategorie:Sportler (Südkorea)
Kategorija:Imprendituri Amerikani	Kategorie:Unternehmer (Vereinigte Staaten)
Kategorija:Futbolers Torok	Kategorie:Fußballspieler (Türkei)
Kategorija:Futbolers Montenegrini	Kategorie:Fußballspieler (Montenegro)
Kategorija:Futbolers Żvizzeri	Kategorie:Fußballspieler (Schweiz)
Kategorija:Futbolers Spanjoli	Kategorie:Fußballspieler (Spanien)
Kategorija:Futbolers Ungeriżi	Kategorie:Fußballspieler (Ungarn)
Kategorija:Futbolers Serbi	Kategorie:Fußballspieler (Serbien)
Kategorija:Futbolers Taljani	Kategorie:Fußballspieler (Italien)
Kategorija:Futbolers Daniżi	Kategorie:Fußballspieler (Dänemark)
Kategorija:Futbolers Galliċi	Kategorie:Fußballspieler (Wales)
Kategorija:Futbolers Nord-Irlandiżi	Kategorie:Fußballspieler (Nordirland)
Kategorija:Futbolers Irlandiżi	Kategorie:Fußballspieler (Irland)
Kategorija:Futbolers Kolombjani	Kategorie:Fußballspieler (Kolumbien)
Kategorija:Futbolers Kroati	Kategorie:Fußballspieler (Kroatien)
Kategorija:Futbolers Portugiżi	Kategorie:Fußballspieler (Portugal)
Kategorija:Denominazzjonijiet Kristjani	Kategorie:Kirche (Organisation)
Kategorija:Seklu 15	Kategorie:15. Jahrhundert
Kategorija:Mietu fis-seklu 16	Kategorie:Gestorben (16. Jahrhundert)
Kategorija:Mietu fis-seklu 17	Kategorie:Gestorben (17. Jahrhundert)
Kategorija:Mietu fis-seklu 18	Kategorie:Gestorben (18. Jahrhundert)
Kategorija:Mietu fis-seklu 19	Kategorie:Gestorben (19. Jahrhundert)
Kategorija:Mietu fis-seklu 20	Kategorie:Gestorben (20. Jahrhundert)
Kategorija:Mietu fis-seklu 21	Kategorie:Gestorben (21. Jahrhundert)
Kategorija:Futbol fi New Zealand	Kategorie:Fußball in Neuseeland
Kategorija:Futbol fil-Messiku	Kategorie:Fußball in Mexiko
Kategorija:Futbol fl-Iżvezja	Kategorie:Fußball in Schweden
Kategorija:Futbol fl-Ukrajna	Kategorie:Fußball in der Ukraine
Kategorija:Futbol fil-Kroazja	Kategorie:Fußball in Kroatien
Kategorija:Futbol fi Franza	Kategorie:Fußball in Frankreich
Kategorija:Ġeorġja	Kategorie:Georgien
Kategorija:Mużiċisti Żvizzeri	Kategorie:Schweizer Musiker
Kategorija:Mużiċisti Armeni	Kategorie:Armenischer Musiker
Kategorija:Mużiċisti Ażerbajġani	Kategorie:Musiker (Aserbaidschan)
Kategorija:Mużiċisti Iżraeljani	Kategorie:Israelischer Musiker
Kategorija:Futbolers Ganiżi	Kategorie:Fußballspieler (Ghana)
Kategorija:1727	Kategorie:1727
Kategorija:1744	Kategorie:1744
Kategorija:1808	Kategorie:1808
Kategorija:1824	Kategorie:1824
Kategorija:Mietu fl-1835	Kategorie:Gestorben 1835
Kategorija:Mietu fl-1868	Kategorie:Gestorben 1868
Kategorija:Mietu fl-1888	Kategorie:Gestorben 1888
Kategorija:Mietu fl-1933	Kategorie:Gestorben 1933
Kategorija:Mietu fl-1961	Kategorie:Gestorben 1961
Kategorija:1968	Kategorie:1968
Kategorija:Futbol fir-Russja	Kategorie:Fußball in Russland
Kategorija:Futbol fl-Ekwador	Kategorie:Fußball in Ecuador
Kategorija:Futbol fl-Eġittu	Kategorie:Fußball in Ägypten
Kategorija:Futbol fl-Andorra	Kategorie:Fußball in Andorra
Kategorija:Nies Maltin	Kategorie:Malteser
Kategorija:Mużiċisti Belġjani	Kategorie:Belgischer Musiker
Kategorija:Futbolers Gambjani	Kategorie:Fußballspieler (Gambia)
Kategorija:Futbolers Griegi	Kategorie:Fußballspieler (Griechenland)
Kategorija:Futbolers Sud-Afrikani	Kategorie:Fußballspieler (Südafrika)
Kategorija:Futbolers Litwani	Kategorie:Fußballspieler (Litauen)
Kategorija:Futbolers Maċedoni	Kategorie:Fußballspieler (Mazedonien)
Kategorija:Futbolers Maltin	Kategorie:Fußballspieler (Malta)
Kategorija:Futbolers Senegaliżi	Kategorie:Fußballspieler (Senegal)
Kategorija:Futbolers Iżlandiżi	Kategorie:Fußballspieler (Island)
Kategorija:Futbolers Iżraeljani	Kategorie:Fußballspieler (Israel)
Kategorija:Futbolers Kamerunjani	Kategorie:Fußballspieler (Kamerun)
Kategorija:1817	Kategorie:1817
Kategorija:1898	Kategorie:1898
Kategorija:1998	Kategorie:1998
Kategorija:Libanu	Kategorie:Libanon
Kategorija:Mietu fis-seklu 15	Kategorie:Gestorben (15. Jahrhundert)
Kategorija:Mużiċisti Iżlandiżi	Kategorie:Isländischer Musiker
Kategorija:Kompożituri Irlandiżi	Kategorie:Irischer Komponist
Kategorija:Futbolers Messikani	Kategorie:Fußballspieler (Mexiko)
Kategorija:2003	Kategorie:2003
Kategorija:Mietu fis-seklu 14	Kategorie:Gestorben (14. Jahrhundert)
Kategorija:Futbol fid-Danimarka	Kategorie:Fußball in Dänemark
Kategorija:Mudelli tal-Unjoni Ewropea	Kategorie:Vorlage:Europäische Union
Kategorija:1971	Kategorie:1971
Kategorija:Mietu fis-seklu 13	Kategorie:Gestorben (13. Jahrhundert)
Mudell:Utent de-4	Vorlage:User de-4
Kategorija:Futbol Asjatiku	Kategorie:Fußball (Asien)
Kategorija:Futbol fl-Afrika	Kategorie:Fußball (Afrika)
Kategorija:Futbol fl-Amerika t'Isfel	Kategorie:Fußball (Südamerika)
Kategorija:Futbol fl-Ewropa	Kategorie:Fußball (Europa)
Kategorija:Futbol fl-Oċeanja	Kategorie:Fußball (Australien und Ozeanien)
Kategorija:Futbol skont il-kontinent	Kategorie:Fußball nach Kontinent
Kategorija:Plejers ta' PSV Eindhoven	Kategorie:Fußballspieler (PSV Eindhoven)
Kategorija:Plejers ta' CA Osasuna	Kategorie:Fußballspieler (CA Osasuna)
Kategorija:Plejers ta' AFC Ajax	Kategorie:Fußballspieler (Ajax Amsterdam)
Kategorija:Plejers ta' MSV Duisburg	Kategorie:Fußballspieler (MSV Duisburg)
Kategorija:Plejers ta' Empoli FC	Kategorie:Fußballspieler (FC Empoli)
Kategorija:Plejers ta' Eintracht Braunschweig	Kategorie:Fußballspieler (Eintracht Braunschweig)
Kategorija:Futbolers fil-Bulgarija skont il-klabb	Kategorie:Fußballspieler (Bulgarien) nach Verein
Kategorija:Plejers ta' Red Star Belgrade	Kategorie:Fußballspieler (Roter Stern Belgrad)
Kategorija:Plejers ta' FC Basel	Kategorie:Fußballspieler (FC Basel)
Kategorija:Plejers ta' Bayer 04 Leverkusen	Kategorie:Fußballspieler (Bayer 04 Leverkusen)
Kategorija:Plejers ta' VfL Bochum	Kategorie:Fußballspieler (VfL Bochum)
Kategorija:Plejers ta' Borussia Dortmund	Kategorie:Fußballspieler (Borussia Dortmund)
Kategorija:Plejers ta' Piacenza Calcio	Kategorie:Fußballspieler (Piacenza Calcio 1919)
Kategorija:Plejers ta' Torino FC	Kategorie:Fußballspieler (FC Turin)
Kategorija:Plejers ta' Genoa CFC	Kategorie:Fußballspieler (CFC Genua)
Kategorija:Plejers ta' Racing de Santander	Kategorie:Fußballspieler (Racing Santander)
Kategorija:Plejers ta' Real Valladolid	Kategorie:Fußballspieler (Real Valladolid)
Kategorija:Plejers ta' Sporting de Gijón	Kategorie:Fußballspieler (Sporting Gijón)
Kategorija:Plejers ta' Real Sociedad	Kategorie:Fußballspieler (Real Sociedad San Sebastián)
Kategorija:Plejers ta' RCD Mallorca	Kategorie:Fußballspieler (RCD Mallorca)
Kategorija:Plejers ta' Recreativo de Huelva	Kategorie:Fußballspieler (Recreativo Huelva)
Kategorija:Plejers ta' FC Zürich	Kategorie:Fußballspieler (FC Zürich)
Kategorija:Plejers ta' UC Sampdoria	Kategorie:Fußballspieler (Sampdoria Genua)
Kategorija:Plejers ta' Santos Futebol Clube	Kategorie:Fußballspieler (FC Santos)
Kategorija:Plejers ta' São Paulo Futebol Clube	Kategorie:Fußballspieler (FC São Paulo)
Kategorija:Plejers ta' Sporting Clube de Portugal	Kategorie:Fußballspieler (Sporting Lissabon)
Kategorija:Plejers ta' Stoke City FC	Kategorie:Fußballspieler (Stoke City)
Kategorija:Plejers ta' VfB Stuttgart	Kategorie:Fußballspieler (VfB Stuttgart)
Kategorija:Plejers ta' Sheffield Wednesday FC	Kategorie:Fußballspieler (Sheffield Wednesday)
Kategorija:Plejers ta' Grêmio Foot-Ball Porto Alegrense	Kategorie:Fußballspieler (Grêmio Porto Alegre)
Kategorija:Plejers ta' KAA Gent	Kategorie:Fußballspieler (KAA Gent)
Kategorija:Plejers ta' Fluminense Football Club	Kategorie:Fußballspieler (Fluminense FC)
Kategorija:Plejers ta' Fulham FC	Kategorie:Fußballspieler (FC Fulham)
Kategorija:Plejers ta' FC Carl Zeiss Jena	Kategorie:Fußballspieler (FC Carl Zeiss Jena)
Kategorija:Plejers ta' Cagliari Calcio	Kategorie:Fußballspieler (Cagliari Calcio)
Kategorija:Plejers ta' 1. FC Kaiserslautern	Kategorie:Fußballspieler (1. FC Kaiserslautern)
Kategorija:Futbolers fi Spanja skont il-klabb	Kategorie:Fußballspieler (Spanien) nach Verein
Kategorija:Futbolers fl-Iskozja skont il-klabb	Kategorie:Fußballspieler (Schottland) nach Verein
Kategorija:Futbolers fil-Portugall skont il-klabb	Kategorie:Fußballspieler (Portugal) nach Verein
Kategorija:Futbolers fl-Ungerija skont il-klabb	Kategorie:Fußballspieler (Ungarn) nach Verein
Kategorija:Futbolers fir-Russja skont il-klabb	Kategorie:Fußballspieler (Russland) nach Verein
Kategorija:Futbolers fir-Rumanija skont il-klabb	Kategorie:Fußballspieler (Rumänien) nach Verein
Kategorija:Plejers ta' Cruzeiro Esporte Clube	Kategorie:Fußballspieler (Cruzeiro Belo Horizonte)
Kategorija:Imwiet skont is-sena	Kategorie:Person nach Todesjahrhundert
Kategorija:Plejers ta' US Lecce	Kategorie:Fußballspieler (US Lecce)
Kategorija:San Marino	Kategorie:San Marino
Kategorija:Liechtenstein	Kategorie:Liechtenstein
Kategorija:Andorra	Kategorie:Andorra
Kategorija:Serbja	Kategorie:Serbien
Kategorija:Pajjiżi skont il-kontinent	Kategorie:Staat nach Kontinent
Kategorija:Albanija	Kategorie:Albanien
Kategorija:Pajjiżi tal-Oċeanja	Kategorie:Staat in Australien und Ozeanien
Kategorija:Pajjiżi tal-Amerika ta' Fuq	Kategorie:Staat in Nordamerika
Kategorija:Klabbs tal-futbol Litwani	Kategorie:Litauischer Fußballverein
Kategorija:Plejers ta' Modena FC	Kategorie:Fußballspieler (FC Modena)
Kategorija:Plejers ta' SSC Napoli	Kategorie:Fußballspieler (SSC Neapel)
Kategorija:Plejers ta' Calcio Padova	Kategorie:Fußballspieler (Calcio Padova)
Kategorija:Plejers ta' Perugia Calcio	Kategorie:Fußballspieler (AC Perugia Calcio)
Kategorija:Plejers ta' Getafe CF	Kategorie:Fußballspieler (FC Getafe)
Kategorija:Plejers ta' Villarreal CF	Kategorie:Fußballspieler (FC Villarreal)
Kategorija:Plejers ta' Málaga CF	Kategorie:Fußballspieler (FC Málaga)
Kategorija:Plejers ta' Novara Calcio	Kategorie:Fußballspieler (Novara Calcio)
Kategorija:Plejers ta' Newcastle United FC	Kategorie:Fußballspieler (Newcastle United)
Kategorija:Plejers ta' Hannover 96	Kategorie:Fußballspieler (Hannover 96)
Kategorija:Plejers ta' Hertha BSC	Kategorie:Fußballspieler (Hertha BSC)
Kategorija:Plejers ta' Hellas Verona FC	Kategorie:Fußballspieler (Hellas Verona)
Kategorija:Plejers ta' West Bromwich Albion FC	Kategorie:Fußballspieler (West Bromwich Albion)
Kategorija:Rebbieħa tal-Festival tal-Eurovision	Kategorie:Gewinner des Eurovision Song Contests
Kategorija:Referis tal-futbol Ingliżi	Kategorie:Fußballschiedsrichter (England)
Kategorija:Referis tal-futbol Taljani	Kategorie:Fußballschiedsrichter (Italien)
Kategorija:Plejers ta' FC Barcelona	Kategorie:Fußballspieler (FC Barcelona)
Kategorija:Plejers ta' Valencia CF	Kategorie:Fußballspieler (FC Valencia)
Kategorija:Plejers ta' Liverpool FC	Kategorie:Fußballspieler (FC Liverpool)
Kategorija:Plejers ta' FC Bayern Munich	Kategorie:Fußballspieler (FC Bayern München)
Kategorija:Plejers ta' Manchester City FC	Kategorie:Fußballspieler (Manchester City)
Kategorija:Plejers ta' Atlético Madrid	Kategorie:Fußballspieler (Atlético Madrid)
Kategorija:Plejers ta' Arsenal FC	Kategorie:Fußballspieler (FC Arsenal)
Kategorija:Plejers ta' FC Porto	Kategorie:Fußballspieler (FC Porto)
Kategorija:Plejers ta' AS Roma	Kategorie:Fußballspieler (AS Rom)
Kategorija:Kampjonati tal-futbol nazzjonali	Kategorie:Fußballwettbewerb für Vereinsmannschaften
Kategorija:Timijiet nazzjonali tal-futbol	Kategorie:Fußballnationalmannschaft
Kategorija:Rivisti tal-logħob	Kategorie:Spielezeitschrift
Kategorija:Reġjuni tal-Ewropa	Kategorie:Region in Europa
Kategorija:Oċeani	Kategorie:Ozean
Kategorija:Antropoloġija	Kategorie:Anthropologie
Kategorija:Bliet tal-Veneżwela	Kategorie:Ort in Venezuela
Mudell:Tim ta' Inter Milan	Vorlage:Navigationsleiste Kader von Inter Mailand
Kategorija:Repubbliki	Kategorie:Republik
Kategorija:Chelsea FC	Kategorie:FC Chelsea
Kategorija:Arsenal FC	Kategorie:FC Arsenal
Kategorija:Liverpool FC	Kategorie:FC Liverpool
Kategorija:Inter Milan	Kategorie:Inter Mailand
Kategorija:Manchester United FC	Kategorie:Manchester United
Kategorija:AC Milan	Kategorie:AC Mailand
Kategorija:Klabbs tal-futbol Olandiżi	Kategorie:Niederländischer Fußballverein
Kategorija:Tupaja	Kategorie:Scandentia
Kategorija:Lagomorpha	Kategorie:Hasenartige
Kategorija:Proboscidea	Kategorie:Rüsseltiere
Kategorija:Hyracoidea	Kategorie:Hyracoidea
Kategorija:Kontestanti fil-Festival tal-Eurovision	Kategorie:Teilnehmer am Eurovision Song Contest
Kategorija:Pajjiżi tal-Amerika t'Isfel	Kategorie:Staat in Südamerika
Kategorija:Timijiet nazzjonali li m'għadhomx jeżistu	Kategorie:Ehemalige Fußballnationalmannschaft
Kategorija:Plejers ta' FC Vaslui	Kategorie:Fußballspieler (FC Vaslui)
Kategorija:Presidenti ta' Malta	Kategorie:Präsident (Malta)
Mudell:Utent id-4	Vorlage:User id-4
Kategorija:Klabbs tal-futbol tal-Andorra	Kategorie:Andorranischer Fußballverein
Kategorija:Analisi matematika	Kategorie:Analysis
Kategorija:Sirenia	Kategorie:Seekühe
Kategorija:Mitoloġija Griega	Kategorie:Griechische Mythologie
Kategorija:Bliet kapitali	Kategorie:Hauptstadt
Kategorija:Avvenimenti	Kategorie:Veranstaltung
Kategorija:HIV/AIDS	Kategorie:AIDS
Kategorija:Tazza Ażjatika tal-Futbol	Kategorie:Fußball-Asienmeisterschaft
Kategorija:Filatelija	Kategorie:Philatelie
Kategorija:Arkeoloġija	Kategorie:Archäologie
Kategorija:Astroloġija	Kategorie:Astrologie
Kategorija:Logħob Olimpiku tas-sajf 2008	Kategorie:Olympische Sommerspiele 2008
Kategorija:Ho Chi Minh (belt)	Kategorie:Ho-Chi-Minh-Stadt
Kategorija:Elettriċità	Kategorie:Elektrischer Strom
Kategorija:Posta	Kategorie:Postwesen
Kategorija:Utenti pl	Kategorie:User pl
Kategorija:Trasport	Kategorie:Verkehrswesen
Kategorija:Ir-Rivoluzzjoni Franċiża	Kategorie:Französische Revolution
Kategorija:Żfin	Kategorie:Tanzen
Kategorija:Sports tat-timijiet	Kategorie:Mannschaftssport
Kategorija:Teorija tal-grafi	Kategorie:Graphentheorie
Kategorija:Teorija tan-numri	Kategorie:Zahlentheorie
Kategorija:Kantanti	Kategorie:Sänger
Kategorija:Futbolers	Kategorie:Fußballspieler
Kategorija:Matematiċi	Kategorie:Mathematiker
Kategorija:Futbolers fl-Italja skont il-klabb	Kategorie:Fußballspieler (Italien) nach Verein
Kategorija:Futbolers fl-Olanda skont il-klabb	Kategorie:Fußballspieler (Niederlande) nach Verein
Kategorija:Futbolers fl-Ingilterra skont il-klabb	Kategorie:Fußballspieler (England) nach Verein
Kategorija:Futbolers skont il-klabb	Kategorie:Fußballspieler nach Verein
Kategorija:Presidenti tal-Italja	Kategorie:Staatspräsident (Italien)
Kategorija:Kompetizzjonijiet tal-futbol fil-Ġermanja	Kategorie:Fußballwettbewerb in Deutschland
Kategorija:Sportivi	Kategorie:Sportler
Kategorija:Skultura	Kategorie:Bildhauerei
Kategorija:Montenegro	Kategorie:Montenegro
Kategorija:Plejers ta' Everton FC	Kategorie:Fußballspieler (FC Everton)
Kategorija:Plejers ta' West Ham United FC	Kategorie:Fußballspieler (West Ham United)
Kategorija:Plejers ta' Manchester United FC	Kategorie:Fußballspieler (Manchester United)
Kategorija:Kampjonati Ewropej tal-Futbol 2008	Kategorie:Fußball-Europameisterschaft 2008
Kategorija:Ewropa tat-Tramuntana	Kategorie:Nordeuropa
Mudell:Utent ga-1	Vorlage:User ga-1
Kategorija:Peramelemorphia	Kategorie:Nasenbeutler
Kategorija:Kultura tal-Veneżwela	Kategorie:Kultur (Venezuela)
Kategorija:Bliet ta' Malta	Kategorie:Ort in Malta
Kategorija:Bliet tal-Vjetnam	Kategorie:Ort in Vietnam
Għajnuna:Sintassi	Hilfe:Textgestaltung
Kategorija:Bliet kapitali fl-Ewropa	Kategorie:Hauptstadt in Europa
Kategorija:Partiti politiċi ta' Malta	Kategorie:Maltesische Partei
Kategorija:Plejers ta' Djurgårdens IF Fotboll	Kategorie:Fußballspieler (Djurgårdens IF Fotbollsförening)
Roberta Metsola Tedesco Triccas	Roberta Metsola
Kategorija:Sports tal-bord	Kategorie:Brettsportart
Kategorija:Logħob tal-ballun	Kategorie:Ballspiel
Kategorija:Belt Valletta	Kategorie:Valletta
Kategorija:Ewropa tal-Punent	Kategorie:Westeuropa
Kategorija:Ewropa tan-Nofsinhar	Kategorie:Südeuropa
Kategorija:Mediterran	Kategorie:Mittelmeerraum
Kategorija:Mużiċisti Albaniżi	Kategorie:Albanischer Musiker
Kategorija:Storja tal-matematika	Kategorie:Geschichte der Mathematik
Kategorija:Gwida essenzjali tal-Wikipedija	Kategorie:Wikipedia:Tutorial
Kategorija:Etoloġi	Kategorie:Verhaltensforscher
Kategorija:Kowċis ta' Juventus FC	Kategorie:Fußballtrainer (Juventus Turin)
Kategorija:Kowċis ta' FC Barcelona	Kategorie:Fußballtrainer (FC Barcelona)
Kategorija:Kowċis ta' Real Madrid CF	Kategorie:Fußballtrainer (Real Madrid)
Kategorija:Kowċis ta' Borussia Mönchengladbach	Kategorie:Fußballtrainer (Borussia Mönchengladbach)
Kategorija:Kowċis ta' Borussia Dortmund	Kategorie:Fußballtrainer (Borussia Dortmund)
Kategorija:Kowċis ta' FC Bayern Munich	Kategorie:Fußballtrainer (FC Bayern München)
Kategorija:Klabbs tal-futbol Belġjani	Kategorie:Belgischer Fußballverein
Kategorija:L-Ewwel Diviżjoni Belġjana	Kategorie:Erste Division (Belgien)
Kategorija:Saħħa	Kategorie:Gesundheit
Kategorija:Futbolers fil-Ġermanja skont il-klabb	Kategorie:Fußballspieler (Deutschland) nach Verein
Mudell:Fussballdaten	Vorlage:Fussballdaten
Kategorija:Grawnds tal-futbol skont il-pajjiż	Kategorie:Fußballstadion nach Staat
Mudell:Staġuni tal-Premier League Malti	Vorlage:Navigationsleiste Spielzeiten Maltese Premier League
Kategorija:Klabbs tal-futbol Russi	Kategorie:Russischer Fußballverein
Kategorija:Mudelli tal-klabbs tal-futbol Ġermaniżi	Kategorie:Vorlage:Navigationsleiste Fußballkader (Deutschland)
Kategorija:Mudelli tal-klabbs tal-futbol Spanjoli	Kategorie:Vorlage:Navigationsleiste Fußballkader (Spanien)
Mudell:Utent pl-4	Vorlage:User pl-4
Kategorija:Plejers ta' US Avellino	Kategorie:Fußballspieler (AS Avellino 1912)
Kategorija:Plejers ta' Albacete Balompié	Kategorie:Fußballspieler (Albacete Balompié)
Kategorija:Plejers ta' SC Rheindorf Altach	Kategorie:Fußballspieler (SC Rheindorf Altach)
Kategorija:Plejers ta' FC Aarau	Kategorie:Fußballspieler (FC Aarau)
Kategorija:Plejers ta' Bristol City FC	Kategorie:Fußballspieler (Bristol City)
Kategorija:Plejers ta' Valletta FC	Kategorie:Fußballspieler (FC Valletta)
Kategorija:Isqfijiet Taljani	Kategorie:Liste (römisch-katholische Bischöfe in Italien)
Kategorija:Plejers ta' KS Vllaznia Shkodër	Kategorie:Fußballspieler (KS Vllaznia Shkodra)
Kategorija:Plejers ta' Chivas de Guadalajara	Kategorie:Fußballspieler (Deportivo Guadalajara)
Kategorija:Plejers ta' KRC Genk	Kategorie:Fußballspieler (KRC Genk)
Kategorija:Plejers ta' Defensor Sporting Club	Kategorie:Fußballspieler (Defensor Sporting Club)
Kategorija:Plejers ta' Beerschot AC	Kategorie:Fußballspieler (Germinal Beerschot)
Kategorija:Plejers ta' SC Kriens	Kategorie:Fußballspieler (SC Kriens)
Kategorija:Plejers ta' FC Crotone	Kategorie:Fußballspieler (FC Crotone)
Kategorija:Plejers ta' Lillestrøm SK	Kategorie:Fußballspieler (Lillestrøm SK)
Kategorija:Plejers ta' AC Lugano	Kategorie:Fußballspieler (FC Lugano)
Kategorija:Plejers ta' Lierse SK	Kategorie:Fußballspieler (Lierse SK)
Kategorija:Plejers ta' FC Lucerne	Kategorie:Fußballspieler (FC Luzern)
Kategorija:Plejers ta' Manisaspor	Kategorie:Fußballspieler (Manisaspor)
Kategorija:Plejers ta' KV Mechelen	Kategorie:Fußballspieler (KV Mechelen)
Kategorija:Plejers ta' CD Nacional	Kategorie:Fußballspieler (Nacional Funchal)
The Narrative	The Narrative
Kategorija:Plejers ta' SK Rapid Wien	Kategorie:Fußballspieler (SK Rapid Wien)
Kategorija:Plejers ta' Rimini Calcio FC	Kategorie:Fußballspieler (AC Rimini 1912)
Kategorija:Plejers ta' FC St. Gallen	Kategorie:Fußballspieler (FC St. Gallen)
Kategorija:Plejers ta' Servette FC	Kategorie:Fußballspieler (Servette FC Genève)
Kategorija:Plejers ta' Standard Liège	Kategorie:Fußballspieler (Standard Lüttich)
Kategorija:Plejers ta' FC Sion	Kategorie:Fußballspieler (FC Sion)
Kategorija:Plejers ta' Hibernian FC	Kategorie:Fußballspieler (Hibernian Edinburgh)
Kategorija:Plejers ta' Chester City FC	Kategorie:Fußballspieler (Chester City)
Kategorija:Plejers ta' FC Schaffhausen	Kategorie:Fußballspieler (FC Schaffhausen)
Kategorija:Plejers ta' SD Eibar	Kategorie:Fußballspieler (SD Eibar)
Kategorija:Plejers ta' Yverdon-Sport FC	Kategorie:Fußballspieler (Yverdon-Sport FC)
Kategorija:Plejers ta' BSC Young Boys	Kategorie:Fußballspieler (BSC Young Boys)
Kategorija:Plejers ta' PFC CSKA Sofia	Kategorie:Fußballspieler (ZSKA Sofia)
Portal:Matematika	Portal:Mathematik
Kategorija:Mużiċisti Litwani	Kategorie:Litauischer Musiker
Kategorija:Kompożituri Iżlandiżi	Kategorie:Isländischer Komponist
Mudell:Tim ta' RSC Anderlecht	Vorlage:Navigationsleiste Kader des RSC Anderlecht
Kategorija:William Shakespeare	Kategorie:William Shakespeare
Kategorija:Galatasaray SK	Kategorie:Galatasaray Istanbul
Kategorija:Plejers ta' Galatasaray SK	Kategorie:Fußballspieler (Galatasaray Istanbul)
Kategorija:Mudelli tal-mużika	Kategorie:Vorlage:Musik
Mudell:Infobox Kulur	Vorlage:Infobox Farbe
Kategorija:Kompożituri	Kategorie:Komponist
Kategorija:Macroscelididae	Kategorie:Rüsselspringer
Kategorija:Futbolers f'Ċipru skont il-klabb	Kategorie:Fußballspieler (Zypern) nach Verein
Kategorija:Pajjiżi Amerikani	Kategorie:Staat in Amerika
Mudell:Kampjonati tal-UEFA	Vorlage:Navigationsleiste Nationale Meisterschaften der Verbände der UEFA
Mudell:Pajjiżi tal-Eurovision	Vorlage:Navigationsleiste Länder beim Eurovision Song Contest
Mudell:Utent scn-3	Vorlage:User scn-3
Mudell:Utent hi-2	Vorlage:User hi-2
Kategorija:Artikli li jeħtieġu aġġornament	Kategorie:Wikipedia:Veraltet
Mudell:Utent ga	Vorlage:User ga
Mudell:Suboff	Vorlage:Auswechslung
Mudell:Sent off	Vorlage:Rot
Mudell:MLT	Vorlage:MLT
Kategorija:Tazza tad-Dinja tal-Futbol 2006	Kategorie:Fußball-Weltmeisterschaft 2006
Kategorija:Grawnds tal-futbol fil-Ġermanja	Kategorie:Fußballstadion in Deutschland
Kategorija:Plejers ta' AC ChievoVerona	Kategorie:Fußballspieler (AC Chievo Verona)
Kategorija:Kowċis ta' AC Milan	Kategorie:Fußballtrainer (AC Mailand)
Kategorija:ACF Fiorentina	Kategorie:AC Florenz
Kategorija:Plejers ta' ACF Fiorentina	Kategorie:Fußballspieler (AC Florenz)
Kategorija:Plejers ta' AS Monaco FC	Kategorie:Fußballspieler (AS Monaco)
Kategorija:Federazzjonijiet tal-futbol	Kategorie:Fußballverband
Kategorija:Futbolers fi New Zealand skont il-klabb	Kategorie:Fußballspieler (Neuseeland) nach Verein
Kategorija:Plejers ta' Atalanta BC	Kategorie:Fußballspieler (Atalanta Bergamo)
Kategorija:Kowċis ta' Athletic Bilbao	Kategorie:Fußballtrainer (Athletic Bilbao)
Kategorija:Plejers ta' Barnsley FC	Kategorie:Fußballspieler (FC Barnsley)
Mudell:Tim ta' Valencia CF	Vorlage:Navigationsleiste Kader des FC Valencia
Kategorija:Plejers ta' Boca Juniors	Kategorie:Fußballspieler (CA Boca Juniors)
Kategorija:Borussia Dortmund	Kategorie:Borussia Dortmund
Kategorija:Referis tal-futbol Brażiljani	Kategorie:Fußballschiedsrichter (Brasilien)
Kategorija:Pajjiżi tal-Amerika Ċentrali	Kategorie:Staat in Mittelamerika
Mudell:TOCleft	Vorlage:TOCleft
Kategorija:Plejers ta' Eintracht Frankfurt	Kategorie:Fußballspieler (Eintracht Frankfurt)
Kategorija:Plejers Ewropej tas-Sena	Kategorie:Europas Fußballer des Jahres
Kategorija:Edizzjonijiet tal-Festival tal-Eurovision	Kategorie:Eurovision Song Contest nach Jahr
Kategorija:Plejers ta' FC Admira Wacker Mödling	Kategorie:Fußballspieler (FC Admira Wacker)
Kategorija:FC Barcelona	Kategorie:FC Barcelona
Kategorija:FC Bayern Munich	Kategorie:FC Bayern München
Kategorija:Plejers ta' FC Girondins de Bordeaux	Kategorie:Fußballspieler (Girondins Bordeaux)
Kategorija:Plejers ta' FC Lausanne-Sport	Kategorie:Fußballspieler (FC Lausanne-Sport)
Kategorija:Kowċis ta' FC Schalke 04	Kategorie:Fußballtrainer (FC Schalke 04)
Kategorija:Plejers ta' FC Schalke 04	Kategorie:Fußballspieler (FC Schalke 04)
Kategorija:Plejers ta' FC Sochaux-Montbéliard	Kategorie:Fußballspieler (FC Sochaux)
Kategorija:Plejers ta' FC Thun	Kategorie:Fußballspieler (FC Thun)
Kategorija:Tazza tad-Dinja tal-Futbol tal-Klabbs	Kategorie:FIFA-Klub-Weltmeisterschaft
Kategorija:Tazza tad-Dinja tal-Futbol	Kategorie:Fußball-Weltmeisterschaft als Thema
Kategorija:Plejers tas-Sena tal-FIFA	Kategorie:Weltfußballer des Jahres
Kategorija:Klabbs tal-futbol Armeni	Kategorie:Armenischer Fußballverein
Kategorija:Klabbs tal-futbol Awstrijaċi	Kategorie:Österreichischer Fußballverein
Kategorija:Klabbs tal-futbol Bożnijaċi	Kategorie:Bosnisch-herzegowinischer Fußballverein
Kategorija:Klabbs tal-futbol Estonjani	Kategorie:Estnischer Fußballverein
Kategorija:Klabbs tal-futbol Iżraeljani	Kategorie:Israelischer Fußballverein
Kategorija:Klabbs tal-futbol Serbi	Kategorie:Serbischer Fußballverein
Kategorija:Futbol fil-Korea t'Isfel	Kategorie:Fußball in Südkorea
Kategorija:Grawnds tal-futbol fil-Belġju	Kategorie:Fußballstadion in Belgien
Kategorija:Futbolers fl-Arġentina skont il-klabb	Kategorie:Fußballspieler (Argentinien) nach Verein
Kategorija:Futbolers fil-Belġju skont il-klabb	Kategorie:Fußballspieler (Belgien) nach Verein
Kategorija:Futbolers fil-Brażil skont il-klabb	Kategorie:Fußballspieler (Brasilien) nach Verein
Kategorija:Futbolers fl-Ekwador skont il-klabb	Kategorie:Fußballspieler (Ecuador) nach Verein
Kategorija:Futbolers fi Franza skont il-klabb	Kategorie:Fußballspieler (Frankreich) nach Verein
Kategorija:Futbolers fil-Greċja skont il-klabb	Kategorie:Fußballspieler (Griechenland) nach Verein
Kategorija:Futbolers fl-Iżrael skont il-klabb	Kategorie:Fußballspieler (Israel) nach Verein
Kategorija:Futbolers f'Malta skont il-klabb	Kategorie:Fußballspieler (Malta) nach Verein
Kategorija:Futbolers fil-Messiku skont il-klabb	Kategorie:Fußballspieler (Mexiko) nach Verein
Kategorija:Futbolers fin-Norveġja skont il-klabb	Kategorie:Fußballspieler (Norwegen) nach Verein
Kategorija:Futbolers fis-Serbja skont il-klabb	Kategorie:Fußballspieler (Serbien) nach Verein
Kategorija:Futbolers fil-Korea t'Isfel skont il-klabb	Kategorie:Fußballspieler (Südkorea) nach Verein
Kategorija:Futbolers fl-Iżvezja skont il-klabb	Kategorie:Fußballspieler (Schweden) nach Verein
Kategorija:Futbolers fl-Iżvizzera skont il-klabb	Kategorie:Fußballspieler (Schweiz) nach Verein
Kategorija:Futbolers fit-Turkija skont il-klabb	Kategorie:Fußballspieler (Türkei) nach Verein
Kategorija:Futbolers fl-Urugwaj skont il-klabb	Kategorie:Fußballspieler (Uruguay) nach Verein
Kategorija:Logħob tal-Pajjiżi ż-Żgħar tal-Ewropa	Kategorie:Spiele der kleinen Staaten von Europa
Kategorija:Għawdex	Kategorie:Gozo
Kategorija:Gran Mastri tal-Ordni ta' San Ġwann	Kategorie:Großmeister des Malteserordens
Kategorija:Plejers ta' Grasshopper-Club Zürich	Kategorie:Fußballspieler (Grasshopper Club Zürich)
Kategorija:Plejers ta' Hamburger SV	Kategorie:Fußballspieler (Hamburger SV)
Kategorija:Kowċis ta' Inter Milan	Kategorie:Fußballtrainer (Inter Mailand)
Kategorija:Plejers ta' Inter Milan	Kategorie:Fußballspieler (Inter Mailand)
Kategorija:Irlanda	Kategorie:Irland (Insel)
Kategorija:Preżentaturi televiżivi Taljani	Kategorie:Fernsehmoderator (Italien)
Għajnuna:Kronoloġija	Hilfe:Versionen
Kategorija:Festival tal-Eurovision taż-Żgħar	Kategorie:Junior Eurovision Song Contest
Kategorija:Plejers ta' Juventus FC	Kategorie:Fußballspieler (Juventus Turin)
Kategorija:Ordni Militari Sovran ta' Malta	Kategorie:Malteserorden
Kategorija:Mexxejja tal-Partit Laburista (Malta)	Kategorie:Mitglied der Partit Laburista
Kategorija:Plejers ta' Legia Warszawa	Kategorie:Fußballspieler (Legia Warschau)
Portal:Kimika	Portal:Chemie
Kategorija:Premier League Malti	Kategorie:Maltesische Fußballmeisterschaft
Kategorija:Kompożituri Maltin	Kategorie:Maltesischer Komponist
Kategorija:Avukati Maltin	Kategorie:Rechtsanwalt (Malta)
Kategorija:Mużiċisti Maltin	Kategorie:Maltesischer Musiker
Kategorija:Plejers ta' RSC Anderlecht	Kategorie:Fußballspieler (RSC Anderlecht)
Kategorija:Plejers ta' RC Strasbourg	Kategorie:Fußballspieler (Racing Straßburg)
Kategorija:Plejers ta' Racing Club	Kategorie:Fußballspieler (Racing Club Avellaneda)
Kategorija:Mikelanġlu	Kategorie:Michelangelo
Kategorija:Plejers ta' Real Madrid CF	Kategorie:Fußballspieler (Real Madrid)
Kategorija:Plejers ta' Real Zaragoza	Kategorie:Fußballspieler (Real Saragossa)
Kategorija:Mużiċisti Montenegrini	Kategorie:Montenegrinischer Musiker
Kategorija:Plejers ta' River Plate	Kategorie:Fußballspieler (CA River Plate)
Kategorija:Politiċi tal-Partit Nazzjonalista (Malta)	Kategorie:Mitglied der Partit Nazzjonalista
Kategorija:Kompożituri Romantiċi	Kategorie:Komponist (Romantik)
Kategorija:Plejers ta' Rosario Central	Kategorie:Fußballspieler (CA Rosario Central)
Kategorija:Kowċis ta' SL Benfica	Kategorie:Fußballtrainer (Benfica Lissabon)
Kategorija:SSC Napoli	Kategorie:SSC Neapel
Kategorija:Plejers ta' SS Lazio	Kategorie:Fußballspieler (Lazio Rom)
Kategorija:SK Rapid Wien	Kategorie:SK Rapid Wien
Kategorija:SK Sturm Graz	Kategorie:SK Sturm Graz
Kategorija:Plejers ta' SV Werder Bremen	Kategorie:Fußballspieler (Werder Bremen)
Kategorija:Ortografija	Kategorie:Rechtschreibung
Kategorija:Pitturi ta' Pablo Picasso	Kategorie:Gemälde von Pablo Picasso
Kategorija:Plejers ta' Parma FC	Kategorie:Fußballspieler (FC Parma)
Kategorija:Lingwi Semitiċi	Kategorie:Semitische Sprachen
Raymond Vella	Raymond Vella
Kategorija:Kantanti Slovakki	Kategorie:Slowakischer Musiker
Kategorija:Futbolers fl-Istati Uniti skont il-klabb	Kategorie:Fußballspieler (Vereinigte Staaten) nach Verein
Kategorija:Grawnds tal-futbol fl-Afrika t'Isfel	Kategorie:Fußballstadion in Südafrika
Kategorija:Plejers ta' Sociedade Esportiva Palmeiras	Kategorie:Fußballspieler (Palmeiras São Paulo)
Kategorija:Referis tal-futbol Spanjoli	Kategorie:Fußballschiedsrichter (Spanien)
Kategorija:Mużewijiet sportivi	Kategorie:Sportmuseum
Kategorija:Okkupazzjonijiet sportivi	Kategorie:Beruf (Sport)
Kategorija:Provinċja ta' Agrigento	Kategorie:Provinz Agrigent
Kategorija:Provinċja ta' Kaltanissetta	Kategorie:Provinz Caltanissetta
Kategorija:Ludwig van Beethoven	Kategorie:Ludwig van Beethoven
Kategorija:Ateiżmu	Kategorie:Atheismus
Kategorija:Plejers ta' Stade Rennais FC	Kategorie:Fußballspieler (Stade Rennes)
Kategorija:Standard Liège	Kategorie:Standard Lüttich
Kategorija:Edizzjonijiet tal-Kampjonati Ewropej tal-Futbol	Kategorie:Fußball-Europameisterschaft
Kategorija:Kompożituri Klassiċi	Kategorie:Komponist (Klassische Musik)
Kategorija:Didelphimorphia	Kategorie:Beutelratten
Kategorija:Bolol	Kategorie:Briefmarke
Kategorija:Ewropa Ċentrali	Kategorie:Mitteleuropa
Kategorija:Trattati tal-Unjoni Ewropea	Kategorie:Europäisches Primärrecht
Kategorija:Futbol fil-Maċedonja	Kategorie:Fußball in Mazedonien
Kategorija:Snin tas-seklu 12	Kategorie:Jahr (12. Jahrhundert)
Kategorija:Snin tas-seklu 13	Kategorie:Jahr (13. Jahrhundert)
Kategorija:Snin tas-seklu 14	Kategorie:Jahr (14. Jahrhundert)
Kategorija:Snin tas-seklu 15	Kategorie:Jahr (15. Jahrhundert)
Kategorija:Snin tas-seklu 16	Kategorie:Jahr (16. Jahrhundert)
Kategorija:Snin tas-seklu 17	Kategorie:Jahr (17. Jahrhundert)
Kategorija:Snin tas-seklu 18	Kategorie:Jahr (18. Jahrhundert)
Kategorija:Snin tas-seklu 19	Kategorie:Jahr (19. Jahrhundert)
Kategorija:Snin tas-seklu 20	Kategorie:Jahr (20. Jahrhundert)
Kategorija:Snin tas-seklu 21	Kategorie:Jahr (21. Jahrhundert)
Kategorija:Logħob tat-tfal	Kategorie:Kinderspiel
Kategorija:Provinċja ta' Bergamo	Kategorie:Provinz Bergamo
Mudell:Premier League Armen	Vorlage:Navigationsleiste Vereine der armenischen Bardsragujn chumb
Kategorija:Provinċja ta' Lodi	Kategorie:Provinz Lodi
Kategorija:Plejers ta' Beşiktaş JK	Kategorie:Fußballspieler (Beşiktaş Istanbul)
Kategorija:Plejers ta' Chelsea FC	Kategorie:Fußballspieler (FC Chelsea)
Kategorija:Plejers ta' Club Brugge KV	Kategorie:Fußballspieler (FC Brügge)
Kategorija:Plejers ta' Neuchâtel Xamax	Kategorie:Fußballspieler (Neuchâtel Xamax)
Kategorija:Plejers ta' Panathinaikos	Kategorie:Fußballspieler (Panathinaikos Athen)
Kategorija:Plejers ta' Paris Saint-Germain FC	Kategorie:Fußballspieler (Paris SG)
Kategorija:Plejers ta' VfL Wolfsburg	Kategorie:Fußballspieler (VfL Wolfsburg)
Kategorija:Plejers ta' 1. FC Köln	Kategorie:Fußballspieler (1. FC Köln)
Kategorija:Plejers ta' OGC Nice	Kategorie:Fußballspieler (OGC Nizza)
Kategorija:Plejers ta' Olympique Lyonnais	Kategorie:Fußballspieler (Olympique Lyon)
Kategorija:Pedagoġija	Kategorie:Pädagogik
Mudell:Edizzjonijiet tal-Logħob tal-Pajjiżi ż-Żgħar tal-Ewropa	Vorlage:Navigationsleiste Spiele der kleinen Staaten von Europa
Serie A 2013–14	Serie A 2013/14
Kategorija:Sports ta' preċiżjoni	Kategorie:Präzisionssportart
Kategorija:Preistorja	Kategorie:Ur- und Frühgeschichte
Kategorija:Mużiċisti Torok	Kategorie:Türkischer Musiker
Kategorija:Mużiċisti Bjelorussi	Kategorie:Weißrussischer Musiker
Kategorija:Xogħol għaddej	Kategorie:Wikipedia:In Bearbeitung
Mudell:IMSLP	Vorlage:IMSLP
Kategorija:Utenti en-1	Kategorie:User en-1
Kategorija:Twieldu fl-1930	Kategorie:Geboren 1930
Kategorija:Twieldu fl-1946	Kategorie:Geboren 1946
Kategorija:Utenti de-1	Kategorie:User de-1
Kategorija:Twieldu fl-1920	Kategorie:Geboren 1920
Kategorija:Twieldu fl-1956	Kategorie:Geboren 1956
Kategorija:Twieldu fl-1933	Kategorie:Geboren 1933
Kategorija:Twieldu fl-1911	Kategorie:Geboren 1911
Kategorija:Twieldu fl-1937	Kategorie:Geboren 1937
Kategorija:Twieldu fl-1948	Kategorie:Geboren 1948
Kategorija:Mietu fl-1978	Kategorie:Gestorben 1978
Kategorija:Twieldu fl-1921	Kategorie:Geboren 1921
Kategorija:Twieldu fl-1924	Kategorie:Geboren 1924
Kategorija:Twieldu fl-1926	Kategorie:Geboren 1926
Kategorija:Twieldu fl-1950	Kategorie:Geboren 1950
Kategorija:Twieldu fl-1964	Kategorie:Geboren 1964
Kategorija:Mietu fl-1979	Kategorie:Gestorben 1979
Kategorija:Mietu fl-2010	Kategorie:Gestorben 2010
Kategorija:Macroscelidea	Kategorie:Macroscelidea
Kategorija:Logħob	Kategorie:Spiele
Kategorija:Mużiċisti Rumeni	Kategorie:Rumänischer Musiker
Mudell:Tim ta' Sunderland AFC	Vorlage:Navigationsleiste Kader des AFC Sunderland
Mudell:Tim ta' Borussia Dortmund	Vorlage:Navigationsleiste Kader von Borussia Dortmund
Mudell:Tim ta' VfL Wolfsburg	Vorlage:Navigationsleiste Kader des VfL Wolfsburg
Mudell:Tim ta' SS Lazio	Vorlage:Navigationsleiste Kader von Lazio Rom
Għajnuna:Medja	Hilfe:Dateien
Wikipedija:Ċaħda medika	Wikipedia:Hinweis Gesundheitsthemen
Mudell:Kunsill Nordiku	Vorlage:Navigationsleiste Nordischer Rat
Kategorija:Premier League	Kategorie:Premier League
Mudell:Primera Divisió	Vorlage:Navigationsleiste Vereine der andorranischen Lliga de Primera Divisió
Mudell:Tim ta' Real Madrid CF	Vorlage:Navigationsleiste Kader von Real Madrid
Għajnuna:Gwida essenzjali/Diskussjoni	Wikipedia:Tutorial/5
Għajnuna:Gwida essenzjali/Linji gwida	Wikipedia:Tutorial/1
Macroscelides	Macroscelides
Mudell:Tim ta' Wigan Athletic FC	Vorlage:Navigationsleiste Kader von Wigan Athletic
Mudell:Nat fs g player	Vorlage:National football squad player (goals)
Mudell:Kunsilli lokali ta' Malta u Għawdex	Vorlage:Navigationsleiste Gemeinden in Malta
Wikipedija:Wikipedija fis-sit tiegħek	Wikipedia:Banner und Logos
Mudell:Utent hif	Vorlage:User hif
Għajnuna:Gwida essenzjali/Konklużjoni	Wikipedia:Tutorial/6
Mudell:Tim ta' Manchester City FC	Vorlage:Navigationsleiste Kader von Manchester City
Mudell:Infobox kompetizzjoni sportiva	Vorlage:Infobox Sportliga
Mudell:Utent scn	Vorlage:User scn
Mudell:Federazzjonijiet tal-UEFA	Vorlage:Navigationsleiste Nationale Fußballverbände der UEFA
Mudell:Superliga Albaniża	Vorlage:Navigationsleiste Vereine der Kampionati Shqiptar
Mudell:Tim ta' Liverpool FC	Vorlage:Navigationsleiste Kader des FC Liverpool
Mudell:Tim ta' Birmingham City FC	Vorlage:Navigationsleiste Kader von Birmingham City
Mudell:Tim ta' Hull City AFC	Vorlage:Navigationsleiste Kader von Hull City
Mudell:Tim ta' Aston Villa FC	Vorlage:Navigationsleiste Kader von Aston Villa
Miraklu Ewkaristiku ta' Lanciano	Eucharistisches Wunder von Lanciano
Mudell:Tim ta' Tottenham Hotspur FC	Vorlage:Navigationsleiste Kader von Tottenham Hotspur
Mudell:Tim ta' Villareal CF	Vorlage:Navigationsleiste Kader des FC Villarreal
Wikipedija:VisualEditor	Hilfe:VisualEditor
Mudell:Tim ta' Paris Saint-Germain FC	Vorlage:Navigationsleiste Kader von Paris Saint-Germain
Premier League 2013–14	Premier League 2013/14
Mudell:Tim ta' Olympique Lyonnais	Vorlage:Navigationsleiste Kader von Olympique Lyon
Mudell:Tim ta' Fulham FC	Vorlage:Navigationsleiste Kader des FC Fulham
Mudell:Presidenti ta' Malta	Vorlage:Navigationsleiste Präsidenten von Malta
Birdman (film)	Birdman oder (Die unverhoffte Macht der Ahnungslosigkeit)
Edward Snowden	Edward Snowden
Mudell:Rawnd16	Vorlage:Round16
Mudell:Premijer Liga	Vorlage:Navigationsleiste Vereine der bosnischen Premijerliga (Fußball)
Premier League Malti 2013–14	Maltese Premier League 2013/14
Gaia Cauchi	Gaia Cauchi
Coreca	Coreca
Speċjali:TibdilRiċenti	Spezial:Letzte Änderungen
Kategorija:Utenti ja-4	Kategorie:User ja-4
Kategorija:Mietu fl-1976	Kategorie:Gestorben 1976
Kategorija:Mietu fl-1975	Kategorie:Gestorben 1975
Kategorija:Mietu fl-1974	Kategorie:Gestorben 1974
Franco Trappoli	Franco Trappoli
Jean Paul Farrugia	Jean Paul Farrugia
Senġi ta' widnejħ tondi ta' Etendeka	Macroscelides micus
Senġi ta' widnejh tondi tan-Namib	Macroscelides flavicaudatus
Maurizio Malvestiti	Maurizio Malvestiti
Eurotamandua	Eurotamandua
Tony Nicholl	Tony Nicholl
