Naakaii Łizhiní Bikéyah	Afrika
Binaʼadaałtzózí Dinéʼiʼ Bikéyah	Japan
Bitsiighaʼ Łichííʼí Bikéyah	Irland
Hángewii	Ungarn
Dibé Diníí Bikéyah	Spanien
Wááshindoon Bikéyah Ałhidadiidzooígíí	Vereinigte Staaten
Bélgii Bikéyah	Belgien
Látsębooʼ	Luxemburg
Yágháhookáán	Universum
Nahasdzáán	Erde
Nahoditsʼǫʼłání	Finnland
Déinish Dineʼé Bikéyah	Dänemark
Póolish Dineʼé Bikéyah	Polen
Łitʼoowę́ęya	Litauen
Ídelii	Italien
Swis Bikéyah	Schweiz
Óóswiya	Österreich
Gwíík Dineʼé Bikéyah	Griechenland
Tʼóok Bikéyah	Türkei
Béésh Bichʼahníí Bikéyah	Europa
(*"asia")	Asien
Shádiʼááhjí kéyah yistinígíí	Antarktika
Kéyah Wóyahgo Siʼánígíí	Niederlande
Béésh bee akʼeʼelchíhí tʼáá bí nitsékeesígíí	Computer
Hastiin alą́ąjįʼ dahsidáhígíí Barack Obama	Barack Obama
Táłtłʼááh Chʼosh Bitooh (Kéyah Dah Siʼánígíí)	Uruguay
Méhigo	Mexiko
Akééháshį́į́h Hahoodzo	Kalifornien
Máaz	Mars (Planet)
Kénya	Kenia
Iithiyópya	Äthiopien
Gáana	Ghana
Náshdóítsoh bitsiijįʼ daditłʼooígíí	Löwe
Dáághahii Dinéʼiʼ Bikéyah	Frankreich
Łééchąąʼí	Haushund
Tótaʼ Dinéʼiʼ Bikéyah	Vereinigtes Königreich
Mósí	Hauskatze
Dáághahii bizaad	Französische Sprache
Łóóʼ	Fische
Bwazííl	Brasilien
Biʼééʼ Łichííʼí Bikéyah	Russland
Łóóʼtsoh dóó Tééh hóyáanii	Wale
Élábéemah Hahoodzo	Alabama
Béésh Bichʼahii Bikéyah	Deutschland
Bééshbichʼahii bizaad	Deutsche Sprache
Tin Bikéyah	Island
Ééstii Bikéyah	Estland
Séetin	Saturn (Planet)
Chidí naatʼaʼí	Flugzeug
Hastiin alą́ąjįʼ dahsidáhígíí George W. Bush	George W. Bush
Létbiiya	Lettland
Yóókwein	Ukraine
Chek Bikéyah	Tschechien
Słóbaʼ Bikéyah	Slowakei
Słobíín Bikéyah	Slowenien
Wooméiniya	Rumänien
Bálgaa Bikéyah	Bulgarien
Dziłigaii Bikéyah	Albanien
Haʼaʼaahjí Hakʼaz Dineʼé Bikéyah	Grönland
Kwóóʼad Bikéyah	Kroatien
Bosna dóó Hetsog Bikéyah	Bosnien und Herzegowina
Azééwii Bikéyah	Aserbaidschan
Andówa	Andorra
Béésh Łichíiʼii Bikéyah	Republik Zypern
Jóojah (Kéyah)	Georgien
Kʼazah Bikéyah	Kasachstan
Dziłizhin Bikéyah	Montenegro
Bádikin Sídii	Vatikanstadt
San Mawínoo Bikéyah	San Marino
Kyóoba	Kuba
Hashkʼaan Bikéyah	Barbados
Indoníízha	Indonesien
Tʼóok bizaad	Türkische Sprache
Kéyah Naakai Łizhinii Bikéyah Shádiʼááhjí Siʼánígíí	Südafrika
Aljííya	Algerien
Ózbeʼ Bikéyah	Usbekistan
Tó	Wasser
Níłchʼi naalkidí	Fernsehen
Chíilii	Chile
Doodaatsaahii (Jíísas)	Jesus Christus
Mókiwii	Merkur (Planet)
Ákáʼátʼįįł (béésh ntsékeesígíí álʼíní)	Apple
Biinis	Venus (Planet)
Jíbitoo	Jupiter (Planet)
Yoowéinis	Uranus (Planet)
Néʼtoon	Neptun (Planet)
Sį́ʼgaboo	Singapur
Tłóotoo	Pluto
Łííhtensain	Liechtenstein
Dágháilchįįh	Adolf Hitler
Naaltsoos biniiʼ	Facebook
Naaki góneʼ yéigo daʼahijoogą́ą́ʼ	Zweiter Weltkrieg
Ałhíʼayiiltááh	Mathematik
Aooméénii Bikéyah	Armenien
Ooljééʼ	Mond
Nahatʼeʼiitsoh Bikéyah	Australien
Béésh Łigaii Bikéyah	Argentinien
Kolíya Bikéyah Náhookǫsjí Siʼánígíí	Nordkorea
Naayééʼ	Dinosaurier
Bilasáana bitseeʼ nineezígíí	Birnen
Naturalis Historia of Pliny the Elder	Naturalis historia
Encyclopædia Britannica	Encyclopædia Britannica
Tó yaʼnidaʼaazgééd	Aquädukt
Chʼil łitsooí díkʼǫ́zhígíí	Zitrone
Sǫʼ	Stern
Jóhonaaʼéí	Sonne
Háájiʼjin	Wasserstoff
Níłchʼi Ászólí	Helium
Haʼaʼaahjí Tíímow	Osttimor
Séwes	(1) Ceres
Haʼooméya	(136108) Haumea
Maakiimaakii	(136472) Makemake
Ééwis	(136199) Eris
Káábin	Kohlenstoff
Níłchʼi Yáʼátʼéehii	Sauerstoff
Hadoh dóó hakʼaz neiłkidígíí	Thermometer
Níłchʼi Łitsxooí	Neon
Chihuahua Hahoodzo	Chihuahua (Bundesstaat)
Soodin	Natrium
Béésh Łikoní	Magnesium
Béésh Ászólí	Aluminium
Tó Wónaanídę́ę́ʼ Bitsįʼ Yishtłizhii Bikéyah	Indien
Tʼoobááloo	Tuvalu
Béésh (Fe)	Eisen
Tʼónga	Tonga
Łeetsoii	Schwefel
Samóa	Samoa
Sólomon Tó Bináhaazyínígíí	Salomonen
Banoʼáátʼoo	Vanuatu
Páápowa Bigíní Ániidí	Papua-Neuguinea
Níłchʼi Dootłʼizhí	Argon
Eʼeʼaahjí Tónteel bikáaʼgi Kéyah Yázhí dah Ndaaʼeełgo Ałhidadiidzooígíí	Föderierte Staaten von Mikronesien
Káálsiiyin	Calcium
Dilyį́hí	Blei
Kílíbas	Kiribati
Chʼah Diʼilii Bikéyah	Mongolei
Fííjii	Fidschi
Béésh doo Ńdiniichxíihii	Titan (Element)
Táłkááʼ Bighan Dineʼé Bikéyah	Venezuela
Méíin Hahoodzo	Maine
Łį́į́ʼ	Hauspferd
Naaldeehii	Tier
Sówinam	Suriname
Kéyah Nahasdzáán Ałníiʼgi Siʼánígíí	Ecuador
Kolámbiya	Kolumbien
Béésh Łibáhí	Cobalt
Bolíbiya	Bolivien
Béésh Łichíiʼii	Kupfer
Niihémpshoo Hahoodzo	New Hampshire
Chʼosh doo yitʼíinii dláádí dóó Ábishjaaʼ	Pilze
Jaméíkʼa	Jamaika
Méésíchóoshish Hahoodzo	Massachusetts
Kanédikiʼ Hahoodzo	Connecticut
Naaʼahóóhai	Haushuhn
Antíígwa dóó Hashkʼaan Bikéyah Yázhí	Antigua und Barbuda
Kéyah Ałkéé Nitį́įgo Dah Ndaaʼeełí	Hawaii
Damóo Bikéyah	Dominica
Domingo Bikéyah	Dominikanische Republik
Bisóodi	Hausschwein
Héítii	Haiti
Iiwą́ą́	Iran
Iiwááʼ	Irak
Hakʼaz Dineʼé Bikéyah Hahoodzo	Alaska
Ízrel Bikéyah	Israel
Shádiʼááhjí Ásáí Bikéyah	Jemen
Jóoʼdan	Jordanien
Gah Bikeeʼ Taahíʼahí	Florida
Kíígiz Bikéyah	Kirgisistan
Hoozdo Hahoodzo	Arizona
Kóóweiʼ	Kuwait
Lááʼos	Laos
Łíbanoo	Libanon
Óogin Hahoodzo	Oregon
Naakaii Dootłʼizhí Bikéyah Yázhí (Tó Bináhaazyínígíí)	Malediven
Kéyah dah siʼánígíí	Amerika
Áshįįh Biiʼtó Hahoodzo	Utah
Béégashii	Hausrind
Maléízha	Malaysia
Dziłgaiitsoh Honeezkʼazii Bikéyah	Nepal
Omą́ą́	Oman
Eʼeʼaahjí Naakaii Dootłʼizhí Bikéyah	Pakistan
Kʼatár	Katar
Ásáí Bikéyah Saʼoodí	Saudi-Arabien
Swii Lankʼa	Sri Lanka
Sííwiya	Syrien
Tʼajiʼ Bikéyah	Tadschikistan
Tʼáí Bikéyah	Thailand
Kǫʼ naʼałbąąsii diné bee nágéhéʼ	Zug (Eisenbahn)
Tʼóokmen Bikéyah	Turkmenistan
Ásáí Bikéyah Yázhí Ałhidadiidzooígíí	Vereinigte Arabische Emirate
Biʼednam	Vietnam
Kolíya Bikéyah Shádiʼááhjí Siʼánígíí	Südkorea
Óola	Gold
Naʼałkaahí	Wissenschaftler
Bangla Bikéyah	Bangladesch
Angóola	Angola
Iiʼniʼ Tłʼiishtsoh Bikéyah	Bhutan
Bwoonéí	Brunei
Tʼanzanííya	Tansania
Béésh Tózháanii	Quecksilber
Kéyah Dańlíinii	Philippinen
Naakaii Łizhinii Bikéyah Beʼałnííʼ	Zentralafrikanische Republik
Hastiin Albert Einstein	Albert Einstein
Tʼóogo	Togo
Hooghan Tsé Bee Ádaalyaaí Bikéyah	Simbabwe
Shádiʼááhjí Soodą́ą	Südsudan
Tswana Dineʼé Bikéyah	Botswana
Wóndii Dineʼé Bikéyah	Burundi
Ooljééʼ Bikéyah Yázhí	Komoren
Kéyah Káango Náhookǫsjí Siʼánígíí	Republik Kongo
Kéyah Káango Shádiʼááhjí Siʼánígíí	Demokratische Republik Kongo
Jibótii	Dschibuti
Gíní Nahasdzáán Ałníiʼgi Siʼánígíí	Äquatorialguinea
Gabǫ́ǫ́ (Kéyah)	Gabun
Géémbiya	Gambia
Gíní	Guinea
Gíní Bisó	Guinea-Bissau
Chį́į́h Yee Adilohii Bideeʼ Tónteel Bibąąh	Elfenbeinküste
Táłtłʼááh Chʼosh Daadánígíí Bitooh (Łizhinii Bikéyahdi)	Kamerun
Tónteel Bibąąh Dootłʼizhí	Kap Verde
Sotho Dineʼé Bikéyah	Lesotho
Łíbya	Libyen
Madaʼgéésgáá	Madagaskar
Malááwii	Malawi
Moowitéínya	Mauretanien
Moroko	Marokko
Namííbya	Namibia
Yogénda	Uganda
Wánda Dineʼé Bikéyah	Ruanda
Seishel	Seychellen
Náshdóítsoh Bitsiijįʼ Daditłʼooʼígíí Bidził	Sierra Leone
Soomáálii Bikéyah	Somalia
Soodą́ą	Sudan
Swáazi Dineʼé Bikéyah	Swasiland
Nahasdzáán Bikáaʼgi Kéyah Naaznilgo Ałhidadiidzooígíí	Vereinte Nationen
Nidaashchʼąąʼígíí	Farbe
Béésh Łigaii	Silber
Béésh Dildǫʼí	Zinn
Łéétsoh	Uran
Hastiin alą́ąjįʼ dahsidáhígíí Bill Clinton	Bill Clinton
Míshigin Hahoodzo	Michigan
Tó Nitsaa Nílį́bąąh Hahoodzo	Illinois
Náhookǫsjí Dzígaii	North Dakota
Ałnííʼjí Dzígaii	South Dakota
Ayání Naakaii Hahoodzo	Montana
Tóʼííbézhí	Wyoming
Nímasii Kʼidadilyéhé	Idaho
Ahééhałtį́į́h Hahoodzo	Washington (Staat)
Naʼazhǫǫsh Hahoodzo	Nevada
Kayíbíyinsíí (tónteel)	Karibisches Meer
Dibé Nitsaa Hahoodzo	Colorado
Naakaii bizaad	Spanische Sprache
Naʼashjéʼii	Webspinnen
Chʼosh bijáád tseebíhígíí	Spinnentiere
Chʼosh bideeʼ ádaadinígíí	Kieferklauenträger
Chʼosh bijáád dahólónígíí	Gliederfüßer
Béeso	Geld
Bijíniyah Hahoodzo	Virginia
Eʼeʼaahjí Bijiniyah Hahoodzo	West Virginia
Kin Yótʼááh Deezʼá Hahoodzo	New York (Bundesstaat)
Wóód Áalin Hahoodzo	Rhode Island
Chʼosh bijáád hastání	Insekten
Méelin Hahoodzo	Maryland
Déláwee Hahoodzo	Delaware
Oohááyoo Hahoodzo	Ohio
Pénsówéíniyah Hahoodzo	Pennsylvania
Niijéízii Hahoodzo	New Jersey
Índíʼyéenah Hahoodzo	Indiana
Chidí	Automobil
Jóojah Hahoodzo	Georgia
Akałii Bikéyah	Texas
Náhookǫsjí Kééláanah Hahoodzo	North Carolina
Shádiʼááhjí Kééláanah Hahoodzo	South Carolina
Méhigoʼ sídii	Mexiko-Stadt
Bilasáana diwozhí	Ananas
Mísísípii Hahoodzo	Mississippi (Staat)
Ténésii Hahoodzo	Tennessee
Yootó Hahoodzo	New Mexico
Mínisóodah Hahoodzo	Minnesota
Wiskaansin Hahoodzo	Wisconsin
Haʼaʼaahjí Dzígaii	Iowa
Nabeeskah Hahoodzo	Nebraska
Shádiʼááhjí Dzígaii	Kansas
Tó Dzígaii Nílį́	Missouri
Tónteel Chʼínílį́	Louisiana
Kentákii Hahoodzo	Kentucky
Dził Biiʼ Dzígaii	Arkansas
Halgai Hóteel Hahoodzo	Oklahoma
Ho Chi Min Sídii	Ho-Chi-Minh-Stadt
Bilagáana bizaad	Englische Sprache
Náhookǫsjí Hakʼaz Dineʼé Bikéyah	Nunavut
1901 – 1950	1902
Tłʼiish	Schlangen
1951 – 2000	1979
Pope Benedict XVI	Benedikt XVI.
Maʼii Ashkii	Geronimo
Tsin naaʼeeł táłtłʼááh naagháhígíí	U-Boot
Tahoniigááh	Influenza
Tłʼízí	Hausziege
Kǫʼ	Feuer
Tʼááłáhági átʼéego:Templates	Kategorie:Vorlage:
Dloziłchííʼ	Eichhörnchen
Tʼááłáhági átʼéego:Bideeʼtsʼinígíí	Kategorie:Bovidae
Tʼááłáhági átʼéego:Ndaaʼnaʼii	Kategorie:Squamata
Tiníléítsoh	Komodowaran
Chʼosh bijáád neeznánígíí	Zehnfußkrebse
Aymara bizaad	Aymara (Sprache)
Łeeyiʼ chʼoshtsoh binááʼ hólónígíí	Schleichenlurche
Tʼááłáhági átʼéego:Dééł dóó Tóidoozohii	Kategorie:Kranichvögel
Médíwííyin Sii	Mittelmeer
Jóojah (Ałtsʼáʼáztiin)	Georgia (Begriffsklärung)
Alóós	Reis
Tsídii	Vögel
Kéłánii bikágí yilzhólígíí	Stummelfüßer
Kéchwa bizaad	Quechua
Ínsadoobíídiiya	Enzyklopädie
Íiyisíí Naaltsoos	Wikipedia:Hauptseite
Dziłgaiitsoh Honeezkʼazii	Himalaya
Tʼááłáhági átʼéego:Candidates for speedy deletion	Kategorie:Wikipedia:Schnelllöschen
Chʼil ahwééh	Tee
Adijiłii	Stacheligel
Kéyah Sahééwa Eʼeʼaahjí Siʼánígíí	Westsahara
1801 – 1850	1815
Łį́į́ʼ Bideeʼłáaʼii	Einhorn
Hastiin Hernán Cortés	Hernán Cortés
Tsʼíʼii daʼaneezí	Stechmücken
Dibé	Hausschaf
Łóóʼ hashkéhé	Haie
Ghą́ą́ʼaskʼidii	Altweltkamele
Bidił Daazdoígíí dóó Daʼałtʼoʼígíí	Säugetiere
Mágí dóó Mágí Ndahalinígíí	Primaten
(*wálá-)	Ameisen
Tsísʼná	Bienen
Naayízítsʼósí	Zucchini
Jiłtʼoʼí	Gemeiner Rhabarber
Sęęschʼil	Blumenkohl
Ayęęzhii yiltʼąąʼí	Aubergine
Naalʼeełí	Entenvögel
Yas	Schnee
Jádí dághaaʼígíí	Gnus
1851 – 1900	1865
Biʼééʼ Łichííʼí bizaad	Russische Sprache
1751 – 1800	1784
Bááh	Brot
Bee Hazʼą́ą Ił Chʼétʼaah	Allgemeine Erklärung der Menschenrechte
Kéyah haʼdéísná	Erdbeben
Tó nitéél nitságoʼ atságáá	Tsunami
Níyoltsoh	Tornado
Saad bee alʼį́į́hni	Schrift
Tʼááłáhági átʼéego:Dáághahii	Kategorie:Frankreich
Mąʼii łitsooí	Rotfuchs
Naaltéʼ	Sklaverei
Ahwééh	Kaffee
Abeʼ	Milch
Dził	Berg
Doo Nidahałtingóó	Wüste
Cryptographic	Kryptographie
Guadalajara	Guadalajara (Mexiko)
Tsídii naʼałkʼaiʼí	Pinguine
Kolíya Dineʼé bizaad	Koreanische Sprache
Gah	Kaninchen
Tó niteel	Ozean
Hodíłchʼil Níłtsánígíí	Regenwald
HiTSʼezh	IPod
Hazéí	Hörnchen
Hazéí naatʼáʼii	Gleithörnchen
Ééʼ néíshoodí	Römisch-katholische Kirche
Kwį́į́n Elizabeth II	Elisabeth II.
Hastiin alą́ąjįʼ dahsidáhígíí Ronald Reagan	Ronald Reagan
Hastiin Emperor Yongle	Yongle
Naʼashjéʼiitsoh	Wolfspinnen
Naaldlooshii dadichʼízhii	Reptilien
Tsin Deigházhígíí	Nagetiere
Hasbídí	Tauben
Tééh hóyáanii	Schweinswale
Biyáázh Tsʼǫʼasánígíí (Táyiʼ dóó Niʼkáágóó Ndaakaaígíí)	Amphibien
Géeso	Käse
Chʼil naʼatłʼoʼii (chʼiyáán)	Weintraube
Tsísʼná bitłʼizh	Honig
Atsįʼ	Fleisch
Naʼashjéʼii tsiizisí	Zitterspinnen
Nímasii	Kartoffel
Áshįįh łikan	Zucker
Haʼałtsédii	Nussfrucht
Wááshindoon bisiláołtsooí	Streitkräfte der Vereinigten Staaten
Naʼiiniʼ bá Hooghantsoh	World Trade Center
Áshįįh	Speisesalz
Wááshindoondi bee hazʼáanii ádeiłʼíní	Kongress der Vereinigten Staaten
Tsin naaʼeeł	Schiff
Nidaʼąnyéézh	Bewässerung
Naadą́ą́ʼ	Mais
Naʼashchʼąąʼ	Malerei
Wótáahgoo ałnaaʼáłtʼahiʼ	Raumfahrer
Azhish	Tanz
Naʼashjéʼii nahachaʼígíí	Springspinnen
Kéyah Daʼnaaznilígíí	Liste der Staaten der Erde
Shash	Bären
Hastiin alą́ąjįʼ dahsidáhígíí John Adams	John Adams
Hastiin alą́ąjįʼ dahsidáhígíí Thomas Jefferson	Thomas Jefferson
Hastiin alą́ąjįʼ dahsidáhígíí Andrew Jackson	Andrew Jackson
Ńdíshchííʼ	Kiefern
Tłʼoh naadą́ą́ʼ	Weizen
Naałniih yichʼą́ą́h naabaahígíí bąąh dahooʼaahgo	AIDS
Abeʼ bee neezmasí	Crêpe
Jéíʼádįįh	Tuberkulose
Łóódtsoh	Pocken
Zelda bahaneʼ	The Legend of Zelda
Naakáí dinéʼiʼ biempire Méhigodi	Azteken
Łéétsoh bee atsiniltłʼish álʼį́	Kernenergie
Łéétsoh beeʼeldǫǫhtsoh beeʼalį́į́h	Kernwaffe
Chidí naaʼnaʼí beeʼeldǫǫh bikááʼ dah naaznilígíí	Panzer
Dah woozh	Gartenerdbeere
Jalisco Hahoodzo	Jalisco
Mágí bichʼiyąʼ	Kokospalme
Dzidzétsoh	Pfirsich
Chʼil łitsxooí	Orange (Frucht)
Chʼil dishooí	Kiwifrucht
Chʼil dootłʼizhí díkʼǫ́zhígíí	Limette
Abeʼ yistiní	Speiseeis
Méhigo bizaad	Nahuatl
Diné bizaad	Navajo (Sprache)
Jeeʼiighááh	Ohrwürmer
Tenochtitlan	Tenochtitlan
Ásáí Bizaad	Arabische Sprache
Honeezílígi	Subtropen
Atʼaʼ yiltʼąąʼí	Palmengewächse
Niłchiis	Vielfraß
Tsin yilátah ayání	Giraffe
Naalʼeełídaaʼí	Schnabeltier
Naʼashǫ́ʼii	Echsen
Béésh bee akʼeʼelchí áłtsisígíí	Personal Computer
Wikiibíídiiya:Naaltsoos nizhónígo ádaalyaaígíí	Wikipedia:Exzellente Artikel
Bimááʼ Hahoodzo	Vermont
Hoozdoh	Phoenix (Arizona)
Tʼáyaałchííʼ	Goldspecht
Táłkááʼ tsʼin bíchį́į́hnézí	Gangesgavial
Tsin naaʼeeł chidí naatʼaʼí bee nágéhéʼ	Flugzeugträger
Tsídiitsoh	Afrikanischer Strauß
Kolíya bikéyah (Ałtsʼáʼáztiin)	Korea
Mąʼiitsoh	Wolf
Chʼídeeldlóohiitsoh	Schuhschnabel
Hodíłchʼilgi dlǫ́ʼiitsoh	Fleckenmusang
Tóidoozohii bidaaʼ łichííʼígíí	Teichralle
Táłtłʼááh yilcháazhii	Schwämme
Tónteel naʼashjéʼii	Asselspinnen
Séigoʼ bíláshgaanézí	Geißelspinnen
Naʼashjéʼii jáádnézí	Weberknechte
Séigoʼchilí bitseeʼ ádinígíí	Pseudoskorpione
Séigoʼ	Skorpione
Zahalchíʼii	Walzenspinnen
Hastiin Emperor Qianlong	Qianlong
Séigoʼ bitseeʼ áłtsʼózígíí	Geißelskorpione
Yaaʼ doo yitʼíinii	Milben
Hodíłchʼilgi naaʼahóóhai	Steißhühner
Tłʼiishkʼosí (tsídii)	Schlangenhalsvögel
Télii	Hausesel
Náshdóítsoh noodǫ́zígíí	Tiger
Kʼíneeshbízhiinééz	Spaghetti
Chʼosh yoołgai bitsʼaʼígíí	Austern
Tábąąhgi łeeyiʼ chʼosh	Wattwurm
Azeeʼ hókániitsoh	Gewöhnliche Kratzdistel
Táłkáaʼgi Tsídii	Gänsevögel
Tązhii dóó Naaʼahóóhai Ndahalinígíí	Hühnervögel
Naalʼeełii keelóól	Lappentaucher
Tsídii Deílʼésígíí	Schreitvögel
Daʼałtʼoʼígíí Biyęęzhii Deiłchíhígíí	Kloakentiere
Adijiłii bíchį́į́hnézí	Ameisenigel
Biyázhí neiyéhé	Beutelratten
Hazéítsʼósii	Streifenhörnchen
Chidí bikʼah	Erdöl
Chéłchaaʼ	Käfer
Łį́į́ʼ ałchiní	Przewalski-Pferd
Dlǫ́ʼii yił aheełtʼéhii noodǫ́zígíí	Zebramanguste
Naʼastsʼǫǫsíʼniiʼí	Eigentliche Nasenbeutler
Shash naʼazísí	Wombats
Nahatʼeʼiitsohchilí	Rattenkängurus
Náʼagéédí łichíiʼii	Goldmulle
Bįįh Danilínígíí	Hirsche
Tin	Eis
Tłʼohchin díchʼííʼí	Knoblauch
Taʼneeskʼání áłtsʼóózígíí	Gurke
Tłʼohchin (chʼil daadánígíí)	Zwiebel
Chʼil łichxíʼí	Tomate
Béésh Łichíiʼii Bikéyah Náhookǫsjígo Siʼanígíí	Türkische Republik Nordzypern
Naʼazhǫǫsh Hátsoh	Las Vegas
Náshdóí dilwoʼí	Gepard
Tsékǫʼ	Kohle
Néʼéshjaaʼ	Eulen
Bíígháán Dahólónígíí	Wirbeltiere
Kʼishchííʼ	Birken
Ǫǫbǫʼii	Wiedehopf
Náshdóí Ndahalinígíí	Katzen
Yádiłhił yiiyídíʼ nahosdzáán yináádáłiʼ	Internationale Raumstation
Tó wónaanídę́ę́ʼ toohjįʼ noołnahii	Graureiher
Hashkʼaan dijéʼé	Echte Dattelpalme
Wááshindoon (Ałtsʼáʼáztiin)	Washington
Bidił Daazdoígíí dóó Daʼalghałígíí	Raubtiere
Chʼoshtsoh	Schaben
Dlǫ́ʼii yázhí	Mauswiesel
Tsʼíʼii dóó Tséʼédǫ́ʼii	Zweiflügler
Biniiʼłigaii (néʼéshjaaʼ)	Schleiereule
Mąʼii Ndahalinígíí	Hunde
Bijáád Ádaadinígíí	Weichtiere
Chʼosh łitsxooí dóó Chʼosh łichííʼí	Marienkäfer
Táłkááʼ naalzheehí	Fischadler
Bizaʼazis Dahólónígíí	Beuteltiere
Dlǫ́ʼiiłgaii	Hermelin
Naalʼeełí bitsiiʼ dootłʼizhí	Stockente
Sǫʼ łóóʼ	Seesterne
Giníłbáhí	Habicht
Tʼádootłʼizhii	Eichelhäher
Zhį́ʼii	Kolkrabe
Táłkááʼ tsʼin Danilínígíí	Krokodile
Chʼosh bikágí dantłʼizí	Krebstiere
Dééł	Kraniche
Chʼosh bitsʼaʼígíí	Muscheln
Łóóʼ ooshgę́ęzhii	Knorpelfische
Tániilʼáí	Libellen
Wóláchííʼ yildeełí bikágí ntłʼizí	Schuppentiere
Gah Danilínígíí	Hasenartige
Tsísʼnátsoh	Hummeln
Hazéí yiltseeʼí	Gemeine Schafgarbe
Chʼosh bikǫʼí	Leuchtkäfer
Zéédzísgaii	Fasan
Dlǫ́ʼii Ndahalinígíí	Marder
Tsin yiłkaałii	Spechte
Bideeʼtsʼinígíí	Hornträger
Dééł dóó Tóidoozohii Ndahalinígíí	Kranichvögel
Gáagii dóó Joogii Ndahalinígíí	Rabenvögel
Chʼiltaatʼagii	Kornweihe
Tsin naaʼeeł diné bee nágéhéʼ	Fähre
Gad	Wacholder
Jááłánii	Tausendfüßer
Biishchʼid Dahólónígíí	Höhere Säugetiere
Chʼosh Deildeełii	Insektenfresser
Tó wónaanídę́ę́ʼ naalʼeełítsoh łibáhígíí	Graugans
Tónteel dóó Tábąąhgi Tsídii	Regenpfeiferartige
Ńdíshchíitah dlǫ́ʼii	Baummarder
Biyaatsʼiin Dahólónígíí	Kiefermäuler
Tooh łéʼétsoh	Bisamratte
Chaatʼíní	Wiesen-Sauerampfer
Łóóʼ hashkéhé dootłʼizhígíí	Blauhai
Wóʼatsʼǫǫsii Ádaatʼéhígíí	Schnabelkerfe
Atsáłgaii	Raufußbussard
Béégashiiʼilí	Yak
Tó wónaanídę́ę́ʼ dlǫ́ʼii	Europäischer Iltis
Tsxį́į́łnaalkʼįhii	Segler (Vögel)
Dziłditłʼoii Bił Hahoodzo	San Juan County (Utah)
Hakʼaz naalʼeełí	Eiderente
Naalʼeełítsoh bitsiiʼ halzhinígíí	Kanadagans
Chʼó	Fichten
Łóóʼtsoh łizhin dóó łigaígíí	Schwertwal
Jáádtsʼósí	Säbelschnäbler (Familie)
Téél dzítsooii dóó Tsétah chʼosh	Laufkäfer
Naalʼeełítsoh diłhiłígíí	Ringelgans
Tábąąh dlǫ́ʼii	Amerikanischer Nerz
Dlǫ́ʼii bitéél halgaií	Steinmarder
Tábąąstííntsoh łibáhígíí	Kegelrobbe
Naakaii Łizhiní Bikéyahdi Hadahóólįįdígíí	Afrotheria
Diné Nááhódlóonii bizaad	Athapaskische Sprachen
Łį́į́ʼ bitsísʼná	Dasselfliegen
Tónteel tsídii	Möwen
Ałtį́į́ jikʼáshí (chʼil)	Schachtelhalme
Hazaʼaleehtsoh (dííshjį́ ááłjiní)	Echter Sellerie
Kʼaalógii dóó Iichʼąhii	Schmetterlinge
Díłdánii yił aheełtʼéhii	Wachtel (Art)
Chʼałdą́ą́ʼ / Jádí nátʼoh (chʼil daadánígíí)	Gemüsespargel
Tséʼédǫ́ʼii dootłʼizhí	Schmeißfliegen
Jaaʼabaní Danilínígíí	Fledertiere
Wóónałchídii	Schnellkäfer
Tsídii bidaanézí	Störche
Dlǫ́ʼii	Mustela
Lókʼaaʼ	Schilfrohr
Tsídiiłbáhí	Sperlinge
Biłʼeʼeliníʼ	Backpulver
Táłtłʼááh chʼoshchilí	Krill
Tsiiʼyiishbizhí Dinéʼiʼ Bikéyah	China
Naalʼeełí binááʼ łitsooígíí	Schellente
Tábąąstíín	Fischotter
Jélii łóóʼ	Qualle
Náshdóíłgaii łikizhígíí	Schneeleopard
Tábąąstííntsoh Danilínígíí	Robben
Dlǫ́ǫ́ʼ	Präriehunde
Náshdóí bijaałizhiní	Karakal
Chʼóhojilyééh	Gemeiner Stechapfel
Chʼah Diʼilii Bikéyahdę́ę́ʼ naalʼeełítsoh	Schwanengans
Tsídii yáłtiʼí	Papageien
Tééh łį́į́ʼ	Zebra
Náshdóí łikizhígíí	Ozelot
Dííłdzid jeeshóóʼ	Schmutzgeier
Tʼáadoo leʼé danílʼį́ bił hazʼą́	Museum
Shash łizhin dóó łigaígíí	Großer Panda
Shash łigaígíí	Eisbär
Gaantsʼosí	Seelilien und Haarsterne
Hastiin alą́ąjįʼ dahsidáhígíí Theodore Roosevelt	Theodore Roosevelt
Neeshchʼííłgai	Kaschu
Beeʼódleehí	Tierfalle
Dilní bee Nidaʼanéhígíí	Musikinstrument
Bikááʼ náʼoobałí	Hubschrauber
Dziʼizítsoh	Motorrad
Tééhoołtsódii	Flusspferd
Séí	Sand
Naakaii Łizhiní Bikéyahdę́ę́ʼ náshdóítsoh łikizhígíí	Leopard
Déélgééd	Nashörner
Beeʼeldííl Dahsinil	Albuquerque
Hashkʼaan dootłʼizhí (babáayah)	Papaya
Chʼil łigaii (atʼééké bijish)	Weißkohl
Náshdóítsoh	Puma
Ásáí dinéʼiʼ	Araber
Deeteel	Elch
Shádiʼááhdę́ę́ʼ náshdóítsoh łikizhígíí	Jaguar
Lókʼaatsoh	Bambuseae
Káango (Ałtsʼáʼáztiin)	Congo
Kʼaiʼ	Weiden (Botanik)
Shash bizaʼazis hólóní	Koala
Náshdóí kʼos bee naashchʼąąʼígíí	Nebelparder
Shashtsoh	Braunbär
Łéʼétsoh	Ratten
Akʼáán	Mehl
Mágítsoh	Gorillas
Bitsįʼ yishtłizhii	Indianer
Chʼil akʼahí	Avocado
Neeshchʼííłbáhí	Erdnuss
Dzidzétsoh díkʼǫ́ǫzhii	Aprikose
Naʼashǫ́ʼii łahgo ánééhé	Chamäleons
Yootó	Santa Fe (New Mexico)
Łééchąąłgaii	Greyhound (Hunderasse)
Nahatʼeʼiitsoh Bikéyahdę́ę́ʼ łééchąąʼí ałchiní	Dingo
Chʼééhjiyáán	Wassermelone
Teide	Teide
Naʼastsʼǫǫsí	Mäuse
Hakʼaz bįįh	Ren
Chʼosh doo yitʼínii	Mikroorganismus
Táshchozhii	Schwalben
Neeshchʼííʼ hááheeshchiiʼí	Mandelbaum
Łóóʼ bigaan tseebíí	Kraken
Chʼosh bikágí ntłʼizí	Krabben
Tábąąstííntsoh bideeʼ hólónígíí	Walross
Mágí diʼilí	Orang-Utans
Atsátsoh	Steinadler
Łóóʼtʼą́hí atsiniltłʼish ííłʼínígíí	Zitterrochenartige
Chʼil łitsxooí ntsxaaígíí	Grapefruit
Kʼíníjíłʼahí (dííshjį́ ááłjiní)	Stachelbeere
Kʼaalógiiłgaígíí	Weißlinge
Naʼastsʼǫǫsí binááʼ áłtsʼíísígíí	Spitzmäuse
Dzaanééz	Maultier
Tsinlátah shash łichíʼígíí	Kleiner Panda
Tsídii jáádnézí	Flamingos
Tééh łééchąąʼí	Hyänen
Łóóʼtsoh dootłʼizhígíí	Blauwal
Sóól	Ahorne
Aghaaʼ	Wolle
Deesdoigi	Tropen
Shádiʼááhdę́ę́ʼ tłʼízí	Lama (Kamel)
Mósíʼilí	Perserkatze
Lókʼaatah mósí ałchiní	Rohrkatze
Náátsʼózídę́ę́ʼ mósíłkizhii ałchinígíí	Bengalkatze
Náshdóítʼą́ʼí łikizhígíí	Serval
Tábąąh béégashii	Wasserbüffel
Béégashiitsoh naʼałkǫ́ǫ́ʼígíí	Rundschwanzseekühe
Hastiin Leiw Éíwiksson	Leif Eriksson
Akágí yitsʼǫǫsii	Egel
Anáʼálwoʼ:TʼAN (FAQ)	Hilfe:FAQ
Táłkááʼ tsʼin	Echte Krokodile
Chidítsoh	Lastkraftwagen
Dlǫ́ʼiitsoh áłtsʼózígíí	Ginsterkatzen
Gáagii	Raben und Krähen
Tó wónaanídę́ę́ʼ náshdóí	Eurasischer Luchs
Jááłánii (bitsiitsʼiin nteelígíí)	Hundertfüßer
Giní	Falken
Dahiitį́hii	Kolibris
Tsídii biyęęzhtsohígíí	Kiwis
Tązhii	Truthühner
Chʼosh (Bíígháán Ádaadinígíí)	Wirbellose
Gáagii naashchʼąąʼígíí	Racken
Mąʼii	Kojote
Dah Naatʼaʼí Sǫʼ bił Sinil	The Star-Spangled Banner
Akʼah sisíʼí tsin	Eukalypten
Gahtsoh	Echte Hasen
Bisóodi bíchį́į́h nineezí	Erdferkel
Sonora Hahoodzo	Sonora (Bundesstaat)
Nahakʼízii	Echte Grillen
Chaaʼ	Biber
Chʼilzooł	Broccoli
Kááʼtsʼiní	Gürteltiere
Atsʼiis naałdzid	Bronchialkarzinom
Yágháhoníkáángóó ałánátʼahí	Space Shuttle
Béésh náábałí atsiniltłʼish ííłʼínígíí	Windkraftanlage
Méhigo tééh	Tal von Mexiko
Shą́ą́ʼnahalghałí (naaldeehii)	Schliefer
Nahatʼeʼiitsoh łichíiʼii	Rotes Riesenkänguru
Azeeniłchin	Lippenblütler
Chʼał	Froschlurche
Tsxilghááh	Schwanzlurche
Shádiʼááhdę́ę́ʼ atsátsoh	Harpyie (Vogel)
Shádiʼááhdę́ę́ʼ chʼał kʼaasdáhígíí	Baumsteigerfrösche
Chʼał niłtólí	Glasfrösche
Chʼał dichʼízhí	Kröten
Tónteel tsídiitsoh	Albatrosse
Chidí nadlééh	Cabriolet
Chʼał atʼąąʼ nahalinii	Asiatische Krötenfrösche
Naashgalí	Mescalero
Bisóodi ałchiní	Wildschwein
Naʼastsʼǫǫsí dóó Łéʼétsoh Danilínígíí	Mäuseartige
Mariner 10	Mariner 10
Sǫʼ łóóʼ bigaanézí	Schlangensterne
Dághaałóóʼ	Welsartige
Łóóʼtʼą́hí	Plattfische
Toohjįʼ ndiigaii	Schmuckreiher
Kʼaalógii bitseeʼ hólóní	Ritterfalter
Mágí binááʼtsohígíí	Sulawesi-Koboldmakis
Ndoochííʼ	Pterospora andromedea
Tó wónaanídę́ę́ʼ dlǫ́ʼiiłkizhii	Tigeriltis
Díłdánii	Zahnwachteln
Táłtłʼááh łį́į́ʼ	Seepferdchen
Łóóʼ bíígháántsiighąąʼ ádaadinígíí	Schleimaale
Béésh Sinil	Winslow (Arizona)
Achʼįʼ Náhiłtį́į́	Safford
Tó wónaanídę́ę́ʼ dzeeh	Rothirsch
Tsézhin Deezʼáhí	St. Johns (Arizona)
Béésh Bá Hooghan	Globe (Arizona)
Kinłání (Hoozdoh Hahoodzo)	Flagstaff
Michoacán Hahoodzo	Michoacán
Tʼiisyaakin	Holbrook (Arizona)
Naʼníʼá Hótsaa	Page (Arizona)
Táłtłʼááh chʼosh daadánígíí	Caridea
Mágíshzhin	Schimpansen
Łóóʼntsxaaí łikizhígíí	Walhai
Dlǫ́ʼii yił Aheedaałtʼéhígíí	Mangusten
Béésh Bichʼahníí Bikéyahdę́ę́ʼ ayání	Wisent
Łóóʼtsoh bitsiiʼ dikʼání	Pottwal
Waaʼ (dííshjį́ ááłjiní)	Spinat
Néʼéshjaatsoh	Virginia-Uhu
Shádiʼááhdę́ę́ʼ tłʼízíʼilí	Alpaka (Kamel)
Chʼosh ditłʼooí	Raupe (Schmetterling)
Łóóʼ bigaan neeznání	Kalmare
Bijáád noodǫ́ǫzii	Okapi
Méhigo Hahoodzo	México (Bundesstaat)
Ayání	Amerikanischer Bison
Mąʼiiłgaii	Polarfuchs
Táłtłʼááh chʼosh chʼééh digháhii bideetsohígíí	Breitfußschnecken
Gólízhii Danilínígíí	Skunks
Táłtłʼááh adijiłii	Seeigel
Nahachagii	Kurzfühlerschrecken
Wóóneeshchʼįįdii (nahachaʼígíí)	Wanderheuschrecken
Tsídiitsoh ditsʼozígíí	Großer Emu
Ałhaʼdeetʼaah	Vertrag
Naayééʼ tsídii	Archaeopteryx
Tsísʼná (bitłʼizh ííłʼínígíí)	Honigbienen
Chééwokii dinéʼiʼ	Cherokee
Tsin naaʼeeł hééł bee nágéhéʼ	Frachtschiff
Ałtį́į́ jikʼáshí áłtsʼózígíí (chʼil)	Acker-Schachtelhalm
Yéigo ałhoshii	Bilche
Naʼashjéʼii bijéí dah łichíiʼii	Südliche Schwarze Witwe
Mágí dághaaʼígíí	Kaiserschnurrbarttamarin
Didzéłchííʼ	Stechpalmen
Naałání	Comanche (Volk)
Oozéí / Ayahkinii	Hopi
Toohjįʼ noołnahiitsoh	Goliathreiher
Táłtłʼááh naʼashjéʼii	Wasserspinne
Táłtłʼááh tsisteełtsoh	Lederschildkröte
Nahatʼeʼii	Kängururatten
Tsídii yáłtiʼí yázhí	Wellensittich
Tábąąh mąʼii	Waschbär
Hołchʼíʼí	Brennnesseln
Tsįdláád	Usnea
Dáághahii dinéʼiʼ	Franzosen
Shash łizhinígíí	Amerikanischer Schwarzbär
Náshdóí bizaʼazis hólóní	Beutelwolf
Shash bitéélgaígíí	Kragenbär
Chʼoshtʼą́hí	Plattwürmer
Hashtłʼish jeeshóóʼ	Bartgeier
Jádí bíchį́į́htsohígíí	Saiga
Táłtłʼááh chʼoshtsoh chʼééh digháhii	Seegurken
Tsísʼná bizǫ́ǫ́z ádinígíí	Stachellose Bienen
Chidí naatʼaʼí dilwoʼí	Jagdflugzeug
Bíchį́į́h naatsʼǫǫdí	Tapire
Tó wónaanídę́ę́ʼ mąʼii	Goldschakal
Chʼóshgai (tsin)	Weiß-Fichte
Łóóʼ Bigaan Dahólónígíí	Kopffüßer
Naʼashǫ́ʼii łóóʼ	Aalartige
Dahbaʼ (tsin)	Eschen (Pflanzengattung)
Łóóʼ hashkéhétsoh	Weißer Hai
Neeshchʼííłchííʼ	Kastanien
Chį́į́hnézí nahatʼeʼígíí	Rüsselspringer
Táłtłʼááh ayání	Dugong
Dibé Diníí Bikéyahdę́ę́ʼ náshdóí	Pardelluchs
Dził Ditłʼooí (Áshįįh Biiʼtó Hahoodzo)	Abajo Mountains
Maadíséloo	Monticello (Utah)
Kʼaiʼ Bił Hahazteel	Kanab
Toohjįʼ ndiigaiitsoh	Silberreiher
Wóóneeshchʼįįdii	Singzikaden
Dééshzhiin	Trauerschwan
Naakaii náásééł	Fangschrecken
Dlǫ́ǫ́ʼ ntsxaaígíí	Capybara
Mąʼii bijaaʼtsohí	Fennek
Dilchaʼ	Murmeltiere
Díwózhii	Sarcobatus
Náshdóí łibáhígíí	Rotluchs
Chʼilhaatʼaʼii	Merlin (Vogel)
Tééh hóyáaniitsoh	Weißwal
Jádí bideeʼ yisdizígíí	Impala
Náátsʼózídę́ę́ʼ mąʼiiłchííʼ	Rothund
Łóóʼtsoh bighą́ą́ʼ yílkʼidígíí	Buckelwal
Ghą́ą́ʼnaakiskʼidii	Trampeltier
Tábąąh mąʼiiniiʼí	Marderhund
Naʼazhǫǫsh (ndajiné dóó adazhdikaʼgi)	Spielbank
Ndikʼąʼ	Gossypium hirsutum
Dlǫ́tʼą́ʼí	Erdmännchen
Azeeʼ hókániitsoh (chʼil daadánígíí)	Artischocke
Kéchwa dinéʼiʼ	Quechua (Volk)
Mąʼii bizaʼazis hólóní	Beutelteufel
Shash bítááʼłgaígíí	Brillenbär
Jádítsoh	Großer Kudu
Naatʼáanii Moctezuma II	Moctezuma II.
Biwooʼ Ádaałtsʼíísígíí	Zahnarme
Ásáí dinéʼiʼ bikéyah	Arabische Welt
Shash yázhí	Malaienbär
Shash ndilnaʼii	Lippenbär
Teeł	Rohrkolben
Hwéeldi	Langer Marsch (Diné)
Chʼódeenínii	Stech-Fichte
Łéʼétsoh yiljaaʼí	Hahnenfuß
Hakʼaz náshdóí	Kanadischer Luchs
Mąʼii yił Ałhidanoolinígíí Yázhí	Kleinbären
Béésh Bichʼahii beʼakétłʼóól dijoolí	Kohlrabi
Nahooyéí (chʼil naʼatłʼoʼii)	Winden (Gattung)
Tłʼoh waaʼí nahalinígíí	Weiß-Klee
Tséʼésgízii	Gold-Johannisbeere
Tábąąstííntsoh dághaaʼígíí	Bartrobbe
Naakáí łizhiní	Afrikanische Kultur
Hoshdódii chʼil	Dichtblütige Kresse
Atʼééké bijish yázhí	Rosenkohl
Tsékooh	Canyon
Noodah	Agaven
Łeeʼdoolʼeezí	Sommerwurzgewächse
Kinteel Bił Hahoodzo	San Juan County (New Mexico)
Beeʼeldííl Dahsinil Bił Hahoodzo	Bernalillo County
Aniłtʼánii	Netzflügler
Kʼaalógii bijáád dį́įʼii	Edelfalter
Nímasii yiyání	Kartoffelkäfer
Awééʼchíʼí (chʼil)	Glockenblumen
Taʼaghálii	Tragant
Naaʼołí yiltʼąąʼí	Platterbsen
Azeeʼ ndootʼeezhí łibáhígíí	Gewöhnlicher Andorn
Hastóí tsiiyéélí	Waldreben
Chʼilátah atsʼos	Weidenröschen
Kʼish	Grau-Erle
Dééłjáád	Krauser Ampfer
Shį́náldzidí (chʼil bilátah hózhóón)	Löwenmäuler
Kʼįįʼ	Rhus
Naaztání	Amerikanische Gleditschie
Táłkááʼbéésh	Pfeilkraut
Tsinyaa tłʼoh	Rispengräser
Tłʼééʼ yiigáhii	Nachtkerzen
Tłʼoh deeskʼidí	Zurückgebogener Amarant
Ndootʼeezhí	Monarda (Pflanzengattung)
Wóóseekʼidii	Schwärmer (Schmetterling)
Dzílí bíláshgaan	Gewöhnlicher Reiherschnabel
Díkʼǫ́ǫ́zhí (chʼil)	Melden
Tʼąąʼdoolghasí	Gänsefingerkraut
Teełikaní	Strand-Dreizack
Láʼashdlaʼ	Selbstkletternde Jungfernrebe
Tséghániłchʼi	Portulak
Zééʼiilwoʼii	Fuchsschwanzgräser
Chéchʼil ntłʼizí yiltʼąąʼí	Gewöhnliche Mahonie
Tólchiintsoh	Sumpf-Ziest
Tséyaa hataałí	Steckrübe
Tłʼohtsʼózí	Binsen
Tłʼoh dichʼíízh	Seggen
Shashdą́ą́ʼ	Berberitzen
Tłʼoh waaʼítsoh	Weißer Steinklee
Díkʼǫ́ǫ́zhí yiltʼąąʼí	Weißer Gänsefuß
Bįįh yildeeʼí	Blasenkirschen
Kʼaalógii bitʼaʼ ndikʼąʼ nahalinígíí	Bläulinge
Hosh niteelí	Opuntien
Teeł bitʼąąʼłánígíí	Simsen (Gattung)
Chʼał nineezí	Nordamerikanischer Ochsenfrosch
Tééh hóyáanii bíchį́į́htsahí	Narwal
Mágí bíchį́į́htsohígíí	Paviane
Bįįh łikizhígíí (Béésh Bichʼahníí Bikéyahdę́ę́ʼígíí)	Damhirsch
Tábąąh ayání	Kaffernbüffel
Nátʼostsoh	Kleinblütige Königskerze
Teeł náyizí	Baltische Binse
Tólchiin (chʼil)	Acker-Minze
Dibé diníí dinéʼiʼ	Kastilier
Táłkááʼ dah yikał	Brunnenkressen
Binaʼadaałtzózí	Japaner
Kʼįįshzhíní	Virginische Traubenkirsche
Chʼil awoshí	Kali-Salzkraut
Chʼil naamaasii	Weißer Fuchsschwanz
Naʼashjéʼiichʼil	Nördlicher Mannsschild
Tłʼohdaʼaghálii	Haarästige Rispenhirse
Ahaditʼáán	Ufer-Ampfer
Yéʼiibeʼetsʼos	Dach-Trespe
Kʼaiʼ łichíʼii	Seidiger Hartriegel
Naazkaadí	Westamerikanischer Amarant
Tsáʼásziʼ nteelí	Kerzen-Palmlilie
Ostseʼ yiltʼąąʼí	Gewöhnliche Besenrauke
Ostseʼ	Ungarische Rauke
Azeediilchʼílii	Blaue Lupine
Bikétłʼóól názbąs	Drüsiges Weidenröschen
Kʼįįʼ łitsooí	Kriechende Mahonie
Dzidzé ditʼódí	Erlenblättrige Felsenbirne
Gad yił aheełtʼéhígíí	Tamarisken
Łóóʼ bíchį́į́h nineezí	Schwertfisch
Łį́į́ʼ Ndahalinígíí	Equidae
Binááʼ Ádaałtsʼózí bichʼil łigaií	Chinakohl
Kolíya Tááʼ Bikéyahą́ą	Drei Reiche von Korea
Łeehdoolʼeez łichííʼí	Rote Bete
Hashkʼaantsoh yiltʼeesígíí	Kochbanane
Iiʼnótʼį́į́	Infektion
Chʼah Diʼilii Bikéyahdę́ę́ʼ mósí ałchinígíí	Manul
Jááłánii (bikágí ntłʼizígíí)	Doppelfüßer
Iichʼąhii ntsxaaígíí	Atlasspinner
Łóóʼ ńdídzihígíí	Lungenfische
Chʼíshiibeezhii	Meisen
Giní jáádnézí	Sekretär (Vogel)
Hakʼaz néʼéshjaaʼ	Schnee-Eule
Shádiʼááhdę́ę́ʼ jeeshóóʼ	Andenkondor
Chidí naatʼaʼítsoh beeʼeldǫǫh bikǫʼ neiyéhé	Bomber
Shash bighą́ąʼgi hadzíbáhí	Grizzlybär
Kǫʼ naʼałbąąsii	Dampflokomotive
Ndíyíliitsoh	Sonnenblume
Naaʼahóóhaiłkizhígíí	Perlhühner
Tłʼiish yighání	Honigdachs
Dadilhóni aheltłʼidígíí	Handgranate
Naakaii Łizhiní Bikéyahdę́ę́ʼ łééchąąʼí ałchiní	Afrikanischer Wildhund
Aniłtʼánii (tʼááłaʼajínígoʼígíí)	Eintagsfliegen
Ayánítsoh bighą́ą́ʼaskʼidígíí	Gaur
Niinahnízaad	Nenahnezad
Máaz yikááʼ nandahí Spirit	Spirit (Raumsonde)
Naʼníʼá Hótsaadi atsiniltłʼish bá hooghan	Navajo Generating Station
Hakʼaz giníłgaii	Gerfalke
Tsétah jeeshóóʼ łibáhí	Gänsegeier
Tééh łééchąąʼí łikizhígíí	Tüpfelhyäne
Tłʼízí ałchiní	Wildziege
Yaaʼ dóó chʼosh bíchį́į́h dadichʼízhí	Kratzwürmer
Beeʼeldǫǫh	Muskete
Chʼosh bitsʼaʼígíí bigaan dahólónígíí	Armfüßer
Tʼąąʼdoolghasí (daadánígíí)	Endivie
Dlǫ́ʼii (bílaʼashdlaʼii bilį́į́ʼ)	Frettchen
Łóóʼtsoh łibáhígíí	Grauwal
Chʼah Diʼilii Bikéyahdę́ę́ʼ atsátsoh	Steppenadler
Yiisnááh	Kriegsgefangene
Dzeeh	Wapiti
Tsinlátahgi tsídii nahatʼeʼígíí	Mausvögel
Nátʼoh (chʼil)	Virginischer Tabak
Tsé Nitsaa Deezʼáhí	Rock Point (Arizona)
Tsin naaʼeeł bee daʼahijighánígíí	Schlachtschiff
Tsísʼná yiyání	Bienenfresser (Familie)
Bisóodi bizęęs dį́įʼii	Warzenschwein
Dlǫ́ʼiitsoh naalzheehígíí	Fossa
Nahachagii biyázhí	Blattläuse
Naalkʼįhiitsoh	Riesengleiter
Łóóʼ naatʼaʼí	Fliegende Fische
Hakʼaz ayání	Moschusochse
Tsétah gah	Ochotona
Mąʼiitsoh bikʼos bineʼdę́ę́ʼ łizhinígíí	Mähnenwolf
Iichʼąhiitsʼósí	Köcherfliegen
Kéyah Dańlínídę́ę́ʼ atsátsoh	Philippinenadler
Tábąąstííntsoh bíchį́į́htsohígíí	See-Elefanten
Beʼekʼid Hóteelí (Hoozdoh Hahoodzo)	Mormon Lake
Łóóʼntsxaaí díníchʼahii	Riesenhai
Chʼosh yighání	Erdwolf
Mágí bitseeʼ noodǫ́zígíí	Katta
Táyiʼ chʼoshnézí	Schnurwürmer
Dlǫ́tsʼósí łibáhígíí	Schmalstreifenmungo
Tó naagoʼ	Tropfen
Dlǫ́ʼiitsoh Danilínígíí	Schleichkatzen
Mágí bigaanézí	Gibbons
Bílaneezii	Fingertier
Séí mąʼii	Steppenfuchs
Naalʼeełítsoh bitéél halchíʼí	Rothalsgans
Tłʼízí bideeʼ yisdizígíí	Schraubenziege
Jádí	Gabelbock
Wónikǫsí	Gespenstschrecken
Tééh łééchąąʼí noodǫ́zígíí	Streifenhyäne
Tsídiiłchxoní	Hoatzin
Táłtłʼááh chʼoshtʼą́hí bikááʼtsʼinígíí	Käferschnecken
Mąʼii bighą́ąʼgi hadzíjiní	Schabrackenschakal
Naakaii Łizhiní Bikéyahdę́ę́ʼ mąʼiiłchííʼ	Äthiopischer Wolf
Tsétah dibé	Dickhornschaf
Dibé dóó Tłʼízí Ndahalinígíí	Ziegenartige
Mágí bíchį́į́h dootłʼizhígíí	Mandrill
Tó wónaanídę́ę́ʼ dibé ałchiní	Mufflon
Tsiighájíłchí	Seide (Gattung)
Bįįhyázhí biwooʼnézí	Sibirisches Moschustier
Dzeeh łikizhígíí	Sikahirsch
Tábąąh mósí ałchiní	Fischkatze
Chį́į́h yee achʼiishíhii	Sägerochen
Shádiʼááhdę́ę́ʼ hodíłchʼil mąʼii	Waldhund
Hakʼaz mágí	Japanmakak
Tsé Biiʼ Ndzisgaii	Monument Valley
Mágí bíchį́į́h niilyoolígíí	Nasenaffe
Shádiʼááhdę́ę́ʼ tsídiitsoh	Nandu
Dáádílí łibáhígí	Brauner Zackenbarsch
Ayání dóó Béégashii Danilínígíí	Rinder
Náátsʼózídę́ę́ʼ mósíłtsxooí ałchinígíí	Asiatische Goldkatze
Łóóʼnteeltsoh	Mondfisch
Gaanłáníchilí dóó Gaanłání doo yitʼíinii	Süßwasserpolypen
Atłʼóóh	Weben
Chʼoshkʼaaʼ	Pfeilwürmer
Tábąąh bįįh	Wasserreh
Hodíłchʼil jeeshóóʼ	Königsgeier
Dlǫ́ǫ́ʼ bitseetłʼooígíí	Eigentliche Chinchillas
Achʼąąʼ adáʼatsʼiʼ	Impfung
Néʼéshjaaʼ bíńdáhii	Sperbereule
Bitseeʼ yee adiłhałii	Mississippi-Alligator
Jádítsoh noodǫ́zígíí	Bongo (Antilope)
Níyolgi naatʼaʼígíí (tónteel tsídii)	Sturmschwalben
Tádídíín yiyání	Blattkäfer
Tsídiidaashiyishí	Ibisse
Shádiʼááhdę́ę́ʼ łéʼétsoh bitseeʼ ádinígíí	Agutis
Chʼosh bitsʼaʼłáaʼii	Einschaler
Naʼashǫ́ʼii łóóʼ hashkéhé	Kragenhai
Jeeshóóʼ	Kalifornischer Kondor
Táłkááʼ chʼó	Schmalblättriger Merk
Chʼosh dilwoʼígíí	Sandlaufkäfer
Chʼosh doo yitʼíinii bee nílʼíní	Mikroskop
Tsin ditʼinii	Ziesel
Joogii	Blauhäher
Łeeyiʼ nahakʼízii	Maulwurfsgrillen
Náátsʼózídę́ę́ʼ naalʼeełí	Mandarinente
Mąʼii bijaaʼabanígíí	Löffelhund
Yéʼii bitsáʼásziʼ	Seifen-Palmlilie
Tsídiitsoh bikʼos dootłʼizhí	Kasuare
Atsiniltłʼish ííłʼíinii (naʼashǫ́ʼii łóóʼ)	Zitteraal
Dįʼ	Raufußhühner
Niicháadii (łóóʼ)	Kugelfische
Tééhoołtsódiichilí	Zwergflusspferd
Kʼiiznoodǫ́ǫzii (tsin yigházhígíí)	Pakas
Wóláchííʼ yildeełítsoh	Großer Ameisenbär
Dibéʼniiʼí	Zimtbauch-Phoebetyrann
Bináʼadaałtsózí bitsin naaʼeeł	Dschunke
Níłtsą́goʼ (bideeneezígíí)	Bockkäfer
Tséʼédǫ́ʼii bitsiinézí	Schnabelfliegen
Tłʼohtahgi díłdánii yił aheełtʼéhii	Laufhühnchen
Łóóʼyiniʼįįhí (tónteel tsídii)	Raubmöwen
Shádiʼááhdę́ę́ʼ tó hóyáanii	Amazonasdelfin
Binaʼadaałtsózí dinéʼi	Orient
Łóóʼ adishishí	Stechrochen
Tsin yąąh dzootʼihí	Kleiber (Familie)
Atʼaʼ yiltʼąąʼí dah sidáhígíí (chʼosh ntsxaaígíí)	Palmendieb
Yółeehii	Armflosser
Tiníléí	Gila-Krustenechse
Dijádídlǫ́ʼí	Ohrenlerche
Tłʼoh	Rasen
Dinas	Echte Bärentraube
Mąʼii bikʼiizgi hadzíjiní	Streifenschakal
Yadiizį́įgo ayání	Giraffengazelle
Télii bijáád noodǫ́zí	Afrikanischer Esel
Bitsʼáá bidaʼhodiʼniil	Verbrannte Erde
Mágíłchííʼ	Goldenes Löwenäffchen
Dááʼadeeʼii	Löffler (Unterfamilie)
Łóóʼ hashkéhé bitsiiʼ dikʼání	Hammerhaie
Taahilnoodii	Tölpel
Kʼíneedlíshii adiłhashígíí	Schröter (Käfer)
Łééh yidi tóʼígíí	Grundwasserleiter
Naʼashǫ́ʼiitsoh naʼałkǫ́ʼígíí	Meerechse
Tsídiisháshii	Seidenschwänze
Naakétłʼáhí	Pima
Yaaʼ bitsʼaʼígíí	Schildläuse
Daateel	Kahnschnabel
Tééh łééchąąʼí ditsʼozígíí	Schabrackenhyäne
Tsétaʼ łį́į́ʼ	Mustang (Pferd)
Kénézí	Blatthühnchen
Neeshchʼííʼ	Pinienkern
Naalʼeełítsoh yił aheełtʼéhii łizhin dóó łigaiígíí	Spaltfußgans
Mąʼii chʼil	Goldruten
Yaadaaʼnézí (tónteel tsídii)	Scherenschnäbel
Tsídii disxǫsígíí	Glanzvögel
Náátsʼózídę́ę́ʼ mósíłchíiʼii ałchinígíí	Borneo-Goldkatze
Shádiʼááhdę́ę́ʼ tsétah mósí ałchinígíí	Bergkatze
Tsinlátahgi dlǫ́ʼiitsoh	Binturong
Jeeshóóʼ łizhinígíí	Rabengeier
Naałʼashí	Vogelspinnen
Dééłdą́ą́ʼ	Adlerfarn
Hashkʼaan yildeełígíí (tsídii)	Turakos
Łį́į́chilí	Shetlandpony
Daakʼį́į́ʼ	Brachvögel
Mąʼiiłtsooí łibáhígíí	Graufuchs
Naʼashǫ́ʼiitsoh dootłʼizhígíí	Grüner Leguan
Chidí bikéíjį́ʼ adeizʼááhígíí	Pick-up
Bįįh bitseełgaiígíí	Weißwedelhirsch
Wónitłʼizí	Landasseln
Díʼdikii (jádí)	Dikdiks
Hakʼaz mąʼiitsoh	Polarwolf
Dark Ages	Dunkle Jahrhunderte
Ndikʼąʼ biyaʼ	Baumwollkapselkäfer
Tłʼoh naadą́ą́ʼ biyaʼ	Kornkäfer
Łeeyiʼ jááłániichilí	Wenigfüßer
Aniłtʼánii (bikʼosnézí)	Kamelhalsfliegen
Naaʼołí biyaʼ	Samenkäfer
Ááhooshtʼįįh	Kapitulation
Tséʼédǫ́ʼii dishooí	Schwebfliegen
Bichʼah Dootłʼizhii	Friedenstruppen der Vereinten Nationen
Dlǫ́ʼii łizhin dóó łitsooígíí	Buntmarder
Chʼosh ałchozhii (chéłchaaʼ)	Speckkäfer
Łeʼesoołii (bitseeʼ naakiígíí)	Doppelschwänze
Dlǫ́ʼátsoh	Waldmurmeltier
Chʼééh digháhii dóó Tsisteeł	Schildkröten
Tááʼyaʼniiltʼóshii	Kardinäle
Łóóʼ bigaanłánígo bitsʼaʼígíí	Perlboote
Łeʼesoołii (bitseeʼ tááʼígíí)	Zottenschwänze
Tłʼézhii	Bremsen
Tániilʼáítsʼóóz	Kleinlibellen
Naashtʼézhí	Zuñi (Volk)
Aniłtʼániitsʼóóz	Ameisenjungfern
Tó wónaanídę́ę́ʼ hazéí bíchį́į́hnézí	Spitzhörnchen
Hakʼaz gah	Polarhase
Bįįh łikizhígíí (Naakaii Dootłʼizhii Bikéyahdę́ę́ʼígíí)	Axishirsch
Nahashchʼidí (naaldeehii)	Silberdachs
Bisóodi bideeʼ názhahígíí	Hirscheber
Tsídii bichʼahtsooígíí	Doppelhornvogel
Shádiʼááhdę́ę́ʼ bisóodi diʼilígíí	Nabelschweine
Náʼagéédí bizaʼazis hólóní	Beutelmulle
Bilagáana	Europid
Tłʼézhiiłbáhí	Raupenfliegen
Shash nátʼoh	Erd-Burzeldorn
Jádítsoh diłhiłígíí	Nyala (Antilope)
Jádítsoh bideeʼ shiyishígíí	Rappenantilope
Dlǫ́ʼiitsoh łikizhígíí	Afrikanische Zibetkatze
Tsinaʼayąʼii yildeełí	Numbat
Tsétah tłʼízí	Schneeziege
Jááłániichilí bighádzígaiígíí	Zwergfüßer
Gahchilí	Zwergkaninchen (Art)
Tsiishgaii	Zwergkleiber
Cháʼoł bidahtsʼaaʼ	Zwergmisteln
Tsį́į́łkaałiichilí	Zwergspechte
Dééłgai bitsiiʼ halzhinígíí	Schwarzhalsschwan
Chʼosh nahachagii	Zwergzikaden
Hóółtseiigi naʼastsʼǫǫsí	Rennmäuse
Gaanłání	Zylinderrosen
Dibédą́ą́ʼ	Büffelbeeren
Tádídíín yiyání łichíʼígíí	Lilienhähnchen
Laanaa Yáʼátʼéehgo Késhmish	We Wish You a Merry Christmas
Naʼazǫ́ǫzii	Ameisenwespen
Jáád neishoodí (naʼashjéʼii haalzheehígíí)	Wegwespen
Naalʼeełí bidaatsʼózí	Säger
Chį́į́shłigaií (bílaʼashdlaʼii bilį́į́ʼ)	Hausgans
Nahatʼeʼiitsoh Bikéyahdę́ę́ʼ naalʼeełítsoh łibáhígíí	Hühnergans
Dahsánítsoh	Gewöhnliches Stachelschwein
Naʼastsʼǫǫsí bitseeʼ dichʼízhí	Stachelmäuse
Tsétah nahatʼeʼiitsoh	Felskängurus
Táłkááʼ dilwoʼí	Wasserläufer
Akáshtʼóózh biyaʼ	Staubläuse
Łeʼesoołii (bideeʼ ádinígíí)	Beintastler
Ąąʼąʼii	Echte Elstern
Jádí bideeʼ dį́įʼii	Vierhornantilope
Táłtłʼááh chʼosh ntsxaaígíí	Japanische Riesenkrabbe
Mósí ałchiní bitsiiʼtʼąhígíí	Flachkopfkatze
Naakaii Łizhiní Bikéyahdę́ę́ʼ naalʼeełítsoh dibéłchíʼígíí	Nilgans
Hosh aditsahiitsoh	Carnegiea gigantea
Tʼáá łichíʼígo náʼagéédí	Nacktmull
Tsisteeł łizhinígíí	Köhlerschildkröte
Tééh jeeshóóʼ	Weißrückengeier
Iichʼąhii noodǫ́zí	Hyles lineata
Ghą́ą́ʼnoodǫ́ǫzii (tsin yigházhígíí)	Pakarana
Tsáʼásziʼ bideeʼí	Blaue Palmlilie
Łéʼétsoh beeniʼíhoniitaahígíí	Echte Meerschweinchen
Naʼashǫ́ʼii dichʼízhii	Krötenechsen
Chéłchaaʼ bikʼosnézí	Giraffenhalskäfer
Ásaaʼ neiyéhii	Ölkäfer
Naʼashǫ́ʼiitsoh łitsooígíí	Drusenkopf
Shádiʼááhdę́ę́ʼ tiníléí	Skorpion-Krustenechse
Sahdii Bisí (Tsé Nástánii)	Petrified-Forest-Nationalpark
Tsé Bighánílíní	Antelope Canyon
Naakaii Dootłʼizhii bimósí ałchinígíí	Rostkatze
Naʼashǫ́ʼiiłchííʼ dootłʼizhígíí	Agama mwanzae
Kʼaabizhii	Mammillaria
Dahiitį́hídą́ą́ʼtsoh	Castilleja
Wálázhini	Messor
Dlǫ́ʼbéʼézhóóʼ	Aristida
Chʼil abeʼéntsxaaí	Asclepias tuberosa
Jádí yildeeʼí	Asclepias asperula
Ndilkal (chʼil)	Cucurbita foetidissima
Chʼįdą́ą́ʼ	Säckelblumen
Dlǫ́ʼii nátʼoh	Nicotiana attenuata
Jáád neishoodí (łeyiʼdi bighanígíí)	Sphex
Haashchʼéʼédą́ą́ʼ	Lycium pallidum
Dáʼághálii	Crotalaria
Chʼil abeʼétsoh	Asclepias speciosa
Chʼał bikʼos ádinígíí	Nasikabatrachus sahyadrensis
Jéí náyoogisii	Echinocereus
Chʼiidą́ą́tsʼóóz	Vicia americana
Tłʼiish bideeʼtsʼóóz	Asclepias verticillata
Tłʼohtah náshdóí	Leopardus pajeros
Tsídii naʼałkǫ́ʼígíí	Fratercula
Tsisteeł diyogí	Fransenschildkröte
Haʼagizh	Abiquiú
Łóóʼ adishishí ntsxaaígíí	Riesenmanta
Tónteel bibąąh hóyáanii	Glattschweinswal
Naakaii Łizhiní Bikéyahdę́ę́ʼ tsétah dibé	Mähnenspringer
Náhookǫsdę́ę́ʼ dlǫ́ʼii	Fichtenmarder
Naalʼeełí naashchʼąąʼígíí	Brautente
Tsinlátah nahatʼeʼiitsoh	Baumkängurus
Tsin naaʼeeł łóó beeʼháʼhaalʼééłiʼ	Trawler
Chʼosh biyaʼ	Fächerflügler
Táłtłʼááh chʼosh	Schwimmkäfer
Hastiin John Goodwin	John Noble Goodwin
Gáagii dinéʼiʼ	Absarokee
Shádiʼááhdę́ę́ʼ tábąąstííntsoh	Mähnenrobbe
Táłtłʼááh álééh	Kanadareiher
Tsísʼnáłtsooítsoh	Hornissen
Táłtłʼááh naakaii náásééł yił aheełtʼéhii	Fangschreckenkrebse
Náátsʼózídę́ę́ʼ tsiiłtsooí	Goldfasan
Bisóodi Danilínígíí	Schweineartige
Atsiniltłʼish yiltʼąąʼí	Blauer Holunder
Gólízhii noodǫ́zígíí	Streifenskunk
Tó bichʼosh (séigoʼ nahalinígíí)	Wasserskorpion
Naʼastsʼǫǫsí bijaaʼntsxaaígíí	Großer Kaninchennasenbeutler
Tsʼání	Nacktschnabelhäher
Chʼééh digháhii bitsʼaʼ yilzhólí	Weichschildkröten
Chį́į́shghą́ʼiiłgaii	Carolinakleiber
Hastiin Diego de Landa	Diego de Landa
Hastiin Biʼééʼ Łichíiʼii	Kit Carson
Tábąąstííntsoh (Akééháshį́į́dę́ę́ʼígíí)	Kalifornischer Seelöwe
Mósí bizaʼazis hólóní	Beutelmarder
Tségad	Moosfarne
Naaʼołí	Bohne
Tsįyaalzhahí	Eckschwanzsperber
Hashtłʼishdi chʼééh digháhii	Schlammschildkröten
Yaaʼ nahachagiígíí	Flöhe
Kéʼ łizhiní	Blackfoot
Tábąąsdísí áłtsʼíísí	Drosseluferläufer
Náátsʼózídę́ę́ʼ toohjįʼ ndiigaii	Schneereiher
Dlǫ́ʼii łizhiní	Schwarzfußiltis
Wóláchííʼ yildeełí łizhin dóó łigaígíí	Tamanduas
Lókʼaatah bisóodi	Buschschwein
Hodíłchʼil tłʼízí	Südlicher Serau
Hakʼaz Dineʼé Bikéyahdę́ę́ʼ tábąąstííntsoh	Stellerscher Seelöwe
Dziłtah dlǫ́ʼii	Altaiwiesel
Naayééʼ tsídiitsoh	Moa
Aghaałą́	El Capitan (Arizona)
Atseełtsoii	Rotschwanzbussard
Tóniłhę́ęshii (dééł)	Schreikranich
Naaltsoos Mormon Wolyéhígíí	Buch Mormon
Téél halchíʼí	Wanderdrossel
Dlǫ́ʼátah néʼéshjaaʼ	Kaninchenkauz
Naʼashǫ́ʼii bijáád ádinígíí	Doppelschleichen
Dził Ashdlaʼii	La Sal Mountains
Naʼatłʼoʼii (chʼosh)	Tarsenspinner
Dííłdzid yiyání	Kurzflügler
Tsintah łéʼétsoh	Amerikanische Buschratten
Kʼiishzhinii (tsin)	Amerikanische Hainbuche
Tʼiisbáí	Amerikanische Zitterpappel
Yáhashjool yázhí	Amerikanische Zwergdommel
Tłʼéeʼgo mágí	Nachtaffen
Náʼagéédíchilí	Amerikanischer Spitzmull
Tsʼíʼii jáádnézí	Schnaken
Chʼil ditsʼozíłchííʼ	Rambutan
Mágíłtsooí bináázhiní	Gewöhnlicher Totenkopfaffe
Taʼneeskʼání	Cantaloupe-Melone
Tsídiiłtsooí bitʼaʼ łizhinígíí	Goldzeisig
Tsʼíʼii noodǫ́zí	Asiatische Tigermücke
Bitseeʼ yee adiłhałii yázhí	Kaimane
Anaasází	Anasazi
Chʼééh digháhiitsoh	Galápagos-Riesenschildkröte
Tsineeshbízhii	Andenbaumläufer
Yeenaʼałkǫ́ʼíłániichilí	Remipedia
Naʼnízhoozhí Bił Hahoodzo	McKinley County
Mąʼii Deeshgiizh Bił Hahoodzo	Sandoval County
Naatoohí Bił Hahoodzo	Cibola County
Tábąąstííntsoh łikizhígíí	Largha-Robbe
Ooljééʼ yiikááʼ nandahí	Mondlandung
Tsoodził	Mount Taylor
Toohjįʼ noołnahii yázhí	Grünreiher
Báshdo	Barstow (Kalifornien)
Łóóʼ hashkéhé bíchį́į́hnézí	Koboldhai
Tłʼiishtsiiʼí (łóóʼ)	Schlangenkopffische
Tʼąąʼnteelí	Schokoladenblume
Chéłchaaʼ bideeneezígíí	Herkuleskäfer
Déłí	Kanadakranich
Ąąʼąʼiiłbáhí	Blauelster
Tsétah chaaʼ	Stummelschwanzhörnchen
Sighóla	Socorro (New Mexico)
Chéłchaaʼ disxǫsígíí	Prachtkäfer
Naalʼeełí dootłʼizhí	Blauflügelente
Béíyózhin	Paiute
Tsin naabąąs	Planwagen
Dlǫ́tsʼósí łichííʼígíí	Ringelschwanzmungo
2010 yihahígíí bílaʼashdlaʼii náóltahígíí	United States Census 2010
Jádídlǫ́ʼii	Hauszaunkönig
Tłʼohchintó	Hotevilla-Bacavi
Tséʼédǫ́ʼii	Echte Fliegen
Dahsání dah Yikahjí Tsin Deigházhígíí	Stachelschweinverwandte
Gad niʼeełí	Rocky-Mountain-Wacholder
Níyolgi naʼałkǫ́ʼígíí (tónteel tsídii)	Tauchsturmvögel
Tsinaʼayąʼii biyázhí	Bodenläuse
Sóól dichʼíizhii	Kahler Ahorn
Tseekʼi nástánii	Antilopenziesel
Tłʼízíʼilí	Angoraziege
Naatooh Sikʼaiʼí	Grants
Tsooʼtsʼiní (łóóʼ)	Knochenzüngler
Tsinaʼayąʼii	Termiten
Náʼagéédí bíchį́į́h sǫʼ nahalinígíí	Sternmull
Naaléełchííʼ	Arasittich
Naaʼahóóhai disxǫsígíí	Glanzfasanen
Tsįyaatsiiłchííʼ	Rubintyrann
Náhookǫsdę́ę́ʼ tsétah dibé	Dall-Schaf
Naʼnízhoozhí	Gallup (New Mexico)
Łóóʼ binááʼtsohí	Großaugenbarsche
Tsisteeł bikʼosneezígíí	Schlangenhalsschildkröten
Kilim	Kelim
Táłtłʼááh wónitłʼizí	Wasserassel
Beʼekʼid Halchííʼ	Red Lake (New Mexico)
Naatsisʼáán bińdíshchííʼ	Biegsame Kiefer
Chąąneiłhizii	Stutzkäfer
Tʼáyaałtso	Wüstengoldspecht
Nákʼeʼnáʼijiní	Kanadakleiber
Ałtaʼneetsʼéhii	Spitzkletten
Wáláchíʼétah nahachagiichilí	Ameisengrillen
Yáhashjool yił aheełtʼéhii	Sonnenralle
Tsintah bisóoditsoh	Riesenwaldschwein
Zééjíjinii	Halsband-Wehrvogel
Dziłghą́ʼiʼ	Westliche Apachen
Naʼníʼá Hayázhí	Cameron (Arizona)
Kááʼtsʼiní ditłʼooígíí	Borstengürteltiere
Naalkʼįhíchilí (bizaʼazis hólónígíí)	Australischer Zwerggleitbeutler
Dlǫ́ʼii yił aheełtʼéhii łibáhígíí	Indischer Mungo
Adijiłii yił aheełtʼéhí	Kleiner Igeltenrek
Łóóʼ hashkéhé bitseeneezígíí	Gemeiner Fuchshai
Chį́į́shłigaií dóó Naalʼeełítsoh	Gänse
Jádí biniiʼtsʼózí	Kuhantilope
Tábąąh jádí	Wasserbock
Jádí binááʼ dį́įʼii	Hunter-Antilope
Tó wónaanídę́ę́ʼ dlǫ́ʼáyázhí	Europäischer Ziesel
Ásáí Dineʼé Bikéyahdę́ę́ʼ mąʼiitsoh	Arabischer Wolf
Dlǫ́iitsoh bíchį́į́hdzísgaiígíí	Larvenroller
Sǫʼ tsisteeł	Strahlenschildkröte
Nahatʼeʼiitsoh Bikéyahdę́ę́ʼ tązhii	Buschhuhn
Mąʼii dootłʼizhí	Nordamerikanisches Katzenfrett
Táłkááʼ dilwoʼítsʼóóz	Teichläufer
Chʼoshtsoh bíláshgaantsohí łikizhígíí	Riffhummer
Łeʼesoołii (nahachaʼígíí)	Felsenspringer
Tóidoozohii bidaaʼ łigaiígíí	Blässhühner
Chéłchaaʼtsoh	Riesenkäfer
Wódisxǫsí	Schildwanzen
Mąʼii Deeshgiizh	Jemez Springs
Tsisteeł hashkéhé	Alligatorschildkröten
Naʼastsʼǫǫsí bizaʼazis hólóní	Breitfuß-Beutelmäuse
Wáláchííʼ	Rote Gartenameise
Tsídiidą́ą́ʼ	Flammenblumen
Wóniłchxoní	Baumwanzen
Tsiikʼánii (tsídii)	Hammerkopf (Vogel)
Nahatʼeʼii niłchxoní	Moschusrattenkänguru
Náátsʼózídę́ę́ʼ tsiidootłʼizhii	Argusfasan
Ábishjaaʼ (daadánígíí)	Speisepilz
Tábąąh bisóodiłchíiʼii	Pinselohrschwein
Kéyah Dańlínídę́ę́ʼ naalʼeełí	Philippinenente
Tiníléítsoh naʼałkǫ́ʼígíí	Bindenwaran
Kézhoozhʼilí (tsin yigházhígíí)	Kammfinger
Jádí bideeneezígíí	Oryxantilopen
Beehai	Jicarilla
Dáádílí łikizhígíí	Pantherfisch
Mágíłbáhí	Diademmeerkatze
Jaaʼditłʼoʼí naalkʼįhígíí (bizaʼazis hólónígíí)	Riesengleitbeutler
Nahatʼeʼiitsoh yázhí	Filander
Tóshchíín / Naadą́ą́ʼ dootłʼizhí	Mehlsuppe
Séí tiníléítsoh	Goulds Waran
Dlǫ́ʼii yił aheełtʼéhítsʼózí	Schlankmanguste
Tółání	Laguna (New Mexico)
Łóóʼ bigháhootʼíní	Glasbarsche
Tʼiis	Pyramidenpappel
Tónhidigaii	Silverton (Colorado)
Chʼosh áłtʼą́ą́ʼígíí	Bodenwanzen
Dééłtsoh	Riesentrappe
Shádiʼááhdę́ę́ʼ dahsání	Cuandu
Dlǫ́ʼii bitseenézí	Langschwanzwiesel
Kéyahígíí nidineesdzaʼ	Dust Bowl
Nahachagii dootłʼizhí	Laubheuschrecken
Tsé Bíyah Aniiʼáhí	Chaco Culture National Historical Park
Nahatʼeʼiitsoh Bikéyahdę́ę́ʼ biyázhí neiyéhé	Fuchskusu
Naaʼahóóhaiłbáhí	Rebhühner
Tsísʼnádą́ą́ʼ	Kokardenblumen
Jeeshóóʼ ałchozhígíí	Palmgeier
Łóóʼ adiłdoní	Schützenfische
Dlǫ́ʼii yił aheełtʼéhii łitsxooígíí	Fuchsmanguste
Naakaii Łizhiní Bikéyahdę́ę́ʼ nahatʼeʼii	Springhase
Táłtłʼááh chʼosh chʼééh digháhii bitsʼaʼ ádinígíí	Nacktkiemer
Tiníléítsoh noodǫ́zígíí	Nilwaran
Naʼashǫ́ʼii bideewozhii	Uromastyx
Chʼał ntsxaaígíí	Goliathfrosch
Tééh naaʼahóóhaitʼą́ʼí	Frankoline
Naalʼeełí (bílaʼashdlaʼii bilį́į́ʼ)	Hausente
Yáhashjool	Nordamerikanische Rohrdommel
Dlǫ́ʼii yił aheełtʼéhii yázhí	Südliche Zwergmanguste
Nahatʼeʼiitsoh Bikéyahdę́ę́ʼ tábąąstííntsoh	Australischer Seelöwe
Mąʼiiłtsooí yázhí	Kitfuchs
Gałbáhí	Baumwollschwanzkaninchen
Naʼazísí Toʼí	Cuba (New Mexico)
Tsékááʼgóó naagháhii (chʼosh)	Gladiatoren
Tłʼohtahilzhahí	Seriemas
Táłtłʼááh tsxilghááhtsoh	Riesensalamander
Dibé dághaaʼígíí	Japanischer Serau
Chʼééh digháhii bitsiiʼntsxaaígíí	Großkopfschildkröte
Tsékʼi naʼałkǫ́ʼii	Pyrenäen-Desman
Naʼastsʼǫǫsítsoh (chʼosh yildeełígíí)	Dominikanischer Schlitzrüssler
Tsídiiłtsooí	Gold-Waldsänger
Chʼagii	Rotschulterstärling
Łéʼétsoh diwozhí	Großer Rattenigel
Łéʼétsoh bizaʼazis hólóní	Doppelkamm-Beutelmaus
Dlǫ́ʼiitsoh noodǫ́zígíí	Bänderroller
Tábąąstííntsoh łizhin dóó łigaiígíí	Bandrobbe
Jeeshóóʼ bitsiiłgaiígíí	Wollkopfgeier
Tábąądijádí	Keilschwanz-Regenpfeifer
Shádiʼááhdę́ę́ʼ niłchiis	Grisons
Naʼazísí	Taschenratten
Łeeyiʼ chʼał dichʼízhí	Nasenkröte
Naatsisʼáán	Navajo Mountain
Táłtłʼááh naatʼáʼii	Flughähne
Naakaii Dootłʼizhí Dabikéyah	Südasien
Ńdaʼatʼaałii bideeʼ dahólónígíí	Stirnwaffenträger
Sháńdíín bitsʼą́ą́dę́ę́ʼ atsiniltłʼish álʼį́	Solarmodul
Naaldlooshii	Quadrupedie
Naʼashǫ́ʼii kááʼtsʼinígíí	Panzergürtelschweif
Kinteel (Yootó Hahoodzo)	Aztec (New Mexico)
Néʼétsah azeeʼ	Kanadisches Berufkraut
Naʼastsʼǫǫsí bitsʼohígíí	Streifentenreks
Atsá diłhiłígíí	Malaienadler
Hastiin Dághaaʼ (Barboncito)	Barboncito
Bisóodi dághaaʼígíí	Bartschwein
Dólii	Berghüttensänger
Kin Noodǫ́ǫ́z	Bernalillo
Hashtłʼishdi tádíʼnéehii	Schlammspringerverwandte
Tsiikʼánii (łóóʼ ooshgę́ęzhii)	Geigenrochen
Biniiʼdootłʼizh	Sperlingskäuze
Mágí biniiłgaígíí	Weißkopfsaki
Wónaʼałtéhii	Raubfliegen
Tłʼoh azihii	Meerträubel
Kʼaalógii bitʼaʼ disxǫsgo łikizhígíí	Würfelfalter
Tiníléítsoh bikʼosnézí	Wüstenwaran
Shádiʼááhdę́ę́ʼ gahniiʼí ntsxaaígíí	Pampashasen
Łéʼétsoh bitseetłʼooígíí	Felsenratte
Tsídii bizééʼ naashchʼąąʼí	Tragopane
Tábąąsdísíłbáí	Schlammläufer
Dilzhę́ʼii	Diademhäher
Mágí naashchʼąąʼígíí	Rotschenkliger Kleideraffe
Chʼosh naʼałkǫ́ʼí	Wasserkäfer
Tééh jádítsoh	Elenantilopen
Łeeyiʼ bitiiní	Wühlmäuse
Atsáłbáí	Präriefalke
Dáádílítsoh	Riesenzackenbarsch
Tsédááʼ sikaadí	Falsche Alraunenwurzel
Tsétah bįįhchilí	Pudus
Iichʼąh	Konvulsion
Kiisʼáanii	Pueblo-Kultur
Jeeshóóʼ bitsiiłtsooí	Kleiner Gelbkopfgeier
Dlǫ́ʼii noodǫ́zígíí	Weißnackenwiesel
Tiníléítsoh dootłʼizhígíí	Smaragdwaran
Yáázhłání (naaldlooshii)	Großer Tenrek
Łéʼétsoh yił aheełtʼéhii	Trugratten
Tábąąh łéʼétsoh	Goldbauch-Schwimmratte
Ghą́ą́ʼdiʼilii (tsin yigházhígíí)	Mähnenratte
Lókʼaaʼ yigházhígíí	Rohrratten
Tsídii bitʼaʼ dah adadootłʼizhígíí	Pfaufasane
Dichin	Unterernährung
Chį́į́hʼadeeʼii (łóóʼ)	Löffelstöre
Hazéíntsxaaígíí	Riesenhörnchen
Kéyah Dańlínídę́ę́ʼ bisóodi bizęęs hastání	Visayas-Pustelschwein
Dzílí	Rundschwanzsperber
Dah Naatʼaʼí Bééhoʼdílzin	Pledge of Allegiance
Tó bichʼosh (tsiiyaago naʼałkǫ́ʼígíí)	Rückenschwimmer
Tónteel táshchozhii	Seeschwalben
Naʼastsʼǫǫsí noodǫ́zígíí	Streifengrasmäuse
Tówoł	Taos (New Mexico)
Díchʼíító	Bitter Springs (Arizona)
Kʼish biyaʼ dootłʼizhígíí	Blauer Erlenblattkäfer
Tsáʼásziʼtsʼóóz	Blaugrüne Palmlilie
Dóliiłchííʼ	Blaukehl-Hüttensänger
Łóóʼ binááʼ ádiní	Blindfische
Naabiʼání	Bloomfield (New Mexico)
Tséłgaii Deezʼáhí	Bluff (Utah)
Chʼil bilátah hózhóón	Blume
Aniłtʼánii (nahakʼízígíí)	Blütengrillen
Tsin naabąąs yazhí	Bollerwagen
Aniłtʼánii łizhinígíí	Schlammfliegen (Familie)
Mágí bichį́į́łgaígíí	Rotschwanzmeerkatze
Tábąąh chʼosh	Uferwanzen
Naakaii Bikéyahdę́ę́ʼ bįįh yázhí	Spießhirsche
Naʼashǫ́ʼii dootłʼizhí (naaldeehii)	Halsbandleguan
Naʼashǫ́ʼiiłbáhí	Wüstenleguan
Dlǫ́tsʼósí noodǫ́zígíí	Großer Breitstreifenmungo
Łéʼétsoh gahjaaʼígíí	Votsotsa
Chʼoshtsoh bíláshgaanʼilí	Yeti-Krabbe
Anáʼálwoʼ:Bee hadítʼéhígíí	Hilfe:Übersicht
Deinihootso	Dennehotso
Táłtłʼááh chʼoshtsoh bideeneezí	Langusten
Táshchozhiizhiin	Schwarzkopf-Phoebetyrann
Moháábii dinéʼiʼ	Mohave
Kin Łichííʼ (Kiisʼáanii bikin)	San Juan (Volk)
Néʼéshjaaʼkálii	Elfenkauz
Chaaʼ Bitoʼ	McNary (Arizona)
Tsídii bitʼaʼ hózhóón	Eigentliche Paradiesvögel (Gattung)
Tiníléítsoh łikizhígíí	Riesenwaran
Tiníléítsoh bíchį́į́h dikʼání	Weißkehlwaran
Tsé noolchʼóshiiłbáhí	Felsenzaunkönig
Dloziłgaii	Rothörnchen
Tsísʼná dootłʼizhí	Goldwespen
Halchíítah	Painted Desert
Wóósitsʼílí	Bettwanze
Tsé Nikání	Round Rock (Arizona)
Biizhii	Falkennachtschwalbe
Tsidiłdǫǫhii	Kreischeulen
Dághaaʼ Łichííʼ	Kirtland (New Mexico)
Tábąąh ndoochííʼ	Grünblütiges Wintergrün
Kǫʼ naʼałbąąsii hééł bee nágéhéʼ	Güterzug
Tádídíín dootłʼizh áłtsʼíísí	Einblütige Glockenblume
Dlǫ́ʼiitsoh bizééʼ noodǫ́zí	Malaiische Zibetkatze
Jaaʼabaní	Fledermäuse
Chʼosh chʼééh digháhii bideeʼ dį́įʼii	Landlungenschnecken
Wóláchííʼ yildeełí	Ameisenbären
Niłchʼiʼ bee naalkaahiʼ	Geostationary Operational Environmental Satellite
Tséʼédǫ́ʼii łibáhígíí	Fleischfliegen
Hastiin Chʼil Haajiní (Manuelito)	Manuelito
Tó Sido Háálį́	Pagosa Springs
Aniłtʼánii (naakaii náásééł nahalinígíí)	Fanghafte
Tsisteeł naʼazísí	Gopherschildkröten
Tó Diłhił Biih Yílį́	Snowflake (Arizona)
Yoołgai (Hoozdoh Hahoodzo)	Superior (Arizona)
Tsé Noodǫ́ǫ́z	Springerville
Kin Łání (Dibé Nitsaa Hahoodzo)	Durango (Colorado)
Tségháhoodzání	Window Rock
Tsé Yaatóhí	Cortez (Colorado)
Tótaʼ	Farmington (New Mexico)
Tó Naneesdizí	Tuba City
Táłtłʼááh chʼoshtsoh bideeteelí	Bärenkrebse
Tséhootsooí	Fort Defiance (Arizona)
Chʼínílį́	Chinle
Lókʼaaʼdeeshjin	Keams Canyon
Tséyiʼ (Chʼínílį́įgiʼígíí)	Canyon de Chelly National Monument
Chʼoshtsoh bíláshgaantsohí (tónteelgiʼígíí)	Hummerartige
Kʼaiʼbisii	Wilson-Drossel
Dlǫ́ʼiiłtsooí	Japanischer Marder
Tsʼímah	Chama (New Mexico)
Táshchozhii dootłʼizhí	Purpurschwalbe
Nihookááʼ tsídii bichʼahígíí	Hornraben
Tsísʼnáłtsooí	Kurzkopfwespen
Azeeʼ hókánii łibáhígíí	Raue Gänsedistel
Jélii łóóʼ daʼhólzhaʼígíí	Salpidae
Gólízhii binághah dah łigaiígíí	Haubenskunk
Dloziłbáhí	Westliches Grauhörnchen
Nahatʼeʼii jáádnézí	Wüstenspringmäuse
Tsiiʼnteelí (łóóʼ)	Plattköpfe
Tsiiłchin Biiʼ Tó	Chilchinbito
Chíshí	Chiricahua
Deeschííʼ Bikooh	Cibecue
Chíshii Kʼíneeshbizhii	Rotbürzel-Waldsänger
Tǫ́ʼgaaʼ	Cochiti
Nááʼnoodǫ́ǫzii	Hellerkräuter
Tóidoozohii dootłʼizhígíí	Purpurhühner
Chʼagiiłbáhí	Kuhstärlinge
Jáád neishoodítsʼóóz	Schlupfwespen
Bitsiichįįshgahí	Kiefernhäher
Naʼashǫ́ʼii naatʼaʼí	Flugdrachen
Łeeyiʼ chʼosh bikágí ntłʼizí	Hippoidea
Gólízhii bíchį́į́h tʼáá łichíiʼii	Weißrüsselskunks
Wóóseetsʼiniiniłhiní	Rhaphidophoridae
Ałchʼįʼ beʼastłʼóní	Tamale (Gericht)
Gólízhii yistłʼinígíí	Fleckenskunks
Łóóʼchilí bitʼaʼ ádaadinígíí	Lanzettfischchen
Biniiʼnoodǫ́zí (tsin yigázhígíí)	Viscacha
Tsísʼnátsoh diłhiłígíí	Holzbienen
Aniłtʼánii (bideeneezígíí)	Schmetterlingshafte
Shádiʼááhdę́ę́ʼ chʼoshtsoh bíláshgaantsohí	Parastacidae
Zábąąhnteelii (łóóʼ ooshgę́ęzhii)	Rundkopf-Geigenrochen
Sílátsoh (chʼil)	Schlitzblättriger Sonnenhut
Gahjaaʼí bitseeneezígíí	Hasenmäuse
Tłʼiish kʼaaʼ	Racer (Begriffsklärung)
Tsézhin Dilkǫǫh	Dilkon
Naaldlooshii Bikéshgaan Dahólónígíí	Huftiere
Tółání Biyáázh	North Acomita Village
Dibé Dah Sitíní	Hopi-Buttes-Volcanic-Field
Nóódaʼí	Ute (Volk)
Tó Dínéeshzheeʼ	Kayenta
Beehai (Kintah)	Dulce
Néʼézhiin	Rotnacken-Saftlecker
Hasbídí Áshįįhí	East Fork (Arizona)
Chʼééh digháhii bitsʼaʼ dah deezʼáhí	Höckerschildkröten
Táłtłááh chʼoshyog	Nereiden (Zoologie)
Łį́į́ʼ bidą́ą́ʼtsʼóóz	Prärie-Rübe
Dlǫ́ʼii yił aheełtʼéhii diłhiłígíí	Kleinichneumon
Gadtsagí	Einsamiger Wacholder
Chʼosh bitsʼaʼ doolghasígíí	Kammmuscheln
Hashkʼaan bichʼosh	Yuccamotten
Chaatʼíní bichʼosh	Grüner Sauerampferkäfer
Yéʼiitsoh Bidił Niníyęęzh	El Malpais National Monument
Tsékʼi Naʼasdzooí (Yootó Hahoodzo)	El Morro National Monument
Tsídii bidaatsoh naashchʼąąʼí	Tukane
Kʼaiʼbiiʼtó	Kaibito
Chʼał bikéshgaan hólóní	Krallenfrösche
Tó bichʼosh (ałchozhígíí)	Ruderwanzen
Tó wónaanídę́ę́ʼ nahashchʼidí	Meles (Gattung)
Wónitłʼizí nahalinígíí	Saftkugler
Nahashchʼidí yił aheełtʼéhii yázhí	Sonnendachse
Dáánézí (łóóʼ)	Schnepfenfische
Tłʼiish bichóhí	Seitenwinder-Klapperschlange
Tsékʼi yaʼiiʼáhii	Tabakschwärmer
Táłkááʼ sikaadí	Acker-Hornkraut
Táłtłʼááh chʼosh chʼééh digháhii bitsiiʼ dikʼání	Kopfschildschnecken
Dahtooʼ yinooghałii	Sumpfzaunkönig
Chʼó bidághaaʼ	Usnea filipendula
Tsédááʼii	Hornmilben
Hastiin Pavao Skalić	Stanislav Pavao Skalić
Dahiitį́į́hildaaʼígíí	Kardinals-Lobelie
Atʼaʼ éljołí nahalinígíí (táłtłʼááh chʼosh)	Federwürmer
Tʼááłáhági átʼéego:Bééshbichʼahí	Kategorie:Deutschland
Tʼááłáhági átʼéego:Wááshindoon bikéyah ałhidadiidzooígíí	Kategorie:Vereinigte Staaten
Táłtłʼááh kʼaaʼ (łóóʼ)	Flötenfische
Tʼááłáhági átʼéego:Dibé diníí bikéyah	Kategorie:Spanien
Tʼááłáhági átʼéego:Naakaii Bikéyah	Kategorie:Mexiko
Nteelbitʼąąłánígíí	Rocky-Mountain-Schwertlilie
Naalkʼįhí bizaʼazis hólóní	Gleithörnchenbeutler
Wóódeʼełchíhii	Randwanzen
Naʼashǫ́ʼii diwozhígíí	Riesen-Gürtelschweif
Choozhghalii	Trupiale
Tsinlátah mąʼii	Makibären
Tsiiyah wozhii	Lerchenstärlinge
Chʼóyáázh nahalinígíí (táłtłʼááh chʼosh)	Weihnachtsbaumwurm
Shash Bitooʼ	Fort Wingate
Naatsédlózii	Rennkuckucke
Kʼįįʼ łitsooítsoh	Fremonts Mahonie
Tʼááłáhági átʼéego:Bidił daazdoígíí dóó daʼałtʼoʼígíí	Kategorie:Säugetiere
Tʼááłáhági átʼéego:Biyáázh Tsʼǫʼasánígíí	Kategorie:Amphibien
Tʼááłáhági átʼéego:Tsídii	Kategorie:Vögel
Tʼááłáhági átʼéego:Chʼosh doo yitʼíinii dláádí dóó Ábishjaaʼ	Kategorie:Pilze
Tʼááłáhági átʼéego:Chʼil	Kategorie:Pflanzen
Tʼááłáhági átʼéego:Nátʼą́ą́ʼ náháneʼ	Kategorie:Geschichte
Tʼááłáhági átʼéego:Naʼalkaah	Kategorie:Wissenschaft
Béégashii bideetsohí	Watussirind
Cháʼoł	Pinyon-Kiefern
Dził Nááyisí	Sandia Mountains
Tséchʼízhí	Rough Rock
Tsétaʼkin	San Ildefonso Pueblo
Niʼiijíhí	Navajo (New Mexico)
Lókʼaahnteel	Ganado (Arizona)
Góóhníinii	Havasupai
Azeeʼ ndootʼeezhítsoh	Wilde Bergamotte
Tsísʼná disxǫsígíí	Prachtbienen
Łóóʼtsoh bizábąąh shiyishí	Eubalaena
Tʼiis Názbąs	Teec Nos Pos
Díwózhii Biiʼ Tó	Greasewood
Kiisʼáanii Naakáí yikʼéʼ daʼdéísdlį́į́h	Pueblo-Aufstand
Tsin bizęęs	Stielporlinge
Tó hájiiloh	Santo Domingo (Volk)
Naashashí (Yootó Hahoodzo)	Santa Clara (Volk)
Táłtłʼááh chʼosh chʼééh digháhii bikeeʼ nteelígíí	Mondschnecken
Dah yiskʼid	Mound
Jééhkał Binaalyéhé Bá Hooghan	Hubbell Trading Post National Historic Site
Hanáádlį́	Huerfano
Aniłtʼánii łibáhígíí	Sichelwanzen
Wóótsʼóóz	Krummfühlerwanzen
Tséʼałnáoztʼiʼí	Sanostee
Jádító	Jeddito
Nichʼiʼí	Rosenverbene
Iichʼąhii	Nachtfalter
Chʼoshtsoh yázhí bíláshgaantsohí	Springkrebse
Roman dinéʼiʼ	Römisches Reich
Maricopa dinéʼiʼ	Maricopa (Volk)
Tóyééʼ	Steamboat
Naadą́ą́ʼ bichʼosh	Westlicher Maiswurzelbohrer
Chʼil deenínii	Ruthenisches Salzkraut
Dził Bílátah Łitsooí	Sunset Crater
Tsééhílį́	Tsaile
Azeeʼ ndootʼeezhí	Pferdeminze
Shádiʼááhdę́ę́ʼ tsékʼi dlǫ́ǫ́ʼ	Bergmeerschweinchen
Naabeehó	Navajo Nation Reservation
Áshįįhí Kiisʼáaniígíí	Laguna (Volk)
Chʼílwozh	Whiteriver
Shą́ą́ʼtóhí	Shonto
Tó Nehelį́į́h	Tonalea
Kin Náztʼįʼ	Shongopovi
Tó Hałtsooí	Sheep Springs
Lókʼaʼchʼégai	Lukachukai
Tsé Binííʼtóhí	Tse Bonito
Chʼoshtsoh bikágí diwozhí	Stein- und Königskrabben
Tábąąh naʼashǫ́ʼii	Wasseragamen
Náhodeeshgiizh Chʼínílíní	Pueblo Pintado
Ooljééʼ Tó dóó Tsé Deelghasii	Oljato-Monument Valley (Arizona)
Dáʼákʼeh Halání	Many Farms
Názlíní	Nazlini
Niʼiijííh Hasání	Sawmill
Tséʼnaa Naʼníʼáhí	Rainbow Bridge National Monument
Dilzhʼíʼ	Yavapai
Tsé Łichííʼ Dahazkání (Hoozdoh Hahoodzo)	Red Mesa
Maʼiitoʼí	Houck (Arizona)
Naakaii Chʼah	Mexican Hat
Waalibéí dinéʼiʼ	Walapai
Kégiizhí	Tohono O’Odham
Chʼosh ałchozhii (iichʼąhii)	Kleidermotte
Tsiitsʼiin łichíʼítsoh	Stenopelmatidae
Bitátʼahkin	Navajo National Monument
Anaashashi dinéʼiʼ	Tewa
Dookʼoʼoosłííd	San Francisco Peaks
Tʼááłáhági átʼéego:Ałtsʼáʼáztiin	Kategorie:Begriffsklärung
Bis Deezʼáhí	Newcomb (New Mexico)
Naatʼáanii Nééz	Shiprock (New Mexico)
Tsékʼi naʼazólii	Chuckwallas
Juan de Oñate	Juan de Oñate
Kʼish Chʼínítʼiʼ	Paguate
Gad diltáłii	Alligator-Wacholder
Sengaa	San Carlos (Arizona)
Ńdíshchííʼ Dah Shizhóód	Pinehill (New Mexico)
Atsá	Adler (Biologie)
Tsʼah	Wüsten-Beifuß
Tsʼíhootso	St. Michaels
Tłʼoh Łikizhí	Tesuque
Dibé łizhiní dinéʼiʼ	San Felipe (Volk)
Dził Łigaii (Dibé Nitsaa Hahoodzo)	San-Juan-Gebirge
Tsé Chʼééchiiʼ	Mesita
Tsé Bitʼaʼí	Shiprock
Ndilnaʼii	Faultiere
Dził Bizhiʼ Ádiní	Henry Mountains
Wóótʼą́hí	Rindenwanzen
Tsin Názbąs (Hoozdoh Hahoodzo)	Winona (Arizona)
Tʼáá Bííchʼį́įdii (Áshįįh Biiʼtó Hahoodzo)	Aneth
Naʼashǫ́ʼiidą́ą́ʼ	Asclepias subverticillata
Tʼááłáhági átʼéego:Chidí naatʼaʼí	Kategorie:Luftfahrzeug
Bee álnééhí:User uk-2	Vorlage:User uk-2
Nahashchʼidí (Yootó Hahoodzo)	Naschitti
Tʼááłáhági átʼéego:Wikipedia bots	Kategorie:Benutzer:Bot
Niłtsínii bikétłʼóól dijoolí (daadánígíí)	Speiserübe
Tsídii bitseeʼ naashchʼąąʼí	Asiatische Pfauen
Tʼááłáhági átʼéego:Bee Hazʼáanii	Kategorie:Recht
Wikiibíídiiya:Dahwéetʼaahígíí	Wikipedia:Administratoren
Wikiibíídiiya:Botígíí beehazʼą́ąnii	Wikipedia:Bots
Ííjip	Ägypten
Bee álnééhí:Bot	Vorlage:Bot
Deeteel Bikéyah	Kanada
Wikiibíídiiya:Baa haneʼ	Wikipedia:Über Wikipedia
Tʼááłáhági átʼéego:Béésh bichʼahníí bikéyah	Kategorie:Staat in Europa
Tʼááłáhági átʼéego:Wikiibíídiiya yee Hadítʼéhígíí	Kategorie:Sachsystematik
Tʼááłáhági átʼéego:Choyoołʼįįhí Bizaad	Kategorie:Benutzer:nach Sprache
Anáʼálwoʼ:Wikiibíídiiya beehazʼą́ąnii	Wikipedia:Richtlinien
Tséłnííʼjí (chʼil)	Frauenhaarfarn
Bee álnééhí:Softredirect	Vorlage:Interwiki redirect
Chʼosh chʼééh digháhii	Schnecken
Diné Bizaad yee Nidaazbaaʼígíí	Navajo-Code
Tʼááłáhági átʼéego:Saad	Kategorie:Einzelsprache als Thema
Wikiibíídiiya:General disclaimer	Wikipedia:Impressum
Wikiibíídiiya:Statistics	Wikipedia:Statistik
Łóóʼ hashkéhéchilí	Seekatzen
Tʼááłáhági átʼéego:Béésh bee akʼeʼelchíhí tʼáá bí nitsékeesígíí	Kategorie:Angewandte Informatik
Chʼil naʼatłʼoʼii (Ałtsʼáʼáztiin)	Weinbeere
Bee álnééhí:Bots	Vorlage:Bots
Tʼááłáhági átʼéego:Naaltsoos	Kategorie:Buchwesen
Bee álnééhí:Wikisource	Vorlage:Wikisource
Bee álnééhí:Babel	Vorlage:Babel
Bee álnééhí:Commons	Vorlage:Commons
Bee álnééhí:User af-1	Vorlage:User af-1
Bee álnééhí:User als-1	Vorlage:User als-1
Bee álnééhí:User ar-1	Vorlage:User ar-1
Bee álnééhí:User az	Vorlage:User az
Bee álnééhí:User bar-1	Vorlage:User bar-1
Bee álnééhí:User eo-1	Vorlage:User eo-1
Bee álnééhí:See also	Vorlage:Siehe auch
Bee álnééhí:User da-2	Vorlage:User da-2
Bee álnééhí:User da	Vorlage:User da
Bee álnééhí:User ca-1	Vorlage:User ca-1
Bee álnééhí:User ca-4	Vorlage:User ca-4
Bee álnééhí:User be-2	Vorlage:User be-2
Bee álnééhí:User da-1	Vorlage:User da-1
Bee álnééhí:User cs-1	Vorlage:User cs-1
Bee álnééhí:User bg-1	Vorlage:User bg-1
Bee álnééhí:User eo-3	Vorlage:User eo-3
Bee álnééhí:User de	Vorlage:User de
Bee álnééhí:User de-1	Vorlage:User de-1
Bee álnééhí:User eu-4	Vorlage:User eu-4
Bee álnééhí:User eu	Vorlage:User eu
Bee álnééhí:User et-1	Vorlage:User et-1
Bee álnééhí:User el	Vorlage:User el
Bee álnééhí:User es	Vorlage:User es
Bee álnééhí:User de-3	Vorlage:User de-3
Bee álnééhí:User en-3	Vorlage:User en-3
Bee álnééhí:User el-1	Vorlage:User el-1
Bee álnééhí:User en-1	Vorlage:User en-1
Bee álnééhí:User en-2	Vorlage:User en-2
Bee álnééhí:User fa-1	Vorlage:User fa-1
Bee álnééhí:User eo-2	Vorlage:User eo-2
Bee álnééhí:User en-4	Vorlage:User en-4
Bee álnééhí:User fi	Vorlage:User fi
Bee álnééhí:User en-0	Vorlage:User en-0
Bee álnééhí:User es-4	Vorlage:User es-4
Bee álnééhí:User en	Vorlage:User en
Bee álnééhí:User de-2	Vorlage:User de-2
Bee álnééhí:User es-1	Vorlage:User es-1
Bee álnééhí:User fa	Vorlage:User fa
Bee álnééhí:User fi-1	Vorlage:User fi-1
Bee álnééhí:User fr-1	Vorlage:User fr-1
Bee álnééhí:User ia-2	Vorlage:User ia-2
Bee álnééhí:User hi-1	Vorlage:User hi-1
Bee álnééhí:User hr	Vorlage:User hr
Bee álnééhí:User he-2	Vorlage:User he-2
Bee álnééhí:User he-1	Vorlage:User he-1
Bee álnééhí:User hu	Vorlage:User hu
Bee álnééhí:User id-3	Vorlage:User id-3
Bee álnééhí:User io-3	Vorlage:User io-3
Bee álnééhí:User it-3	Vorlage:User it-3
Bee álnééhí:User grc-1	Vorlage:User grc-1
Bee álnééhí:User ja-4	Vorlage:User ja-4
Bee álnééhí:User sk	Vorlage:User sk
Bee álnééhí:User tr-2	Vorlage:User tr-2
Bee álnééhí:User fr-2	Vorlage:User fr-2
Bee álnééhí:User tr	Vorlage:User tr
Bee álnééhí:User ja	Vorlage:User ja
Bee álnééhí:User ja-1	Vorlage:User ja-1
Bee álnééhí:User it-1	Vorlage:User it-1
Bee álnééhí:User hr-1	Vorlage:User hr-1
Bee álnééhí:User fr	Vorlage:User fr
Bee álnééhí:User gsw-1	Vorlage:User gsw-1
Bee álnééhí:User he	Vorlage:User he
Tʼááłáhági átʼéego:Chʼosh bijáád hastánígíí	Kategorie:Insekten
Tʼááłáhági átʼéego:Choyoołʼįįhí uk	Kategorie:User uk
Tʼááłáhági átʼéego:Choyoołʼįįhí uk-N	Kategorie:User uk-M
Tʼááłáhági átʼéego:Chʼiyáán	Kategorie:Lebensmittel
Bee álnééhí:User sv	Vorlage:User sv
Bee álnééhí:User it	Vorlage:User it
Bee álnééhí:User uk	Vorlage:User uk
Bee álnééhí:User es-2	Vorlage:User es-2
Tʼááłáhági átʼéego:Choyoołʼįįhí ms	Kategorie:User ms
Tʼááłáhági átʼéego:Choyoołʼįįhí fr-1	Kategorie:User fr-1
Bee álnééhí:Image label	Vorlage:Image label
Bee álnééhí:User ms	Vorlage:User ms
Bee álnééhí:User hi-3	Vorlage:User hi-3
Tʼááłáhági átʼéego:Choyoołʼįįhí en-4	Kategorie:User en-4
Tʼááłáhági átʼéego:Choyoołʼįįhí en	Kategorie:User en
Tʼááłáhági átʼéego:Choyoołʼįįhí zh	Kategorie:User zh
Tʼááłáhági átʼéego:Choyoołʼįįhí zh-N	Kategorie:User zh-M
Tʼááłáhági átʼéego:Choyoołʼįįhí en-2	Kategorie:User en-2
Bee álnééhí:User eo	Vorlage:User eo
Bee álnééhí:User zh	Vorlage:User zh
Bee álnééhí:User ru-4	Vorlage:User ru-4
Bee álnééhí:User sr	Vorlage:User sr
Bee álnééhí:GeoTemplate	Vorlage:GeoTemplate
Bee álnééhí:User nl-1	Vorlage:User nl-1
Bee álnééhí:User nl-2	Vorlage:User nl-2
Tʼááłáhági átʼéego:Néʼéshjaaʼ	Kategorie:Eulen
Tʼááłáhági átʼéego:Choyoołʼįįhí hi	Kategorie:User hi
Tʼááłáhági átʼéego:Choyoołʼįįhí ms-N	Kategorie:User ms-M
Tʼááłáhági átʼéego:Dził	Kategorie:Berg
Bee álnééhí:User ru	Vorlage:User ru
Tʼááłáhági átʼéego:Kéyah yádiłhił biiʼ dahólónígíí	Kategorie:Planet des Sonnensystems
Tʼááłáhági átʼéego:Kéyah dah siʼánígíí	Kategorie:Amerika
Tʼááłáhági átʼéego:Choyoołʼįįhí bizaad-Templates	Kategorie:Vorlage:Babel-Sprache
Bee álnééhí:Archive	Vorlage:Archivübersicht
Bee álnééhí:User eo-4	Vorlage:User eo-4
Bee álnééhí:PD-US-gov	Vorlage:Bild-PD-US
Tʼááłáhági átʼéego:Siláołtsooí	Kategorie:Militärwesen
Bee álnééhí:User pt-1	Vorlage:User pt-1
Bee álnééhí:Pt elements	Vorlage:Navigationsleiste Periodensystem
Bee álnééhí:User oc-4	Vorlage:User oc-4
Bee álnééhí:User pl	Vorlage:User pl
Bee álnééhí:User nl	Vorlage:User nl
Bee álnééhí:User no-2	Vorlage:User no-2
Bee álnééhí:Image label end	Vorlage:Image label end
Bee álnééhí:Userpage	Vorlage:Wikipedia-Benutzer
Bee álnééhí:Emergency-bot-shutoff	Vorlage:Emergency-bot-shutoff
Bee álnééhí:User pl-1	Vorlage:User pl-1
Bee álnééhí:Image label small	Vorlage:Image label small
Bee álnééhí:User fr-3	Vorlage:User fr-3
Tʼááłáhági átʼéego:Choyoołʼįįhí gsw-4	Kategorie:User gsw-4
Bee álnééhí:User lt	Vorlage:User lt
Bee álnééhí:User nds-1	Vorlage:User nds-1
Tʼááłáhági átʼéego:Hosh	Kategorie:Kakteengewächse
Bee álnééhí:User tr-4	Vorlage:User tr-4
Bee álnééhí:User is-1	Vorlage:User is-1
Bee álnééhí:User is-2	Vorlage:User is-2
Bee álnééhí:User ce	Vorlage:User ce
Bee álnééhí:User ar-2	Vorlage:User ar-2
Bee álnééhí:User ar-3	Vorlage:User ar-3
Bee álnééhí:User is	Vorlage:User is
Bee álnééhí:User ar	Vorlage:User ar
Bee álnééhí:User az-3	Vorlage:User az-3
Tʼááłáhági átʼéego:Choyoołʼįįhí ja-N	Kategorie:User ja-M
Bee álnééhí:User als	Vorlage:User als
Bee álnééhí:@	Vorlage:@
Tʼááłáhági átʼéego:Tłʼoh	Kategorie:Süßgräser
Bee álnééhí:Ałtsʼáʼáztiin	Vorlage:Begriffsklärung
Bee álnééhí:User no-3	Vorlage:User no-3
Bee álnééhí:User ksh	Vorlage:User ksh
Bee álnééhí:User yue-3	Vorlage:User zh-yue-3
Bee álnééhí:User no	Vorlage:User no
Bee álnééhí:User yue-1	Vorlage:User zh-yue-1
Bee álnééhí:Chʼiyáánbiiʼ	Vorlage:Infobox Inhaltsstoffe
Bee álnééhí:User sv-2	Vorlage:User sv-2
Tʼááłáhági átʼéego:Choyoołʼįįhí gsw-1	Kategorie:User gsw-1
Bee álnééhí:User it-2	Vorlage:User it-2
Tʼááłáhági átʼéego:Kǫʼ naʼałbąąsii	Kategorie:Schienenverkehr
Tʼááłáhági átʼéego:Choyoołʼįįhí gsw-2	Kategorie:User gsw-2
Bee álnééhí:User pt-3	Vorlage:User pt-3
Bee álnééhí:User pt-2	Vorlage:User pt-2
Bee álnééhí:User th-1	Vorlage:User th-1
Bee álnééhí:User lb-1	Vorlage:User lb-1
Bee álnééhí:User ro-4	Vorlage:User ro-4
Bee álnééhí:User ro	Vorlage:User ro
Bee álnééhí:User fr-4	Vorlage:User fr-4
Bee álnééhí:User lv	Vorlage:User lv
Bee álnééhí:User bg	Vorlage:User bg
Tʼááłáhági átʼéego:Choyoołʼįįhí vi-3	Kategorie:User vi-3
Bee álnééhí:User la-1	Vorlage:User la-1
Tʼááłáhági átʼéego:Templates/doc	Kategorie:Vorlage:nur Dokumentation
Tʼááłáhági átʼéego:Choyoołʼįįhí yue	Kategorie:User zh-yue
Tʼááłáhági átʼéego:Choyoołʼįįhí pdc	Kategorie:User pdc
Tʼááłáhági átʼéego:Choyoołʼįįhí mzn	Kategorie:User mzn
Tʼááłáhági átʼéego:Choyoołʼįįhí at	Kategorie:User at
Tʼááłáhági átʼéego:Choyoołʼįįhí az	Kategorie:User az
Tʼááłáhági átʼéego:Choyoołʼįįhí be	Kategorie:User be
Tʼááłáhági átʼéego:Choyoołʼįįhí nb-N	Kategorie:User nb-M
Tʼááłáhági átʼéego:Choyoołʼįįhí bs	Kategorie:User bs
Tʼááłáhági átʼéego:Choyoołʼįįhí ce	Kategorie:User ce
Tʼááłáhági átʼéego:Choyoołʼįįhí hr	Kategorie:User hr
Tʼááłáhági átʼéego:Choyoołʼįįhí sk	Kategorie:User sk
Tʼááłáhági átʼéego:Choyoołʼįįhí sl	Kategorie:User sl
Tʼááłáhági átʼéego:Choyoołʼįįhí eo	Kategorie:User eo
Tʼááłáhági átʼéego:Choyoołʼįįhí et	Kategorie:User et
Tʼááłáhági átʼéego:Choyoołʼįįhí fr	Kategorie:User fr
Tʼááłáhági átʼéego:Choyoołʼįįhí frr	Kategorie:User frr
Tʼááłáhági átʼéego:Choyoołʼįįhí gl	Kategorie:User gl
Tʼááłáhági átʼéego:Choyoołʼįįhí cy	Kategorie:User cy
Tʼááłáhági átʼéego:Choyoołʼįįhí gn	Kategorie:User gn
Tʼááłáhági átʼéego:Choyoołʼįįhí hu-N	Kategorie:User hu-M
Tʼááłáhági átʼéego:Choyoołʼįįhí id	Kategorie:User id
Tʼááłáhági átʼéego:Choyoołʼįįhí ia	Kategorie:User ia
Tʼááłáhági átʼéego:Choyoołʼįįhí ga	Kategorie:User ga
Tʼááłáhági átʼéego:Choyoołʼįįhí ja	Kategorie:User ja
Tʼááłáhági átʼéego:Choyoołʼįįhí km	Kategorie:User km
Tʼááłáhági átʼéego:Choyoołʼįįhí la	Kategorie:User la
Tʼááłáhági átʼéego:Choyoołʼįįhí li	Kategorie:User li
Tʼááłáhági átʼéego:Choyoołʼįįhí lt	Kategorie:User lt
Tʼááłáhági átʼéego:Choyoołʼįįhí mk	Kategorie:User mk
Tʼááłáhági átʼéego:Choyoołʼįįhí mg	Kategorie:User mg
Tʼááłáhági átʼéego:Choyoołʼįįhí mwl	Kategorie:User mwl
Tʼááłáhági átʼéego:Choyoołʼįįhí mn	Kategorie:User mn
Tʼááłáhági átʼéego:Choyoołʼįįhí nn	Kategorie:User nn
Tʼááłáhági átʼéego:Choyoołʼįįhí nah	Kategorie:User nah
Tʼááłáhági átʼéego:Choyoołʼįįhí oc	Kategorie:User oc
Tʼááłáhági átʼéego:Choyoołʼįįhí pt	Kategorie:User pt
Tʼááłáhági átʼéego:Choyoołʼįįhí ro	Kategorie:User ro
Tʼááłáhági átʼéego:Choyoołʼįįhí sc	Kategorie:User sc
Tʼááłáhági átʼéego:Choyoołʼįįhí sh	Kategorie:User sh
Tʼááłáhági átʼéego:Choyoołʼįįhí sv	Kategorie:User sv
Tʼááłáhági átʼéego:Choyoołʼįįhí sw	Kategorie:User sw
Tʼááłáhági átʼéego:Choyoołʼįįhí sa	Kategorie:User sa
Tʼááłáhági átʼéego:Choyoołʼįįhí th	Kategorie:User th
Tʼááłáhági átʼéego:Choyoołʼįįhí ta	Kategorie:User ta
Tʼááłáhági átʼéego:Choyoołʼįįhí vo	Kategorie:User vo
Tʼááłáhági átʼéego:Choyoołʼįįhí bar-3	Kategorie:User bar-3
Tʼááłáhági átʼéego:Choyoołʼįįhí az-3	Kategorie:User az-3
Tʼááłáhági átʼéego:Choyoołʼįįhí be-3	Kategorie:User be-3
Tʼááłáhági átʼéego:Choyoołʼįįhí cs-3	Kategorie:User cs-3
Tʼááłáhági átʼéego:Choyoołʼįįhí sl-3	Kategorie:User sl-3
Tʼááłáhági átʼéego:Choyoołʼįįhí et-3	Kategorie:User et-3
Tʼááłáhági átʼéego:Choyoołʼįįhí fr-3	Kategorie:User fr-3
Tʼááłáhági átʼéego:Choyoołʼįįhí cy-3	Kategorie:User cy-3
Tʼááłáhági átʼéego:Choyoołʼįįhí hi-3	Kategorie:User hi-3
Tʼááłáhági átʼéego:Choyoołʼįįhí it-3	Kategorie:User it-3
Tʼááłáhági átʼéego:Choyoołʼįįhí ja-3	Kategorie:User ja-3
Tʼááłáhági átʼéego:Choyoołʼįįhí li-3	Kategorie:User li-3
Tʼááłáhági átʼéego:Choyoołʼįįhí lt-3	Kategorie:User lt-3
Tʼááłáhági átʼéego:Choyoołʼįįhí mk-3	Kategorie:User mk-3
Tʼááłáhági átʼéego:Choyoołʼįįhí nl-3	Kategorie:User nl-3
Tʼááłáhági átʼéego:Choyoołʼįįhí no-3	Kategorie:User no-3
Tʼááłáhági átʼéego:Choyoołʼįįhí oc-3	Kategorie:User oc-3
Tʼááłáhági átʼéego:Choyoołʼįįhí pl-3	Kategorie:User pl-3
Tʼááłáhági átʼéego:Choyoołʼįįhí sh-3	Kategorie:User sh-3
Tʼááłáhági átʼéego:Choyoołʼįįhí sw-3	Kategorie:User sw-3
Tʼááłáhági átʼéego:Choyoołʼįįhí sa-3	Kategorie:User sa-3
Tʼááłáhági átʼéego:Choyoołʼįįhí ta-3	Kategorie:User ta-3
Tʼááłáhági átʼéego:Choyoołʼįįhí tr-3	Kategorie:User tr-3
Tʼááłáhági átʼéego:Choyoołʼįįhí ar-3	Kategorie:User ar-3
Tʼááłáhági átʼéego:Choyoołʼįįhí pdc-1	Kategorie:User pdc-1
Tʼááłáhági átʼéego:Choyoołʼįįhí an-1	Kategorie:User an-1
Tʼááłáhági átʼéego:Choyoołʼįįhí be-1	Kategorie:User be-1
Tʼááłáhági átʼéego:Choyoołʼįįhí cs-1	Kategorie:User cs-1
Tʼááłáhági átʼéego:Choyoołʼįįhí da-1	Kategorie:User da-1
Tʼááłáhági átʼéego:Choyoołʼįįhí sl-1	Kategorie:User sl-1
Tʼááłáhági átʼéego:Choyoołʼįįhí et-1	Kategorie:User et-1
Tʼááłáhági átʼéego:Choyoołʼįįhí fi-1	Kategorie:User fi-1
Tʼááłáhági átʼéego:Choyoołʼįįhí cy-1	Kategorie:User cy-1
Tʼááłáhági átʼéego:Choyoołʼįįhí hi-1	Kategorie:User hi-1
Tʼááłáhági átʼéego:Choyoołʼįįhí ia-1	Kategorie:User ia-1
Tʼááłáhági átʼéego:Choyoołʼįįhí ga-1	Kategorie:User ga-1
Tʼááłáhági átʼéego:Choyoołʼįįhí ku-1	Kategorie:User ku-1
Tʼááłáhági átʼéego:Choyoołʼįįhí lv-1	Kategorie:User lv-1
Tʼááłáhági átʼéego:Choyoołʼįįhí li-1	Kategorie:User li-1
Tʼááłáhági átʼéego:Choyoołʼįįhí lt-1	Kategorie:User lt-1
Tʼááłáhági átʼéego:Choyoołʼįįhí mk-1	Kategorie:User mk-1
Tʼááłáhági átʼéego:Choyoołʼįįhí nl-1	Kategorie:User nl-1
Tʼááłáhági átʼéego:Choyoołʼįįhí nah-1	Kategorie:User nah-1
Tʼááłáhági átʼéego:Choyoołʼįįhí oc-1	Kategorie:User oc-1
Tʼááłáhági átʼéego:Choyoołʼįįhí pl-1	Kategorie:User pl-1
Tʼááłáhági átʼéego:Choyoołʼįįhí ro-1	Kategorie:User ro-1
Tʼááłáhági átʼéego:Choyoołʼįįhí sc-1	Kategorie:User sc-1
Tʼááłáhági átʼéego:Choyoołʼįįhí sh-1	Kategorie:User sh-1
Tʼááłáhági átʼéego:Choyoołʼįįhí sw-1	Kategorie:User sw-1
Tʼááłáhági átʼéego:Choyoołʼįįhí sa-1	Kategorie:User sa-1
Tʼááłáhági átʼéego:Choyoołʼįįhí tr-1	Kategorie:User tr-1
Tʼááłáhági átʼéego:Choyoołʼįįhí vo-1	Kategorie:User vo-1
Tʼááłáhági átʼéego:Choyoołʼįįhí ar-1	Kategorie:User ar-1
Tʼááłáhági átʼéego:Choyoołʼįįhí be-4	Kategorie:User be-4
Tʼááłáhági átʼéego:Choyoołʼįįhí cs-4	Kategorie:User cs-4
Tʼááłáhági átʼéego:Choyoołʼįįhí ko-4	Kategorie:User ko-4
Tʼááłáhági átʼéego:Choyoołʼįįhí sl-4	Kategorie:User sl-4
Tʼááłáhági átʼéego:Choyoołʼįįhí et-4	Kategorie:User et-4
Tʼááłáhági átʼéego:Choyoołʼįįhí fr-4	Kategorie:User fr-4
Tʼááłáhági átʼéego:Choyoołʼįįhí cy-4	Kategorie:User cy-4
Tʼááłáhági átʼéego:Choyoołʼįįhí hi-4	Kategorie:User hi-4
Tʼááłáhági átʼéego:Choyoołʼįįhí hu-4	Kategorie:User hu-4
Tʼááłáhági átʼéego:Choyoołʼįįhí id-4	Kategorie:User id-4
Tʼááłáhági átʼéego:Choyoołʼįįhí it-4	Kategorie:User it-4
Tʼááłáhági átʼéego:Choyoołʼįįhí li-4	Kategorie:User li-4
Tʼááłáhági átʼéego:Choyoołʼįįhí lt-4	Kategorie:User lt-4
Tʼááłáhági átʼéego:Choyoołʼįįhí mk-4	Kategorie:User mk-4
Tʼááłáhági átʼéego:Choyoołʼįįhí oc-4	Kategorie:User oc-4
Tʼááłáhági átʼéego:Choyoołʼįįhí pl-4	Kategorie:User pl-4
Tʼááłáhági átʼéego:Choyoołʼįįhí sh-4	Kategorie:User sh-4
Tʼááłáhági átʼéego:Choyoołʼįįhí sw-4	Kategorie:User sw-4
Tʼááłáhági átʼéego:Choyoołʼįįhí ar-4	Kategorie:User ar-4
Tʼááłáhági átʼéego:Choyoołʼįįhí als-2	Kategorie:User als-2
Tʼááłáhági átʼéego:Choyoołʼįįhí be-2	Kategorie:User be-2
Tʼááłáhági átʼéego:Choyoołʼįįhí bs-2	Kategorie:User bs-2
Tʼááłáhági átʼéego:Choyoołʼįįhí ce-2	Kategorie:User ce-2
Tʼááłáhági átʼéego:Choyoołʼįįhí cs-2	Kategorie:User cs-2
Tʼááłáhági átʼéego:Choyoołʼįįhí da-2	Kategorie:User da-2
Tʼááłáhági átʼéego:Choyoołʼįįhí sk-2	Kategorie:User sk-2
Tʼááłáhági átʼéego:Choyoołʼįįhí sl-2	Kategorie:User sl-2
Tʼááłáhági átʼéego:Choyoołʼįįhí et-2	Kategorie:User et-2
Tʼááłáhági átʼéego:Choyoołʼįįhí fr-2	Kategorie:User fr-2
Tʼááłáhági átʼéego:Choyoołʼįįhí cy-2	Kategorie:User cy-2
Tʼááłáhági átʼéego:Choyoołʼįįhí gn-2	Kategorie:User gn-2
Tʼááłáhági átʼéego:Choyoołʼįįhí hi-2	Kategorie:User hi-2
Tʼááłáhági átʼéego:Choyoołʼįįhí hu-2	Kategorie:User hu-2
Tʼááłáhági átʼéego:Choyoołʼįįhí ia-2	Kategorie:User ia-2
Tʼááłáhági átʼéego:Choyoołʼįįhí it-2	Kategorie:User it-2
Tʼááłáhági átʼéego:Choyoołʼįįhí ja-2	Kategorie:User ja-2
Tʼááłáhági átʼéego:Choyoołʼįįhí la-2	Kategorie:User la-2
Tʼááłáhági átʼéego:Choyoołʼįįhí li-2	Kategorie:User li-2
Tʼááłáhági átʼéego:Choyoołʼįįhí lt-2	Kategorie:User lt-2
Tʼááłáhági átʼéego:Choyoołʼįįhí mk-2	Kategorie:User mk-2
Tʼááłáhági átʼéego:Choyoołʼįįhí mwl-2	Kategorie:User mwl-2
Tʼááłáhági átʼéego:Choyoołʼįįhí nl-2	Kategorie:User nl-2
Tʼááłáhági átʼéego:Choyoołʼįįhí oc-2	Kategorie:User oc-2
Tʼááłáhági átʼéego:Choyoołʼįįhí pl-2	Kategorie:User pl-2
Tʼááłáhági átʼéego:Choyoołʼįįhí sh-2	Kategorie:User sh-2
Tʼááłáhági átʼéego:Choyoołʼįįhí sv-2	Kategorie:User sv-2
Tʼááłáhági átʼéego:Choyoołʼįįhí sw-2	Kategorie:User sw-2
Tʼááłáhági átʼéego:Choyoołʼįįhí sa-2	Kategorie:User sa-2
Tʼááłáhági átʼéego:Choyoołʼįįhí tr-2	Kategorie:User tr-2
Tʼááłáhági átʼéego:Choyoołʼįįhí vo-2	Kategorie:User vo-2
Tʼááłáhági átʼéego:Choyoołʼįįhí ar-2	Kategorie:User ar-2
Tʼááłáhági átʼéego:Choyoołʼįįhí at-N	Kategorie:User at-M
Tʼááłáhági átʼéego:Choyoołʼįįhí an-N	Kategorie:User an-M
Tʼááłáhági átʼéego:Choyoołʼįįhí hy-N	Kategorie:User hy-M
Tʼááłáhági átʼéego:Choyoołʼįįhí ast-N	Kategorie:User ast-M
Tʼááłáhági átʼéego:Choyoołʼįįhí be-N	Kategorie:User be-M
Tʼááłáhági átʼéego:Choyoołʼįįhí cs-N	Kategorie:User cs-M
Tʼááłáhági átʼéego:Choyoołʼįįhí ko-N	Kategorie:User ko-M
Tʼááłáhági átʼéego:Choyoołʼįįhí hr-N	Kategorie:User hr-M
Tʼááłáhági átʼéego:Choyoołʼįįhí sl-N	Kategorie:User sl-M
Tʼááłáhági átʼéego:Choyoołʼįįhí et-N	Kategorie:User et-M
Tʼááłáhági átʼéego:Choyoołʼįįhí fr-N	Kategorie:User fr-M
Tʼááłáhági átʼéego:Choyoołʼįįhí fy-N	Kategorie:User fy-M
Tʼááłáhági átʼéego:Choyoołʼįįhí gl-N	Kategorie:User gl-M
Tʼááłáhági átʼéego:Choyoołʼįįhí cy-N	Kategorie:User cy-M
Tʼááłáhági átʼéego:Choyoołʼįįhí hi-N	Kategorie:User hi-M
Tʼááłáhági átʼéego:Choyoołʼįįhí id-N	Kategorie:User id-M
Tʼááłáhági átʼéego:Choyoołʼįįhí is-N	Kategorie:User is-M
Tʼááłáhági átʼéego:Choyoołʼįįhí it-N	Kategorie:User it-M
Tʼááłáhági átʼéego:Choyoołʼįįhí jv-N	Kategorie:User jv-M
Tʼááłáhági átʼéego:Choyoołʼįįhí ku-N	Kategorie:User ku-M
Tʼááłáhági átʼéego:Choyoołʼįįhí lv-N	Kategorie:User lv-M
Tʼááłáhági átʼéego:Choyoołʼįįhí li-N	Kategorie:User li-M
Tʼááłáhági átʼéego:Choyoołʼįįhí lt-N	Kategorie:User lt-M
Tʼááłáhági átʼéego:Choyoołʼįįhí lb-N	Kategorie:User lb-M
Tʼááłáhági átʼéego:Choyoołʼįįhí mk-N	Kategorie:User mk-M
Tʼááłáhági átʼéego:Choyoołʼįįhí mg-N	Kategorie:User mg-M
Tʼááłáhági átʼéego:Choyoołʼįįhí nl-N	Kategorie:User nl-M
Tʼááłáhági átʼéego:Choyoołʼįįhí no-N	Kategorie:User no-M
Tʼááłáhági átʼéego:Choyoołʼįįhí nn-N	Kategorie:User nn-M
Tʼááłáhági átʼéego:Choyoołʼįįhí oc-N	Kategorie:User oc-M
Tʼááłáhági átʼéego:Choyoołʼįįhí or-N	Kategorie:User or-M
Tʼááłáhági átʼéego:Choyoołʼįįhí ru-N	Kategorie:User ru-M
Tʼááłáhági átʼéego:Choyoołʼįįhí sh-N	Kategorie:User sh-M
Tʼááłáhági átʼéego:Choyoołʼįįhí sw-N	Kategorie:User sw-M
Tʼááłáhági átʼéego:Choyoołʼįįhí ta-N	Kategorie:User ta-M
Tʼááłáhági átʼéego:Choyoołʼįįhí ar-N	Kategorie:User ar-M
Bee álnééhí:User yue	Vorlage:User zh-yue
Bee álnééhí:User pdc-1	Vorlage:User pdc-1
Tʼááłáhági átʼéego:Choyoołʼįįhí eu-3	Kategorie:User eu-3
Tʼááłáhági átʼéego:Choyoołʼįįhí eu-N	Kategorie:User eu-M
Tʼááłáhági átʼéego:Choyoołʼįįhí af	Kategorie:User af
Tʼááłáhági átʼéego:Choyoołʼįįhí af-1	Kategorie:User af-1
Tʼááłáhági átʼéego:Choyoołʼįįhí af-2	Kategorie:User af-2
Tʼááłáhági átʼéego:Choyoołʼįįhí af-3	Kategorie:User af-3
Tʼááłáhági átʼéego:Choyoołʼįįhí af-4	Kategorie:User af-4
Tʼááłáhági átʼéego:Choyoołʼįįhí af-N	Kategorie:User af-M
Tʼááłáhági átʼéego:Choyoołʼįįhí als	Kategorie:User als
Tʼááłáhági átʼéego:Choyoołʼįįhí als-1	Kategorie:User als-1
Tʼááłáhági átʼéego:Choyoołʼįįhí an	Kategorie:User an
Tʼááłáhági átʼéego:Choyoołʼįįhí ar	Kategorie:User ar
Tʼááłáhági átʼéego:Choyoołʼįįhí ast	Kategorie:User ast
Tʼááłáhági átʼéego:Choyoołʼįįhí ay	Kategorie:User ay
Tʼááłáhági átʼéego:Choyoołʼįįhí ay-1	Kategorie:User ay-1
Tʼááłáhági átʼéego:Choyoołʼįįhí ay-4	Kategorie:User ay-4
Tʼááłáhági átʼéego:Choyoołʼįįhí az-1	Kategorie:User az-1
Tʼááłáhági átʼéego:Choyoołʼįįhí az-2	Kategorie:User az-2
Tʼááłáhági átʼéego:Choyoołʼįįhí az-4	Kategorie:User az-4
Tʼááłáhági átʼéego:Choyoołʼįįhí az-N	Kategorie:User az-M
Tʼááłáhági átʼéego:Choyoołʼįįhí ba	Kategorie:User ba
Tʼááłáhági átʼéego:Choyoołʼįįhí ba-1	Kategorie:User ba-1
Tʼááłáhági átʼéego:Choyoołʼįįhí ba-2	Kategorie:User ba-2
Tʼááłáhági átʼéego:Choyoołʼįįhí bar	Kategorie:User bar
Tʼááłáhági átʼéego:Choyoołʼįįhí bar-1	Kategorie:User bar-1
Tʼááłáhági átʼéego:Choyoołʼįįhí bar-2	Kategorie:User bar-2
Tʼááłáhági átʼéego:Choyoołʼįįhí bar-4	Kategorie:User bar-4
Tʼááłáhági átʼéego:Choyoołʼįįhí bar-N	Kategorie:User bar-M
Tʼááłáhági átʼéego:Choyoołʼįįhí bg	Kategorie:User bg
Tʼááłáhági átʼéego:Choyoołʼįįhí bg-1	Kategorie:User bg-1
Tʼááłáhági átʼéego:Choyoołʼįįhí bg-2	Kategorie:User bg-2
Tʼááłáhági átʼéego:Choyoołʼįįhí bg-3	Kategorie:User bg-3
Tʼááłáhági átʼéego:Choyoołʼįįhí bg-4	Kategorie:User bg-4
Tʼááłáhági átʼéego:Choyoołʼįįhí bg-N	Kategorie:User bg-M
Tʼááłáhági átʼéego:Choyoołʼįįhí bn	Kategorie:User bn
Tʼááłáhági átʼéego:Choyoołʼįįhí bn-2	Kategorie:User bn-2
Tʼááłáhági átʼéego:Choyoołʼįįhí bn-N	Kategorie:User bn-M
Tʼááłáhági átʼéego:Choyoołʼįįhí ca	Kategorie:User ca
Tʼááłáhági átʼéego:Choyoołʼįįhí ca-1	Kategorie:User ca-1
Tʼááłáhági átʼéego:Choyoołʼįįhí ca-2	Kategorie:User ca-2
Tʼááłáhági átʼéego:Tádídíín deiyání	Kategorie:Blattkäfer
Tʼááłáhági átʼéego:Choyoołʼįįhí ca-3	Kategorie:User ca-3
Tʼááłáhági átʼéego:Choyoołʼįįhí ca-4	Kategorie:User ca-4
Tʼááłáhági átʼéego:Choyoołʼįįhí ca-N	Kategorie:User ca-M
Tʼááłáhági átʼéego:Choyoołʼįįhí ce-3	Kategorie:User ce-3
Tʼááłáhági átʼéego:Choyoołʼįįhí ce-N	Kategorie:User ce-M
Tʼááłáhági átʼéego:Choyoołʼįįhí cr	Kategorie:User cr
Tʼááłáhági átʼéego:Choyoołʼįįhí cs	Kategorie:User cs
Tʼááłáhági átʼéego:Choyoołʼįįhí csb	Kategorie:User csb
Tʼááłáhági átʼéego:Choyoołʼįįhí csb-1	Kategorie:User csb-1
Tʼááłáhági átʼéego:Choyoołʼįįhí da	Kategorie:User da
Tʼááłáhági átʼéego:Choyoołʼįįhí sk-N	Kategorie:User sk-M
Tʼááłáhági átʼéego:Choyoołʼįįhí da-3	Kategorie:User da-3
Tʼááłáhági átʼéego:Choyoołʼįįhí da-4	Kategorie:User da-4
Tʼááłáhági átʼéego:Choyoołʼįįhí de	Kategorie:User de
Tʼááłáhági átʼéego:Choyoołʼįįhí de-2	Kategorie:User de-2
Tʼááłáhági átʼéego:Choyoołʼįįhí de-3	Kategorie:User de-3
Tʼááłáhági átʼéego:Choyoołʼįįhí de-4	Kategorie:User de-4
Tʼááłáhági átʼéego:Choyoołʼįįhí de-N	Kategorie:User de-M
Tʼááłáhági átʼéego:Choyoołʼįįhí dsb	Kategorie:User dsb
Tʼááłáhági átʼéego:Choyoołʼįįhí dsb-1	Kategorie:User dsb-1
Tʼááłáhági átʼéego:Choyoołʼįįhí dsb-2	Kategorie:User dsb-2
Tʼááłáhági átʼéego:Choyoołʼįįhí dsb-N	Kategorie:User dsb-M
Tʼááłáhági átʼéego:Choyoołʼįįhí el	Kategorie:User el
Tʼááłáhági átʼéego:Choyoołʼįįhí el-1	Kategorie:User el-1
Tʼááłáhági átʼéego:Choyoołʼįįhí el-2	Kategorie:User el-2
Tʼááłáhági átʼéego:Choyoołʼįįhí el-3	Kategorie:User el-3
Tʼááłáhági átʼéego:Choyoołʼįįhí el-4	Kategorie:User el-4
Tʼááłáhági átʼéego:Choyoołʼįįhí el-N	Kategorie:User el-M
Tʼááłáhági átʼéego:Choyoołʼįįhí en-0	Kategorie:User en-0
Tʼááłáhági átʼéego:Choyoołʼįįhí en-3	Kategorie:User en-3
Tʼááłáhági átʼéego:Choyoołʼįįhí en-5	Kategorie:User en-5
Tʼááłáhági átʼéego:Choyoołʼįįhí en-N	Kategorie:User en-M
Tʼááłáhági átʼéego:Choyoołʼįįhí eo-1	Kategorie:User eo-1
Tʼááłáhági átʼéego:Choyoołʼįįhí eo-2	Kategorie:User eo-2
Tʼááłáhági átʼéego:Choyoołʼįįhí eo-3	Kategorie:User eo-3
Tʼááłáhági átʼéego:Choyoołʼįįhí eo-4	Kategorie:User eo-4
Tʼááłáhági átʼéego:Choyoołʼįįhí eo-N	Kategorie:User eo-M
Tʼááłáhági átʼéego:Choyoołʼįįhí es	Kategorie:User es
Tʼááłáhági átʼéego:Choyoołʼįįhí es-1	Kategorie:User es-1
Tʼááłáhági átʼéego:Choyoołʼįįhí es-2	Kategorie:User es-2
Tʼááłáhági átʼéego:Choyoołʼįįhí es-3	Kategorie:User es-3
Tʼááłáhági átʼéego:Choyoołʼįįhí es-4	Kategorie:User es-4
Tʼááłáhági átʼéego:Choyoołʼįįhí es-N	Kategorie:User es-M
Tʼááłáhági átʼéego:Choyoołʼįįhí eu	Kategorie:User eu
Tʼááłáhági átʼéego:Choyoołʼįįhí eu-1	Kategorie:User eu-1
Tʼááłáhági átʼéego:Choyoołʼįįhí eu-2	Kategorie:User eu-2
Tʼááłáhági átʼéego:Choyoołʼįįhí eu-4	Kategorie:User eu-4
Tʼááłáhági átʼéego:Choyoołʼįįhí fa	Kategorie:User fa
Tʼááłáhági átʼéego:Choyoołʼįįhí fa-1	Kategorie:User fa-1
Tʼááłáhági átʼéego:Choyoołʼįįhí fa-2	Kategorie:User fa-2
Tʼááłáhági átʼéego:Choyoołʼįįhí fa-3	Kategorie:User fa-3
Tʼááłáhági átʼéego:Choyoołʼįįhí fa-N	Kategorie:User fa-M
Tʼááłáhági átʼéego:Choyoołʼįįhí fi	Kategorie:User fi
Tʼááłáhági átʼéego:Choyoołʼįįhí fi-2	Kategorie:User fi-2
Tʼááłáhági átʼéego:Gólízhii	Kategorie:Skunks
Tʼááłáhági átʼéego:Choyoołʼįįhí fi-3	Kategorie:User fi-3
Tʼááłáhági átʼéego:Choyoołʼįįhí fi-4	Kategorie:User fi-4
Tʼááłáhági átʼéego:Choyoołʼįįhí fi-N	Kategorie:User fi-M
Tʼááłáhági átʼéego:Choyoołʼįįhí fy	Kategorie:User fy
Tʼááłáhági átʼéego:Choyoołʼįįhí fy-1	Kategorie:User fy-1
Tʼááłáhági átʼéego:Choyoołʼįįhí ga-2	Kategorie:User ga-2
Tʼááłáhági átʼéego:Choyoołʼįįhí ga-3	Kategorie:User ga-3
Tʼááłáhági átʼéego:Choyoołʼįįhí ga-4	Kategorie:User ga-4
Tʼááłáhági átʼéego:Choyoołʼįįhí ga-N	Kategorie:User ga-M
Tʼááłáhági átʼéego:Choyoołʼįįhí grc	Kategorie:User grc
Tʼááłáhági átʼéego:Choyoołʼįįhí grc-1	Kategorie:User grc-1
Tʼááłáhági átʼéego:Choyoołʼįįhí grc-2	Kategorie:User grc-2
Tʼááłáhági átʼéego:Choyoołʼįįhí grc-3	Kategorie:User grc-3
Tʼááłáhági átʼéego:Choyoołʼįįhí grc-4	Kategorie:User grc-4
Tʼááłáhági átʼéego:Choyoołʼįįhí gsw	Kategorie:User gsw
Tʼááłáhági átʼéego:Choyoołʼįįhí gsw-3	Kategorie:User gsw-3
Tʼááłáhági átʼéego:Choyoołʼįįhí gsw-N	Kategorie:User gsw-M
Tʼááłáhági átʼéego:Choyoołʼįįhí he	Kategorie:User he
Tʼááłáhági átʼéego:Choyoołʼįįhí he-1	Kategorie:User he-1
Tʼááłáhági átʼéego:Choyoołʼįįhí he-2	Kategorie:User he-2
Tʼááłáhági átʼéego:Choyoołʼįįhí he-3	Kategorie:User he-3
Tʼááłáhági átʼéego:Choyoołʼįįhí he-4	Kategorie:User he-4
Tʼááłáhági átʼéego:Choyoołʼįįhí he-N	Kategorie:User he-M
Tʼááłáhági átʼéego:Choyoołʼįįhí hr-1	Kategorie:User hr-1
Tʼááłáhági átʼéego:Choyoołʼįįhí hr-2	Kategorie:User hr-2
Tʼááłáhági átʼéego:Choyoołʼįįhí hr-3	Kategorie:User hr-3
Tʼááłáhági átʼéego:Choyoołʼįįhí hr-4	Kategorie:User hr-4
Tʼááłáhági átʼéego:Choyoołʼįįhí hsb	Kategorie:User hsb
Tʼááłáhági átʼéego:Choyoołʼįįhí hsb-1	Kategorie:User hsb-1
Tʼááłáhági átʼéego:Choyoołʼįįhí hsb-2	Kategorie:User hsb-2
Tʼááłáhági átʼéego:Choyoołʼįįhí hsb-3	Kategorie:User hsb-3
Tʼááłáhági átʼéego:Choyoołʼįįhí hu	Kategorie:User hu
Tʼááłáhági átʼéego:Choyoołʼįįhí hu-1	Kategorie:User hu-1
Tʼááłáhági átʼéego:Choyoołʼįįhí hu-3	Kategorie:User hu-3
Tʼááłáhági átʼéego:Choyoołʼįįhí hy	Kategorie:User hy
Tʼááłáhági átʼéego:Choyoołʼįįhí hy-1	Kategorie:User hy-1
Tʼááłáhági átʼéego:Choyoołʼįįhí hy-2	Kategorie:User hy-2
Tʼááłáhági átʼéego:Choyoołʼįįhí hy-3	Kategorie:User hy-3
Tʼááłáhági átʼéego:Choyoołʼįįhí hy-4	Kategorie:User hy-4
Tʼááłáhági átʼéego:Choyoołʼįįhí id-1	Kategorie:User id-1
Tʼááłáhági átʼéego:Choyoołʼįįhí id-2	Kategorie:User id-2
Tʼááłáhági átʼéego:Choyoołʼįįhí id-3	Kategorie:User id-3
Tʼááłáhági átʼéego:Choyoołʼįįhí io	Kategorie:User io
Tʼááłáhági átʼéego:Choyoołʼįįhí io-1	Kategorie:User io-1
Tʼááłáhági átʼéego:Choyoołʼįįhí io-2	Kategorie:User io-2
Tʼááłáhági átʼéego:Choyoołʼįįhí io-3	Kategorie:User io-3
Tʼááłáhági átʼéego:Choyoołʼįįhí is	Kategorie:User is
Tʼááłáhági átʼéego:Choyoołʼįįhí is-1	Kategorie:User is-1
Tʼááłáhági átʼéego:Choyoołʼįįhí is-2	Kategorie:User is-2
Tʼááłáhági átʼéego:Choyoołʼįįhí is-3	Kategorie:User is-3
Tʼááłáhági átʼéego:Choyoołʼįįhí is-4	Kategorie:User is-4
Tʼááłáhági átʼéego:Choyoołʼįįhí als-N	Kategorie:User als-M
Bee álnééhí:User la-3	Vorlage:User la-3
Bee álnééhí:User swg-1	Vorlage:User swg-1
Tʼááłáhági átʼéego:Choyoołʼįįhí pt-3	Kategorie:User pt-3
Tʼááłáhági átʼéego:Choyoołʼįįhí pl-N	Kategorie:User pl-M
Tʼááłáhági átʼéego:Choyoołʼįįhí pt-1	Kategorie:User pt-1
Tʼááłáhági átʼéego:Choyoołʼįįhí ka-1	Kategorie:User ka-1
Tʼááłáhági átʼéego:Choyoołʼįįhí it	Kategorie:User it
Tʼááłáhági átʼéego:Choyoołʼįįhí it-1	Kategorie:User it-1
Tʼááłáhági átʼéego:Choyoołʼįįhí ja-1	Kategorie:User ja-1
Tʼááłáhági átʼéego:Choyoołʼįįhí jv	Kategorie:User jv
Tʼááłáhági átʼéego:Choyoołʼįįhí ka	Kategorie:User ka
Tʼááłáhági átʼéego:Choyoołʼįįhí ka-2	Kategorie:User ka-2
Tʼááłáhági átʼéego:Choyoołʼįįhí ka-N	Kategorie:User ka-M
Tʼááłáhági átʼéego:Choyoołʼįįhí kg	Kategorie:User kg
Tʼááłáhági átʼéego:Choyoołʼįįhí km-1	Kategorie:User km-1
Tʼááłáhági átʼéego:Choyoołʼįįhí km-2	Kategorie:User km-2
Tʼááłáhági átʼéego:Choyoołʼįįhí km-3	Kategorie:User km-3
Tʼááłáhági átʼéego:Choyoołʼįįhí km-4	Kategorie:User km-4
Tʼááłáhági átʼéego:Choyoołʼįįhí km-N	Kategorie:User km-M
Tʼááłáhági átʼéego:Choyoołʼįįhí kn	Kategorie:User kn
Tʼááłáhági átʼéego:Choyoołʼįįhí kn-1	Kategorie:User kn-1
Tʼááłáhági átʼéego:Choyoołʼįįhí ko	Kategorie:User ko
Tʼááłáhági átʼéego:Wááshindoon bikéyah bił haʼdaʼhaasdzoígíí	Kategorie:Bundesstaat der Vereinigten Staaten
Tʼááłáhági átʼéego:Choyoołʼįįhí ko-1	Kategorie:User ko-1
Tʼááłáhági átʼéego:Choyoołʼįįhí ko-2	Kategorie:User ko-2
Tʼááłáhági átʼéego:Choyoołʼįįhí ko-3	Kategorie:User ko-3
Tʼááłáhági átʼéego:Choyoołʼįįhí ksh	Kategorie:User ksh
Tʼááłáhági átʼéego:Choyoołʼįįhí ksh-1	Kategorie:User ksh-1
Tʼááłáhági átʼéego:Choyoołʼįįhí ksh-2	Kategorie:User ksh-2
Tʼááłáhági átʼéego:Choyoołʼįįhí ksh-3	Kategorie:User ksh-3
Tʼááłáhági átʼéego:Choyoołʼįįhí ksh-4	Kategorie:User ksh-4
Tʼááłáhági átʼéego:Choyoołʼįįhí ksh-N	Kategorie:User ksh-M
Tʼááłáhági átʼéego:Choyoołʼįįhí ku	Kategorie:User ku
Tʼááłáhági átʼéego:Choyoołʼįįhí ku-2	Kategorie:User ku-2
Tʼááłáhági átʼéego:Choyoołʼįįhí ku-3	Kategorie:User ku-3
Tʼááłáhági átʼéego:Choyoołʼįįhí ku-4	Kategorie:User ku-4
Tʼááłáhági átʼéego:Choyoołʼįįhí la-1	Kategorie:User la-1
Tʼááłáhági átʼéego:Choyoołʼįįhí la-3	Kategorie:User la-3
Tʼááłáhági átʼéego:Choyoołʼįįhí la-4	Kategorie:User la-4
Tʼááłáhági átʼéego:Choyoołʼįįhí lb	Kategorie:User lb
Tʼááłáhági átʼéego:Choyoołʼįįhí lb-1	Kategorie:User lb-1
Tʼááłáhági átʼéego:Choyoołʼįįhí lb-2	Kategorie:User lb-2
Tʼááłáhági átʼéego:Choyoołʼįįhí lb-3	Kategorie:User lb-3
Tʼááłáhági átʼéego:Choyoołʼįįhí lb-4	Kategorie:User lb-4
Tʼááłáhági átʼéego:Dibé Nitsaa Hahoodzodi kin naaznilígíí	Kategorie:Ort in Colorado
Bee álnééhí:User sh	Vorlage:User sh
Tʼááłáhági átʼéego:Choyoołʼįįhí nn-2	Kategorie:User nn-2
Bee álnééhí:User gl	Vorlage:User gl
Tʼááłáhági átʼéego:Choyoołʼįįhí ru-1	Kategorie:User ru-1
Bee álnééhí:User af-4	Vorlage:User af-4
Yaaʼ bijáád hastánígíí	Tierläuse
Bee álnééhí:User ta	Vorlage:User ta
Bee álnééhí:User sv-1	Vorlage:User sv-1
Tʼááłáhági átʼéego:Chʼil bikétłʼóól daadánígíí	Kategorie:Wurzelgemüse
Tʼááłáhági átʼéego:Choyoołʼįįhí lo	Kategorie:User lo
Tʼááłáhági átʼéego:Choyoołʼįįhí lo-1	Kategorie:User lo-1
Tʼááłáhági átʼéego:Choyoołʼįįhí lv	Kategorie:User lv
Tʼááłáhági átʼéego:Choyoołʼįįhí mn-1	Kategorie:User mn-1
Tʼááłáhági átʼéego:Choyoołʼįįhí mn-2	Kategorie:User mn-2
Tʼááłáhági átʼéego:Choyoołʼįįhí mn-3	Kategorie:User mn-3
Tʼááłáhági átʼéego:Choyoołʼįįhí mn-N	Kategorie:User mn-M
Tʼááłáhági átʼéego:Choyoołʼįįhí ms-1	Kategorie:User ms-1
Nahasdzáán bimagnetic field	Erdmagnetfeld
Tʼááłáhági átʼéego:Choyoołʼįįhí als-3	Kategorie:User als-3
Bee álnééhí:User jv	Vorlage:User jv
Bee álnééhí:User id	Vorlage:User id
Tʼááłáhági átʼéego:Choyoołʼįįhí nds	Kategorie:User nds
Tʼááłáhági átʼéego:Choyoołʼįįhí nds-1	Kategorie:User nds-1
Tʼááłáhági átʼéego:Choyoołʼįįhí nds-2	Kategorie:User nds-2
Tʼááłáhági átʼéego:Choyoołʼįįhí nds-3	Kategorie:User nds-3
Tʼááłáhági átʼéego:Choyoołʼįįhí nds-4	Kategorie:User nds-4
Tʼááłáhági átʼéego:Choyoołʼįįhí nds-N	Kategorie:User nds-M
Tʼááłáhági átʼéego:Choyoołʼįįhí nds-nl	Kategorie:User nds-nl
Bee álnééhí:User oc-1	Vorlage:User oc-1
Tʼááłáhági átʼéego:Kéyah Ałhidadiidzooígíí dóó Ahiih Yikaígíí	Kategorie:Internationale Organisation
Tʼááłáhági átʼéego:Chʼosh bijáád dahólónígíí	Kategorie:Gliederfüßer
Tʼááłáhági átʼéego:Tó	Kategorie:Wasser
Tʼááłáhági átʼéego:Bidił daazdoígíí dóó daʼalghałígíí	Kategorie:Raubtiere
Tʼááłáhági átʼéego:Choyoołʼįįhí tt-N	Kategorie:User tt-M
Tʼááłáhági átʼéego:Choyoołʼįįhí nn-1	Kategorie:User nn-1
Tʼááłáhági átʼéego:Choyoołʼįįhí nb	Kategorie:User nb
Bee álnééhí:User sw-1	Vorlage:User sw-1
Bee álnééhí:User ka-1	Vorlage:User ka-1
Bee álnééhí:User af	Vorlage:User af
Tʼááłáhági átʼéego:Naakaii Łizhiní Bikéyah	Kategorie:Staat in Afrika
Bee álnééhí:User da-3	Vorlage:User da-3
Bee álnééhí:User pt-4	Vorlage:User pt-4
Bee álnééhí:User grc-4	Vorlage:User grc-4
Bee álnééhí:User sl-3	Vorlage:User sl-3
Bee álnééhí:User ja-2	Vorlage:User ja-2
Bee álnééhí:User ko-2	Vorlage:User ko-2
Bee álnééhí:User ko-1	Vorlage:User ko-1
Bee álnééhí:User cs	Vorlage:User cs
Bee álnééhí:User ru-2	Vorlage:User ru-2
Bee álnééhí:User es-3	Vorlage:User es-3
Bee álnééhí:User ja-3	Vorlage:User ja-3
Bee álnééhí:User eu-1	Vorlage:User eu-1
Bee álnééhí:User ko-3	Vorlage:User ko-3
Tʼááłáhági átʼéego:Tsin bineestʼąʼ dadíkʼǫ́zhígíí	Kategorie:Zitrusfrucht
Tʼááłáhági átʼéego:Choyoołʼįįhí pt-2	Kategorie:User pt-2
Tʼááłáhági átʼéego:Choyoołʼįįhí pt-4	Kategorie:User pt-4
Tʼááłáhági átʼéego:Choyoołʼįįhí pt-N	Kategorie:User pt-M
Tʼááłáhági átʼéego:Choyoołʼįįhí qu	Kategorie:User qu
Tʼááłáhági átʼéego:Choyoołʼįįhí qu-1	Kategorie:User qu-1
Tʼááłáhági átʼéego:Choyoołʼįįhí qu-2	Kategorie:User qu-2
Tʼááłáhági átʼéego:Choyoołʼįįhí qu-3	Kategorie:User qu-3
Tʼááłáhági átʼéego:Choyoołʼįįhí qu-N	Kategorie:User qu-M
Tʼááłáhági átʼéego:Choyoołʼįįhí ro-2	Kategorie:User ro-2
Tʼááłáhági átʼéego:Choyoołʼįįhí ro-3	Kategorie:User ro-3
Tʼááłáhági átʼéego:Choyoołʼįįhí ro-4	Kategorie:User ro-4
Tʼááłáhági átʼéego:Choyoołʼįįhí ro-N	Kategorie:User ro-M
Tʼááłáhági átʼéego:Choyoołʼįįhí ru	Kategorie:User ru
Tʼááłáhági átʼéego:Choyoołʼįįhí ru-2	Kategorie:User ru-2
Tʼááłáhági átʼéego:Choyoołʼįįhí ru-3	Kategorie:User ru-3
Tʼááłáhági átʼéego:Choyoołʼįįhí ru-4	Kategorie:User ru-4
Tʼááłáhági átʼéego:Choyoołʼįįhí sk-1	Kategorie:User sk-1
Tʼááłáhági átʼéego:Choyoołʼįįhí sk-3	Kategorie:User sk-3
Tʼááłáhági átʼéego:Choyoołʼįįhí sk-4	Kategorie:User sk-4
Tʼááłáhági átʼéego:Choyoołʼįįhí sli	Kategorie:User sli
Tʼááłáhági átʼéego:Choyoołʼįįhí sli-1	Kategorie:User sli-1
Tʼááłáhági átʼéego:Choyoołʼįįhí sr	Kategorie:User sr
Tʼááłáhági átʼéego:Choyoołʼįįhí sr-1	Kategorie:User sr-1
Tʼááłáhági átʼéego:Choyoołʼįįhí sr-2	Kategorie:User sr-2
Tʼááłáhági átʼéego:Choyoołʼįįhí sr-3	Kategorie:User sr-3
Tʼááłáhági átʼéego:Choyoołʼįįhí sr-4	Kategorie:User sr-4
Tʼááłáhági átʼéego:Choyoołʼįįhí sr-N	Kategorie:User sr-M
Tʼááłáhági átʼéego:Choyoołʼįįhí stq	Kategorie:User stq
Tʼááłáhági átʼéego:Choyoołʼįįhí stq-1	Kategorie:User stq-1
Tʼááłáhági átʼéego:Choyoołʼįįhí sv-1	Kategorie:User sv-1
Tʼááłáhági átʼéego:Choyoołʼįįhí sv-3	Kategorie:User sv-3
Tʼááłáhági átʼéego:Choyoołʼįįhí sv-4	Kategorie:User sv-4
Tʼááłáhági átʼéego:Choyoołʼįįhí sv-N	Kategorie:User sv-M
Tʼááłáhági átʼéego:Choyoołʼįįhí swg	Kategorie:User swg
Tʼááłáhági átʼéego:Choyoołʼįįhí swg-1	Kategorie:User swg-1
Tʼááłáhági átʼéego:Choyoołʼįįhí swg-N	Kategorie:User swg-M
Tʼááłáhági átʼéego:Choyoołʼįįhí sxu	Kategorie:User sxu
Tʼááłáhági átʼéego:Choyoołʼįįhí sxu-1	Kategorie:User sxu-1
Tʼááłáhági átʼéego:Choyoołʼįįhí sxu-2	Kategorie:User sxu-2
Tʼááłáhági átʼéego:Choyoołʼįįhí sxu-3	Kategorie:User sxu-3
Tʼááłáhági átʼéego:Choyoołʼįįhí ta-1	Kategorie:User ta-1
Tʼááłáhági átʼéego:Choyoołʼįįhí ta-2	Kategorie:User ta-2
Tʼááłáhági átʼéego:Choyoołʼįįhí th-1	Kategorie:User th-1
Tʼááłáhági átʼéego:Choyoołʼįįhí th-2	Kategorie:User th-2
Tʼááłáhági átʼéego:Choyoołʼįįhí th-3	Kategorie:User th-3
Tʼááłáhági átʼéego:Choyoołʼįįhí th-N	Kategorie:User th-M
Tʼááłáhági átʼéego:Choyoołʼįįhí tr	Kategorie:User tr
Tʼááłáhági átʼéego:Choyoołʼįįhí tr-4	Kategorie:User tr-4
Tʼááłáhági átʼéego:Choyoołʼįįhí tr-N	Kategorie:User tr-M
Tʼááłáhági átʼéego:Choyoołʼįįhí tt	Kategorie:User tt
Tʼááłáhági átʼéego:Choyoołʼįįhí tt-1	Kategorie:User tt-1
Tʼááłáhági átʼéego:Choyoołʼįįhí tt-2	Kategorie:User tt-2
Tʼááłáhági átʼéego:Choyoołʼįįhí tt-3	Kategorie:User tt-3
Tʼááłáhági átʼéego:Choyoołʼįįhí tt-4	Kategorie:User tt-4
Tʼááłáhági átʼéego:Choyoołʼįįhí uk-1	Kategorie:User uk-1
Tʼááłáhági átʼéego:Choyoołʼįįhí uk-2	Kategorie:User uk-2
Tʼááłáhági átʼéego:Choyoołʼįįhí uk-3	Kategorie:User uk-3
Tʼááłáhági átʼéego:Choyoołʼįįhí uk-4	Kategorie:User uk-4
Tʼááłáhági átʼéego:Choyoołʼįįhí vi	Kategorie:User vi
Tʼááłáhági átʼéego:Choyoołʼįįhí vi-1	Kategorie:User vi-1
Tʼááłáhági átʼéego:Choyoołʼįįhí vi-2	Kategorie:User vi-2
Tʼááłáhági átʼéego:Choyoołʼįįhí vi-4	Kategorie:User vi-4
Tʼááłáhági átʼéego:Choyoołʼįįhí vi-N	Kategorie:User vi-M
Tʼááłáhági átʼéego:Choyoołʼįįhí vls	Kategorie:User vls
Tʼááłáhági átʼéego:Choyoołʼįįhí vls-1	Kategorie:User vls-1
Tʼááłáhági átʼéego:Choyoołʼįįhí yue-1	Kategorie:User zh-yue-1
Tʼááłáhági átʼéego:Choyoołʼįįhí yue-2	Kategorie:User zh-yue-2
Tʼááłáhági átʼéego:Choyoołʼįįhí yue-3	Kategorie:User zh-yue-3
Tʼááłáhági átʼéego:Choyoołʼįįhí yue-4	Kategorie:User zh-yue-4
Tʼááłáhági átʼéego:Choyoołʼįįhí yue-N	Kategorie:User zh-yue-M
Bee álnééhí:User ro-1	Vorlage:User ro-1
Tʼááłáhági átʼéego:Tsin ííʼáhígíí	Kategorie:Baum
Bee álnééhí:User th	Vorlage:User th
Bee álnééhí:User nds-2	Vorlage:User nds-2
Bee álnééhí:User ca	Vorlage:User ca
Tʼááłáhági átʼéego:Mágí: Diné Ndahalinígíí	Kategorie:Menschenartige
Tʼááłáhági átʼéego:Mágí	Kategorie:Primaten
Bee álnééhí:LivingP	Vorlage:Artikel über lebende Person
Bee álnééhí:User sv-3	Vorlage:User sv-3
Bee álnééhí:User hy-1	Vorlage:User hy-1
Bee álnééhí:User hsb-1	Vorlage:User hsb-1
Bee álnééhí:User hsb	Vorlage:User hsb
Tʼááłáhági átʼéego:Naʼiiniʼ	Kategorie:Handel
Bee álnééhí:User hsb-2	Vorlage:User hsb-2
Bee álnééhí:User af-3	Vorlage:User af-3
Tʼááłáhági átʼéego:Naaki góneʼ yéigo daʼahijoogą́ą́ʼ	Kategorie:Zweiter Weltkrieg
Bee álnééhí:User ms-1	Vorlage:User ms-1
Tʼááłáhági átʼéego:Mósí dóó Náshdóí	Kategorie:Katzen
Bee álnééhí:User nds	Vorlage:User nds
Bee álnééhí:User ar-4	Vorlage:User ar-4
Bee álnééhí:User az-2	Vorlage:User az-2
Bee álnééhí:User be	Vorlage:User be
Bee álnééhí:User ca-2	Vorlage:User ca-2
Bee álnééhí:User ca-3	Vorlage:User ca-3
Bee álnééhí:User cs-3	Vorlage:User cs-3
Bee álnééhí:User da-4	Vorlage:User da-4
Bee álnééhí:User el-2	Vorlage:User el-2
Bee álnééhí:User et-3	Vorlage:User et-3
Bee álnééhí:User fa-2	Vorlage:User fa-2
Bee álnééhí:User fa-3	Vorlage:User fa-3
Bee álnééhí:User fa-4	Vorlage:User fa-4
Bee álnééhí:User fi-2	Vorlage:User fi-2
Bee álnééhí:User fi-3	Vorlage:User fi-3
Bee álnééhí:User ga-2	Vorlage:User ga-2
Bee álnééhí:User he-3	Vorlage:User he-3
Bee álnééhí:User he-4	Vorlage:User he-4
Bee álnééhí:User hu-1	Vorlage:User hu-1
Bee álnééhí:User hy	Vorlage:User hy
Bee álnééhí:User ka	Vorlage:User ka
Bee álnééhí:User ko	Vorlage:User ko
Bee álnééhí:User ku	Vorlage:User ku
Bee álnééhí:User la-2	Vorlage:User la-2
Bee álnééhí:User lb-2	Vorlage:User lb-2
Bee álnééhí:User li-1	Vorlage:User li-1
Bee álnééhí:User li-3	Vorlage:User li-3
Bee álnééhí:User mk-1	Vorlage:User mk-1
Bee álnééhí:User nn-2	Vorlage:User nn-2
Bee álnééhí:User no-1	Vorlage:User no-1
Bee álnééhí:User pl-2	Vorlage:User pl-2
Bee álnééhí:User pt	Vorlage:User pt
Bee álnééhí:User ro-2	Vorlage:User ro-2
Bee álnééhí:User ru-1	Vorlage:User ru-1
Bee álnééhí:User sa-1	Vorlage:User sa-1
Bee álnééhí:User sk-1	Vorlage:User sk-1
Bee álnééhí:User sk-2	Vorlage:User sk-2
Bee álnééhí:User sk-3	Vorlage:User sk-3
Bee álnééhí:User sr-1	Vorlage:User sr-1
Bee álnééhí:User sxu-1	Vorlage:User sxu-1
Bee álnééhí:User tr-1	Vorlage:User tr-1
Bee álnééhí:User tr-3	Vorlage:User tr-3
Bee álnééhí:User uk-1	Vorlage:User uk-1
Bee álnééhí:User uk-4	Vorlage:User uk-4
Bee álnééhí:User vo-1	Vorlage:User vo-1
Bee álnééhí:User zh-1	Vorlage:User zh-1
Bee álnééhí:User zh-2	Vorlage:User zh-2
Bee álnééhí:User zh-3	Vorlage:User zh-3
Bee álnééhí:User zh-4	Vorlage:User zh-4
Tʼááłáhági átʼéego:Choyoołʼįįhí nl	Kategorie:User nl
Tʼááłáhági átʼéego:Choyoołʼįįhí nn-3	Kategorie:User nn-3
Tʼááłáhági átʼéego:Choyoołʼįįhí no-1	Kategorie:User no-1
Tʼááłáhági átʼéego:Choyoołʼįįhí no-2	Kategorie:User no-2
Tʼááłáhági átʼéego:Choyoołʼįįhí no	Kategorie:User no
Tʼááłáhági átʼéego:Choyoołʼįįhí pi-1	Kategorie:User pi-1
Tʼááłáhági átʼéego:Choyoołʼįįhí nds-nl-1	Kategorie:User nds-nl-1
Tʼááłáhági átʼéego:Choyoołʼįįhí zh-1	Kategorie:User zh-1
Tʼááłáhági átʼéego:Choyoołʼįįhí zh-4	Kategorie:User zh-4
Tʼááłáhági átʼéego:Choyoołʼįįhí zh-3	Kategorie:User zh-3
Tʼááłáhági átʼéego:Choyoołʼįįhí zh-2	Kategorie:User zh-2
Tʼááłáhági átʼéego:Chʼał	Kategorie:Froschlurche
Tʼááłáhági átʼéego:Atłʼóóh	Kategorie:Verfahren (Weberei)
Tʼááłáhági átʼéego:Mąʼii yił Ałhidanoolinígíí Yázhí	Kategorie:Kleinbären
Tʼááłáhági átʼéego:Dlǫ́ʼiitsoh Danilínígíí	Kategorie:Schleichkatzen
Tʼááłáhági átʼéego:Chéłchaaʼ	Kategorie:Käfer
Tʼááłáhági átʼéego:Naakáí dootłʼizhí dóó Bééshbichʼahii dabizaad ndahalinígíí	Kategorie:Indogermanische Sprachen
Tʼááłáhági átʼéego:Hazéí	Kategorie:Hörnchen
Tʼááłáhági átʼéego:Chidí naatʼaʼí ńdinibįįhígi	Kategorie:Flughafen
Tʼááłáhági átʼéego:Áʼádaatʼéhígíí	Kategorie:Chemisches Element
Bee álnééhí:User pfl-1	Vorlage:User pfl-1
Bee álnééhí:User als-2	Vorlage:User als-2
Bee álnééhí:User als-4	Vorlage:User als-4
Bee álnééhí:User gsw-3	Vorlage:User gsw-3
Bee álnééhí:User de-4	Vorlage:User de-4
Tʼááłáhági átʼéego:Biwooʼ Ádaałtsʼíísígíí dóó Kááʼtsʼiní	Kategorie:Nebengelenktiere
Tʼááłáhági átʼéego:Abeʼ bitsʼą́ą́dóó ádaalyaaígíí	Kategorie:Milchprodukt
Tʼááłáhági átʼéego:Tsin dóó chʼil bineestʼąʼ	Kategorie:Obst
Tʼááłáhági átʼéego:Kʼaalógii dóó Iichʼąhii	Kategorie:Schmetterlinge
Tʼááłáhági átʼéego:Chʼosh bijáád ádaadinígíí	Kategorie:Weichtiere
Tʼááłáhági átʼéego:Deeteel Bikéyah bił haʼdaʼhaasdzoígíí	Kategorie:Kanada nach Provinz oder Territorium
Tʼááłáhági átʼéego:Shádiʼááhdę́ę́ʼ Mágí	Kategorie:Neuweltaffen
Tʼááłáhági átʼéego:Gáagii dóó Joogii Ndahalinígíí	Kategorie:Rabenvögel
Tʼááłáhági átʼéego:Mąʼii dóó Łééchąąʼí	Kategorie:Hunde
Tʼááłáhági átʼéego:Tó Wónaanídę́ę́ʼ Mágí	Kategorie:Meerkatzenverwandte
Tʼááłáhági átʼéego:Naayízí dóó taʼneeskʼání	Kategorie:Cucurbitaceae
Tʼááłáhági átʼéego:Dlǫ́ʼii Ndahalinígíí	Kategorie:Marder
Tʼááłáhági átʼéego:Łóóʼtsoh biwooʼ daditsʼózígíí	Kategorie:Bartenwale
Tʼááłáhági átʼéego:Naaldeehii	Kategorie:Vielzellige Tiere
Tʼááłáhági átʼéego:Bizaʼazis Dahólónígíí	Kategorie:Beutelsäuger
Tʼááłáhági átʼéego:Choyoołʼįįhí pfl-1	Kategorie:User pfl-1
Tłʼiishdą́ą́ʼ	Dreiblütiger Nachtschatten
Tʼááłáhági átʼéego:Chʼosh chʼééh diikáhii	Kategorie:Schnecken
Tʼááłáhági átʼéego:Chʼosh bitsʼaʼígíí	Kategorie:Muscheln
Tʼááłáhági átʼéego:Gah	Kategorie:Hasenartige
Tʼááłáhági átʼéego:Łóóʼtsoh dóó Tééh hóyáanii	Kategorie:Wale
Bee álnééhí:User bn	Vorlage:User bn
Bee álnééhí:User fy-1	Vorlage:User fy-1
Bee álnééhí:User id-4	Vorlage:User id-4
Bee álnééhí:User uk-3	Vorlage:User uk-3
Bee álnééhí:User bn-2	Vorlage:User bn-2
Tʼááłáhági átʼéego:Eʼeʼaahjí Tónteel bikáaʼgi Kéyah dah Ndaaʼeełígíí	Kategorie:Insel (Pazifischer Ozean)
Tʼááłáhági átʼéego:Łóóʼ Bigaan Dahólónígíí	Kategorie:Kopffüßer
Tʼááłáhági átʼéego:Chʼééh digháhii dóó Tsisteeł	Kategorie:Schildkröten
Tʼááłáhági átʼéego:Béésh	Kategorie:Metall
Tʼááłáhági átʼéego:Naayééʼ	Kategorie:Dinosaurier
Tʼááłáhági átʼéego:Choyoołʼįįhí pi	Kategorie:User pi
Tʼááłáhági átʼéego:Choyoołʼįįhí pl	Kategorie:User pl
Tʼááłáhági átʼéego:Choyoołʼįįhí th-4	Kategorie:User th-4
Tʼááłáhági átʼéego:Chʼosh bikágí dantłʼizí	Kategorie:Krebstiere
Tʼááłáhági átʼéego:Jaaʼabaní	Kategorie:Fledertiere
Tʼááłáhági átʼéego:Tłʼiish	Kategorie:Schlangen
Tʼááłáhági átʼéego:Shádiʼááhjí kéyah yistinígíí	Kategorie:Antarktika
Tʼááłáhági átʼéego:Beʼekʼid	Kategorie:See
Kʼíshíshjį́į́zh	Kletternder Gift-Sumach
Bee álnééhí:User sl	Vorlage:User sl
Tʼááłáhági átʼéego:Bįįh	Kategorie:Hirsche
Bee álnééhí:User sw-3	Vorlage:User sw-3
Tʼááłáhági átʼéego:Łóóʼ ooshgę́ęzhii	Kategorie:Knorpelfische
Bee álnééhí:User hsb-3	Vorlage:User hsb-3
Tʼááłáhági átʼéego:Chidí	Kategorie:Automobil
Bee álnééhí:User ga-1	Vorlage:User ga-1
Bee álnééhí:User lb	Vorlage:User lb
Bee álnééhí:User af-2	Vorlage:User af-2
Chąąshtʼezhiitsoh	Karotte
Tséyooʼáałii	Rüsselkäfer
Tʼááłáhági átʼéego:Łį́į́ʼ Ndahalinígíí	Kategorie:Pferde
Tʼááłáhági átʼéego:Wóʼatsʼǫǫsii Ádaatʼéhígíí	Kategorie:Schnabelkerfe
Tʼááłáhági átʼéego:Tsin Deigházhígíí	Kategorie:Nagetiere
Bee álnééhí:User hr-2	Vorlage:User hr-2
Bee álnééhí:User sl-1	Vorlage:User sl-1
Tʼááłáhági átʼéego:Choyoołʼįįhí ab	Kategorie:User ab
Tʼááłáhági átʼéego:Choyoołʼįįhí ab-3	Kategorie:User ab-3
Tʼááłáhági átʼéego:Choyoołʼįįhí ab-N	Kategorie:User ab-M
Bee álnééhí:User pl-3	Vorlage:User pl-3
Bee álnééhí:User pl-4	Vorlage:User pl-4
Bee álnééhí:User an-1	Vorlage:User an-1
Bee álnééhí:User yue-4	Vorlage:User zh-yue-4
Bee álnééhí:User yue-2	Vorlage:User zh-yue-2
Bee álnééhí:User wep-1	Vorlage:User wep-1
Bee álnééhí:User vo-4	Vorlage:User vo-4
Bee álnééhí:User vo-3	Vorlage:User vo-3
Bee álnééhí:User vo-2	Vorlage:User vo-2
Bee álnééhí:User vi-4	Vorlage:User vi-4
Bee álnééhí:User vi-2	Vorlage:User vi-2
Bee álnééhí:User vi-1	Vorlage:User vi-1
Bee álnééhí:User tt-3	Vorlage:User tt-3
Bee álnééhí:User tt-2	Vorlage:User tt-2
Bee álnééhí:User tt-1	Vorlage:User tt-1
Bee álnééhí:User ta-3	Vorlage:User ta-3
Bee álnééhí:User ta-1	Vorlage:User ta-1
Bee álnééhí:User sxu-3	Vorlage:User sxu-3
Bee álnééhí:User sxu-2	Vorlage:User sxu-2
Bee álnééhí:User sxu	Vorlage:User sxu
Bee álnééhí:User swg	Vorlage:User swg
Bee álnééhí:User sw	Vorlage:User sw
Bee álnééhí:User stq-1	Vorlage:User stq-1
Bee álnééhí:User sr-4	Vorlage:User sr-4
Bee álnééhí:User sr-3	Vorlage:User sr-3
Bee álnééhí:User sr-2	Vorlage:User sr-2
Bee álnééhí:User sl-2	Vorlage:User sl-2
Bee álnééhí:User sk-4	Vorlage:User sk-4
Bee álnééhí:User sh-4	Vorlage:User sh-4
Bee álnééhí:User sh-3	Vorlage:User sh-3
Bee álnééhí:User sh-1	Vorlage:User sh-1
Bee álnééhí:User sc-1	Vorlage:User sc-1
Bee álnééhí:User sa-3	Vorlage:User sa-3
Bee álnééhí:User qu-3	Vorlage:User qu-3
Bee álnééhí:User qu-2	Vorlage:User qu-2
Bee álnééhí:User qu-1	Vorlage:User qu-1
Bee álnééhí:User pi-1	Vorlage:User pi-1
Bee álnééhí:User pfl	Vorlage:User pfl
Bee álnééhí:User oc-3	Vorlage:User oc-3
Bee álnééhí:User oc-2	Vorlage:User oc-2
Bee álnééhí:User oc	Vorlage:User oc
Bee álnééhí:User nds-3	Vorlage:User nds-3
Bee álnééhí:User nb	Vorlage:User nb
Bee álnééhí:User nah-1	Vorlage:User nah-1
Bee álnééhí:User mn-4	Vorlage:User mn-4
Bee álnééhí:User mn-3	Vorlage:User mn-3
Bee álnééhí:User mn-2	Vorlage:User mn-2
Bee álnééhí:User mn-1	Vorlage:User mn-1
Bee álnééhí:User mn	Vorlage:User mn
Bee álnééhí:User mk-3	Vorlage:User mk-3
Bee álnééhí:User mk-2	Vorlage:User mk-2
Bee álnééhí:User mk	Vorlage:User mk
Bee álnééhí:User lv-1	Vorlage:User lv-1
Bee álnééhí:User lt-4	Vorlage:User lt-4
Bee álnééhí:User lt-3	Vorlage:User lt-3
Bee álnééhí:User lt-1	Vorlage:User lt-1
Bee álnééhí:User lo-1	Vorlage:User lo-1
Bee álnééhí:User li-2	Vorlage:User li-2
Bee álnééhí:User lb-4	Vorlage:User lb-4
Bee álnééhí:User lb-3	Vorlage:User lb-3
Bee álnééhí:User la-4	Vorlage:User la-4
Bee álnééhí:User ku-4	Vorlage:User ku-4
Bee álnééhí:User ku-3	Vorlage:User ku-3
Bee álnééhí:User ku-2	Vorlage:User ku-2
Bee álnééhí:User ku-1	Vorlage:User ku-1
Bee álnééhí:User ksh-4	Vorlage:User ksh-4
Bee álnééhí:User ksh-3	Vorlage:User ksh-3
Bee álnééhí:User ksh-2	Vorlage:User ksh-2
Bee álnééhí:User ksh-1	Vorlage:User ksh-1
Bee álnééhí:User ka-2	Vorlage:User ka-2
Bee álnééhí:User it-4	Vorlage:User it-4
Bee álnééhí:User is-4	Vorlage:User is-4
Bee álnééhí:User is-3	Vorlage:User is-3
Bee álnééhí:User io-2	Vorlage:User io-2
Bee álnééhí:User io-1	Vorlage:User io-1
Bee álnééhí:User id-2	Vorlage:User id-2
Bee álnééhí:User ia-1	Vorlage:User ia-1
Bee álnééhí:User hr-3	Vorlage:User hr-3
Bee álnééhí:User hi-4	Vorlage:User hi-4
Bee álnééhí:User hi-2	Vorlage:User hi-2
Bee álnééhí:User grc-3	Vorlage:User grc-3
Bee álnééhí:User grc-2	Vorlage:User grc-2
Bee álnééhí:User gn-2	Vorlage:User gn-2
Bee álnééhí:User ga	Vorlage:User ga
Bee álnééhí:User fi-4	Vorlage:User fi-4
Bee álnééhí:User et-4	Vorlage:User et-4
Bee álnééhí:User et-2	Vorlage:User et-2
Bee álnééhí:User et	Vorlage:User et
Bee álnééhí:User el-4	Vorlage:User el-4
Bee álnééhí:User el-3	Vorlage:User el-3
Bee álnééhí:User dsb-2	Vorlage:User dsb-2
Bee álnééhí:User dsb	Vorlage:User dsb
Bee álnééhí:User cy-3	Vorlage:User cy-3
Bee álnééhí:User cy-2	Vorlage:User cy-2
Bee álnééhí:User cy-1	Vorlage:User cy-1
Bee álnééhí:User cy	Vorlage:User cy
Bee álnééhí:User csb-1	Vorlage:User csb-1
Bee álnééhí:User cs-4	Vorlage:User cs-4
Bee álnééhí:User bs-2	Vorlage:User bs-2
Bee álnééhí:User bg-4	Vorlage:User bg-4
Bee álnééhí:User bg-3	Vorlage:User bg-3
Bee álnééhí:User bg-2	Vorlage:User bg-2
Bee álnééhí:User be-3	Vorlage:User be-3
Bee álnééhí:User be-1	Vorlage:User be-1
Bee álnééhí:User an	Vorlage:User an
Bee álnééhí:User tt	Vorlage:User tt
Bee álnééhí:User gl-2	Vorlage:User gl-2
Bee álnééhí:User eu-3	Vorlage:User eu-3
Bee álnééhí:User ast	Vorlage:User ast
Bee álnééhí:User ro-3	Vorlage:User ro-3
Tʼááłáhági átʼéego:Dlǫ́ʼii yił Aheedaałtʼéhígíí	Kategorie:Mangusten
Bee álnééhí:User mk-4	Vorlage:User mk-4
Bee álnééhí:User nds-4	Vorlage:User nds-4
Bee álnééhí:User eu-2	Vorlage:User eu-2
Bee álnééhí:User sli-1	Vorlage:User sli-1
Tʼááłáhági átʼéego:Hoozdo Hahoodzodi chidí naatʼaʼí ńdinibįįhígi	Kategorie:Flughafen in Arizona
Tʼááłáhági átʼéego:Yootó Hahoodzodi chidí naatʼaʼí ńdinibįįhígi	Kategorie:Flughafen in New Mexico
Tʼááłáhági átʼéego:Beeʼeldííldahsinil	Kategorie:Albuquerque
Tʼááłáhági átʼéego:Chʼosh Deildeełii	Kategorie:Insektenfresser
Tʼááłáhági átʼéego:Choyoołʼįįhí sxu-4	Kategorie:User sxu-4
Tʼááłáhági átʼéego:Tábąąstííntsoh	Kategorie:Robben
Tʼááłáhági átʼéego:Táłkáaʼgi Tsídii	Kategorie:Gänsevögel
Tʼááłáhági átʼéego:Tsísʼná dóó Wáláchííʼ	Kategorie:Taillenwespen
Tʼááłáhági átʼéego:Chʼosh bijáád tseebíhígíí	Kategorie:Spinnentiere
Tʼááłáhági átʼéego:Yágháhonikáánji biłnaaztʼiʼígíí	Kategorie:Weltraumforschung
Tʼááłáhági átʼéego:Shash	Kategorie:Bären
Tʼááłáhági átʼéego:Tsin deiłkaałii	Kategorie:Spechte
Tʼááłáhági átʼéego:Tsékooh	Kategorie:Canyon
Tó bichʼoshtsoh	Riesenwanzen
Tʼááłáhági átʼéego:Chʼosh bijáád neeznánígíí	Kategorie:Zehnfußkrebse
Tʼááłáhági átʼéego:Bílaʼashdlaʼii bilį́į́ʼ danilínígíí	Kategorie:Haustier
Tʼááłáhági átʼéego:Dziil / Atsiniltłʼish álʼį́	Kategorie:Energiewesen
Tʼááłáhági átʼéego:Tsʼíʼii dóó Tséʼédǫ́ʼii	Kategorie:Zweiflügler
Bee álnééhí:User ko-4	Vorlage:User ko-4
Tʼááłáhági átʼéego:Tązhii dóó Naaʼahóóhai Ndahalinígíí	Kategorie:Hühnervögel
Tʼááłáhági átʼéego:Tééh łééchąąʼí	Kategorie:Hyänen
Tʼááłáhági átʼéego:Wónitłʼizí	Kategorie:Asseln
Tʼááłáhági átʼéego:Kǫʼ naʼałbąąsii ninádaaltłiʼígi	Kategorie:Bahnhof
Tʼááłáhági átʼéego:Daʼałtʼoʼígíí biyęęzhii deiłchíhígíí	Kategorie:Kloakentiere
Tʼááłáhági átʼéego:Chéłchaaʼ bigaantéłígíí	Kategorie:Blatthornkäfer
Tʼááłáhági átʼéego:Tábąąsdísí	Kategorie:Schnepfenvögel
Tʼááłáhági átʼéego:Séigoʼ	Kategorie:Skorpione
Tʼááłáhági átʼéego:Táłtłʼááhdę́ę́ʼ dóó tónteel biyiʼdę́ę́ʼ chʼiyáán	Kategorie:Fisch und Meeresfrüchte
Tʼááłáhági átʼéego:Tsin naaʼeeł	Kategorie:Schiff
Tʼááłáhági átʼéego:Naʼashjéʼii	Kategorie:Webspinnen
Tʼááłáhági átʼéego:Jááłánii	Kategorie:Tausendfüßer
Tʼááłáhági átʼéego:Bisóodi	Kategorie:Schweinerasse
Tʼááłáhági átʼéego:Choyoołʼįįhí ba-3	Kategorie:User ba-3
Tʼááłáhági átʼéego:Choyoołʼįįhí ba-4	Kategorie:User ba-4
Tʼááłáhági átʼéego:Choyoołʼįįhí ba-N	Kategorie:User ba-M
Tʼááłáhági átʼéego:Choyoołʼįįhí ce-1	Kategorie:User ce-1
Tʼááłáhági átʼéego:Choyoołʼįįhí dsb-3	Kategorie:User dsb-3
Tʼááłáhági átʼéego:Choyoołʼįįhí pfl	Kategorie:User pfl
Tʼááłáhági átʼéego:Choyoołʼįįhí dsb-4	Kategorie:User dsb-4
Tʼááłáhági átʼéego:Choyoołʼįįhí frr-N	Kategorie:User frr-M
Tʼááłáhági átʼéego:Choyoołʼįįhí hsb-4	Kategorie:User hsb-4
Tʼááłáhági átʼéego:Choyoołʼįįhí kg-1	Kategorie:User kg-1
Tʼááłáhági átʼéego:Choyoołʼįįhí no-4	Kategorie:User no-4
Tʼááłáhági átʼéego:Choyoołʼįįhí pfl-N	Kategorie:User pfl-M
Tʼááłáhági átʼéego:Azeeʼ	Kategorie:Heilpflanze
Tʼááłáhági átʼéego:Choyoołʼįįhí vo-3	Kategorie:User vo-3
Tʼááłáhági átʼéego:Choyoołʼįįhí vo-4	Kategorie:User vo-4
Tʼááłáhági átʼéego:Choyoołʼįįhí wep-1	Kategorie:User wep-1
Tʼááłáhági átʼéego:Choyoołʼįįhí nl-4	Kategorie:User nl-4
Tʼááłáhági átʼéego:Naʼastsʼǫǫsí dóó Łéʼétsoh	Kategorie:Langschwanzmäuse
Bee álnééhí:User cs-2	Vorlage:User cs-2
Bee álnééhí:Image label begin	Vorlage:Image label begin
Tʼááłáhági átʼéego:Yootó Hahoodzodi kin naaznilígíí	Kategorie:Ort in New Mexico
Tʼááłáhági átʼéego:Choyoołʼįįhí ay-2	Kategorie:User ay-2
Tʼááłáhági átʼéego:Choyoołʼįįhí ay-3	Kategorie:User ay-3
Tʼááłáhági átʼéego:Choyoołʼįįhí ay-N	Kategorie:User ay-M
Tʼááłáhági átʼéego:Choyoołʼįįhí ce-4	Kategorie:User ce-4
Tʼááłáhági átʼéego:Choyoołʼįįhí hsb-N	Kategorie:User hsb-M
Tʼááłáhági átʼéego:Choyoołʼįįhí mn-4	Kategorie:User mn-4
Tʼááłáhági átʼéego:Choyoołʼįįhí pdc-N	Kategorie:User pdc-M
Tʼááłáhági átʼéego:Choyoołʼįįhí qu-4	Kategorie:User qu-4
Tʼááłáhági átʼéego:Choyoołʼįįhí sli-N	Kategorie:User sli-M
Tʼááłáhági átʼéego:Choyoołʼįįhí swg-2	Kategorie:User swg-2
Tʼááłáhági átʼéego:Choyoołʼįįhí swg-3	Kategorie:User swg-3
Tʼááłáhági átʼéego:Choyoołʼįįhí swg-4	Kategorie:User swg-4
Tʼááłáhági átʼéego:Choyoołʼįįhí sxu-N	Kategorie:User sxu-M
Tʼááłáhági átʼéego:Choyoołʼįįhí wep	Kategorie:User wep
Tʼááłáhági átʼéego:Choyoołʼįįhí fa-4	Kategorie:User fa-4
Bee álnééhí:User nn-3	Vorlage:User nn-3
Bee álnééhí:User vi	Vorlage:User vi
Tʼááłáhági átʼéego:Choyoołʼįįhí en-1	Kategorie:User en-1
Tʼááłáhági átʼéego:Choyoołʼįįhí de-1	Kategorie:User de-1
Tʼááłáhági átʼéego:Choyoołʼįįhí da-N	Kategorie:User da-M
Tʼááłáhági átʼéego:Choyoołʼįįhí gl-2	Kategorie:User gl-2
Tʼááłáhági átʼéego:Choyoołʼįįhí or	Kategorie:User or
Yaaʼ bijáád tseebíhígíí	Zecken
Bee álnééhí:User vls-1	Vorlage:User vls-1
Dahsání	Urson
Tsiiyázhí (dééł)	Trompetervögel
Bee álnééhí:User nl-4	Vorlage:User nl-4
Bee álnééhí:User no-4	Vorlage:User no-4
Bee álnééhí:User nn-1	Vorlage:User nn-1
Bee álnééhí:User lt-2	Vorlage:User lt-2
Bee álnééhí:User ru-3	Vorlage:User ru-3
Bee álnééhí:User be-4	Vorlage:User be-4
Bee álnééhí:User az-1	Vorlage:User az-1
Bee álnééhí:User nl-3	Vorlage:User nl-3
Bee álnééhí:User nn	Vorlage:User nn
Bee álnééhí:User az-4	Vorlage:User az-4
Bee álnééhí:User hsb-4	Vorlage:User hsb-4
Bee álnééhí:User dsb-1	Vorlage:User dsb-1
Bee álnééhí:User bar	Vorlage:User bar
Bee álnééhí:User km-1	Vorlage:User km-1
Bee álnééhí:User sa-2	Vorlage:User sa-2
Bee álnééhí:User li	Vorlage:User li
Bee álnééhí:User sxu-4	Vorlage:User sxu-4
Bee álnééhí:User swg-4	Vorlage:User swg-4
Bee álnééhí:User bar-2	Vorlage:User bar-2
Bee álnééhí:User hy-2	Vorlage:User hy-2
Bee álnééhí:User fy	Vorlage:User fy
Bee álnééhí:User sv-4	Vorlage:User sv-4
Bee álnééhí:User dsb-3	Vorlage:User dsb-3
Bee álnééhí:User km-3	Vorlage:User km-3
Bee álnééhí:User nds-nl-1	Vorlage:User nds-nl-1
Bee álnééhí:User hi	Vorlage:User hi
Bee álnééhí:User hu-2	Vorlage:User hu-2
Bee álnééhí:User hr-4	Vorlage:User hr-4
Bee álnééhí:User sw-2	Vorlage:User sw-2
Bee álnééhí:User als-3	Vorlage:User als-3
Bee álnééhí:User km-4	Vorlage:User km-4
Bee álnééhí:User bar-3	Vorlage:User bar-3
Bee álnééhí:User km	Vorlage:User km
Bee álnééhí:User th-2	Vorlage:User th-2
Bee álnééhí:User sh-2	Vorlage:User sh-2
Bee álnééhí:User hu-4	Vorlage:User hu-4
Bee álnééhí:User km-2	Vorlage:User km-2
Bee álnééhí:User cy-4	Vorlage:User cy-4
Bee álnééhí:User hu-3	Vorlage:User hu-3
Bee álnééhí:User bar-4	Vorlage:User bar-4
Bee álnééhí:User sw-4	Vorlage:User sw-4
Bee álnééhí:User tt-4	Vorlage:User tt-4
Bee álnééhí:User pdc	Vorlage:User pdc
Bee álnééhí:User ga-3	Vorlage:User ga-3
Bee álnééhí:User qu	Vorlage:User qu
Bee álnééhí:User dsb-4	Vorlage:User dsb-4
Bee álnééhí:User swg-3	Vorlage:User swg-3
Bee álnééhí:User kn-1	Vorlage:User kn-1
Bee álnééhí:User gsw-4	Vorlage:User gsw-4
Bee álnééhí:User sl-4	Vorlage:User sl-4
Bee álnééhí:User vi-3	Vorlage:User vi-3
Bee álnééhí:User th-3	Vorlage:User th-3
Bee álnééhí:User ta-2	Vorlage:User ta-2
Bee álnééhí:User id-1	Vorlage:User id-1
Bee álnééhí:User swg-2	Vorlage:User swg-2
Kʼaalógii	Tagfalter
Mąʼii Deeshgiizhnii	Jemez
Akétłʼóól łichxííʼí yázhí	Garten-Rettich
Tʼááłáhági átʼéego:Choyoołʼįįhí als-4	Kategorie:User als-4
Bee álnééhí:User gsw	Vorlage:User gsw
Bee álnééhí:User gsw-2	Vorlage:User gsw-2
Bee álnééhí:User sli	Vorlage:User sli
Wónitłʼizí ntsxaaígíí	Riesenasseln
Special:RecentChanges	Spezial:Letzte Änderungen
Tʼááłáhági átʼéego:Choyoołʼįįhí ja-4	Kategorie:User ja-4
Ábishjaaʼ łóóʼ	Dendrogramma
