Afrika	Afrika
Jabaan	Japan
Ameerikada koonfureed	Südamerika
Norway	Norwegen
Ingiriiska	England
Skotland	Schottland
Waalis	Wales
Waqooyiga Ayrland	Nordirland
Ireland	Irland
Hungaria	Ungarn
Isbania	Spanien
Mareykanka	Vereinigte Staaten
Beljim	Belgien
Luksemburg	Luxemburg
Koon	Universum
Dhul	Erde
Nolosha	Leben
Biniaadan	Mensch
George Washington	George Washington
Finland	Finnland
Iswiidhan	Schweden
Denmark	Dänemark
Boland	Polen
Lithuaniya	Litauen
Talyaaniga	Italien
Iswisarland	Schweiz
Austriya	Österreich
Giriig	Griechenland
Turkiga	Türkei
Bortuqaal	Portugal
Yurub	Europa
Aasiya	Asien
Woqooyiga Ameerika	Nordamerika
Antiarktis	Antarktika
Wikipedia	Wikipedia
Holland	Niederlande
New York	New York City
Washington D.C	Washington, D.C.
Baarliin	Berlin
Los Angeles	Los Angeles
Boeing	Boeing
Kumbuyuutar	Computer
Jineefa	Genf
Internet	Internet
Barack Obama	Barack Obama
Uruguay	Uruguay
London	London
Qaahiro	Kairo
Baariis	Paris
Android	Android (Betriebssystem)
Google	Google Inc.
Meksiko	Mexiko
Badweynta Atlaantik	Atlantischer Ozean
Badweynta Baasifik	Pazifischer Ozean
Kalifornia	Kalifornien
Isniin	Montag
Janaayo	Januar
Febraayo	Februar
Maarso	März
Farraare	Mars (Planet)
Kiinya	Kenia
Itoobiya	Äthiopien
Gaana	Ghana
Abriil	April
May	Mai
Juun	Juni
Luuliyo	Juli
Agoosto	August
Sebteembar	September
Oktoobar	Oktober
Nofeembar	November
Diseembar	Dezember
Talaado	Dienstag
Arbaco	Mittwoch
Khamiis	Donnerstag
Jimco	Freitag
Sabti	Samstag
Axad	Sonntag
Libaax	Löwe
Faransiiska	Frankreich
Esberanto	Esperanto
Ey	Haushund
Midowga boqortooyada Britan	Vereinigtes Königreich
Yaanyuur	Hauskatze
Shiinaha	Volksrepublik China
Af-Faransiis	Französische Sprache
Malaay	Fische
Khamri	Alkoholisches Getränk
Barasiil	Brasilien
François Hollande	François Hollande
Ruushka	Russland
Nibiri	Wale
Labajibaarane	Quadrat
Bad	Meer
Bada madaw	Schwarzes Meer
Pi Sumad xisaabeed	Kreiszahl
Wiki	Wiki
Toronto	Toronto
Alabama	Alabama
São Paulo	São Paulo
São Paulo (Gobol)	São Paulo (Bundesstaat)
Wikimedia	Wikimedia
Jimmy Wales	Jimmy Wales
Ingiriis	English
Jarmalka	Deutschland
Belarus	Weißrussland
Af-Jarmal	Deutsche Sprache
Island	Island
Estoniya	Estland
David Cameron	David Cameron
Raage	Saturn (Planet)
Chocolate	Schokolade
Dagaalada	Krieg
Kow	Eins
Labo	Zwei
Sadax	Drei
Afar (lambar)	Vier
Shan	Fünf
0	Null
George W. Bush	George W. Bush
Laydi	Rechteck
Latfiya	Lettland
Ukrain	Ukraine
Jamhuuriyadda Tashik	Tschechien
Islofaakiya	Slowakei
Isloveeniya	Slowenien
Moldofa	Moldawien
Romania	Rumänien
Bulgaria	Bulgarien
Roma	Rom
Jamhuriyada Makedonia	Mazedonien
Albania	Albanien
Griinland	Grönland
Kroatia	Kroatien
Bosniya	Bosnien und Herzegowina
Aserbiijaan	Aserbaidschan
Andorra	Andorra
Jasiirada Qabrus	Republik Zypern
Joorjiya	Georgien
Kasakhstan	Kasachstan
Malta	Malta
Monako	Monaco
Montenegro	Montenegro
Faatikan	Vatikanstadt
San Marino	San Marino
Boroksel	Stadt Brüssel
Kuuba	Kuba
Belise	Belize
Barbados	Barbados
Indunisiya	Indonesien
Wolfgang Amadeus Mozart	Wolfgang Amadeus Mozart
Af-Turki	Türkische Sprache
Koonfur Afrika	Südafrika
Aljeeriya	Algerien
Usbekistan	Usbekistan
Biyo	Wasser
Alwaax	Holz
Telefishin	Fernsehen
Claude Monet	Claude Monet
Diego Velázquez	Diego Rodríguez de Silva y Velázquez
Jili	Chile
El Greco	El Greco
Ciise	Jesus Christus
Dusaa	Merkur (Planet)
Taariikh	Geschichte
Apple Inc	Apple
Waxaraxir	Venus (Planet)
Jaceyl	Liebe
Cirjeex	Jupiter (Planet)
Uraano	Uranus (Planet)
Nicolas Sarkozy	Nicolas Sarkozy
Nebtuun	Neptun (Planet)
Xiddigis	Astronomie
Singabuur	Singapur
Saynis	Wissenschaft
Buluuto	Pluto
Liechtenstein	Liechtenstein
Ciyaaraha	Sport
Adolf Hitler	Adolf Hitler
Facebook	Facebook
Julian Assange	Julian Assange
Dagaalkii koowaad	Erster Weltkrieg
Dagaalkii Labaad ee Aduunka	Zweiter Weltkrieg
Goorsheegto	Uhr
Linux	Linux
Xisaab	Mathematik
Af-Laatiin	Latein
Baxrayn	Bahrain
Armania	Armenien
Seerbiya	Serbien
Bil	Mond
Istanbuul	Istanbul
Australia	Australien
Fiisigis	Physik
Arjantiina	Argentinien
Isgaarsiinta	Telekommunikation
Peru	Peru
Bayoloji	Biologie
Waqooyiga Kuuriya	Nordkorea
Kambodiya	Kambodscha
Qur'aan	Koran
Diinsoor (xayawaan)	Dinosaurier
Islaam	Islam
Ljubljana	Ljubljana
World Wide Web	World Wide Web
Naag	Frau
Gabay	Poesie
Chernobyl	Nuklearkatastrophe von Tschernobyl
Milan	Mailand
Torino	Turin
Liin dhanaan	Zitrone
Ubax	Blüte
Magaalo	Stadt
Napoleon Bonaparte	Napoleon Bonaparte
Xidig	Stern
Qorax	Sonne
Cir	Himmel (planetär)
Tuulo	Dorf
Ooshiyaaniya	Ozeanien
Bahda Midaysay Qoraxdu	Sonnensystem
Ilig	Zahn
Hydrogen	Wasserstoff
Hiliyaam	Helium
Cadaab	Hölle
Wikimedia Commons	Wikimedia Commons
Liithiyaam	Lithium
Beriiliyaam	Beryllium
Buug	Buch
Maalin	Tag
Bariga Timor	Osttimor
Sanad	Jahr
Qarni	Jahrhundert
Oslo	Oslo
Lissabon	Lissabon
Dubay	Dubai (Emirat)
Lionel Messi	Lionel Messi
Booron	Bor
Versailles	Versailles
Kaarboon	Kohlenstoff
Nitrojiin	Stickstoff
Ogsajiin	Sauerstoff
FC Internazionale Milano	Inter Mailand
Meere	Planet
Muusig	Musik
Moskow	Moskau
Foloriin	Fluor
Af-Taliyaani	Italienische Sprache
Niyoon	Neon
Saint Petersburg	Sankt Petersburg
Jad	Tschad
Sodhiyaam	Natrium
Woqooyi	Norden
Magniisiyaam	Magnesium
Alumiiniyaam	Aluminium
New Zealand	Neuseeland
Koonfur	Süden
Hindiya	Indien
Silikoon	Silicium
Faransiyaam	Francium
Tuvalu	Tuvalu
Fosforos	Phosphor
Xadiid	Eisen
Galbeed	Westen
Salfar	Schwefel
Bari (Jiho)	Osten
Jasiiradaha Solomon	Salomonen
Koloriin	Chlor
Koofurta Holland	Provinz Südholland
Balau	Palau
Aargon	Argon
Nawru	Nauru
Firefox	Mozilla Firefox
Waqooyiga Holland	Provinz Nordholland
Botashiyaam	Kalium
Zeeland	Provinz Zeeland
Kaalshiyaam	Calcium
Flevoland	Provinz Flevoland
Lead	Blei
Jasiirada Marshall	Marshallinseln
Kiribati	Kiribati
Mongolia	Mongolei
Fiji	Fidschi
Iskaandhiyaam	Scandium
Titaaniyaam	Titan (Element)
Fanansuwela	Venezuela
Jinkis Khan	Dschingis Khan
Fanadhiyaam	Vanadium
Koroomiyaam	Chrom
Faras	Hauspferd
Amistardam	Amsterdam
Hub	Waffe
Xayawaan	Tier
Surinam	Suriname
Manganiis	Mangan
Paraguay	Paraguay
Guyana	Guyana
Fan	Kunst
Ikwadoor	Ecuador
Reheniyaam	Rhenium
Kolombiya	Kolumbien
Kobalti	Cobalt
Tungsten	Wolfram
Nikel	Nickel
Boliifia	Bolivien
Osmiyaam	Osmium
Groningen	Provinz Groningen
Kober	Kupfer
Beer	Pflanzen
Sinki	Zink
Leonardo da Vinci	Leonardo da Vinci
Boqoshaa	Pilze
Jamayka	Jamaika
Friesland	Provinz Friesland
Drenthe	Provinz Drente
Overijssel	Provinz Overijssel
Guatemala	Guatemala
Gelderland	Provinz Gelderland
Utrecht	Provinz Utrecht
Bahamas	Bahamas
Dooro	Haushuhn
Antigua iyo Barbuda	Antigua und Barbuda
Hawaay	Hawaii
Dominika	Dominica
Doofaar	Hausschwein
Haiti	Haiti
El Salfador	El Salvador
Iiraan	Iran
Ciraaq	Irak
Xikmad	Weisheit
Kosta Rika	Costa Rica
Israaiil	Israel
Magaalada Utrecht	Utrecht
Banama	Panama
Yemen	Jemen
Virus	Viren
Urdun	Jordanien
Nikaragua	Nicaragua
Florida	Florida
Qargistan	Kirgisistan
Kuwayt	Kuwait
Laos	Laos
Lubnaan	Libanon
Jasiirada Maldiif	Malediven
Ameerika	Amerika
Lo'	Hausrind
Malaysiya	Malaysia
Burma	Myanmar
Nebal	Nepal
Cumaan	Oman
Bakistaan	Pakistan
Qatar	Katar
Ciyaarta Teeniska	Tennis
Sacuudi Carabiya	Saudi-Arabien
Siri Lanka	Sri Lanka
Suuriya	Syrien
Gaaliyaam	Gallium
Tadsjikistan	Tadschikistan
Pokemon	Pokémon
Taywan	Republik China (Taiwan)
YouTube	YouTube
Jermaaniyaam	Germanium
Tayland	Thailand
Tareen	Zug (Eisenbahn)
Aarsenik	Arsen
Turkmenistan	Turkmenistan
Seleniyaam	Selen
Iridiyaam	Iridium
Imaaraatka Carabta	Vereinigte Arabische Emirate
Boromiin	Brom
Balatiniyaam	Platin
Fiyetnam	Vietnam
Charlie Chaplin	Charlie Chaplin
Koonfur Kuuriya	Südkorea
Kiribtoon	Krypton
Afgaanistan	Afghanistan
Gangnam Style	Gangnam Style
Rubiidhiyaam	Rubidium
Dahab	Gold
Kanaalka Suweys	Sueskanal
Bangladesh	Bangladesch
Maali	Mali
Sokrades	Sokrates
Angola	Angola
Butaan	Bhutan
Twitter	Twitter
Barunay	Brunei
Tansaaniya	Tansania
Meerkuri	Quecksilber
Roald Amundsen	Roald Amundsen
Harry Mulisch	Harry Mulisch
Filibiin	Philippinen
Jamhuuriyadda Bartamaha Afrika	Zentralafrikanische Republik
Cirifka Koonfur	Südpol
Cirifka waqooyi	Nordpol
Isxaaq Newton	Isaac Newton
Albert Einstein	Albert Einstein
Istoroontiyaam	Strontium
Itriyaam	Yttrium
Bismuth	Bismut
Jaale	Gelb
Togo	Togo
Tunisiya	Tunesien
Saambiya	Sambia
Simbaabwi	Simbabwe
Beijing	Peking
Koonfur Suudaan	Südsudan
Benin	Benin
Botswana	Botswana
Burkina Faso	Burkina Faso
Burundi	Burundi
Komoros	Komoren
Jamhuuriyadda Kongo	Republik Kongo
Jamhuuriyada Dimuqaraadiga Kongo	Demokratische Republik Kongo
Jabuuti	Dschibuti
Boloniyaam	Polonium
Ikweetiga Guinea	Äquatorialguinea
Eratareya	Eritrea
New Delhi	Neu-Delhi
Ilmo	Säugling
Astatiin	Astat
Gabon	Gabun
Mahatma Gandhi	Mohandas Karamchand Gandhi
Gambia	Gambia
Guinea	Guinea
Guinea-Bissau	Guinea-Bissau
Xeebta Foolmaroodi	Elfenbeinküste
Kamiruun	Kamerun
Kab Ferde	Kap Verde
Lesotho	Lesotho
Liberia	Liberia
Libiya	Libyen
Madagaskar	Madagaskar
Malaawi	Malawi
Mauritania	Mauretanien
Mauritius	Mauritius
Marooko	Marokko
Musanbiig	Mosambik
Nambiya	Namibia
Nayjar	Niger
Nayjeeriya	Nigeria
Yugandha	Uganda
Ruwanda	Ruanda
Sirkooniyaam	Zirconium
Sao Tome iyo Prinsipe	São Tomé und Príncipe
Sinigaal	Senegal
Seyshelles	Seychellen
Sierra Leone	Sierra Leone
Soomaaliya	Somalia
Niyobiyaam	Niob
Julius Caesar	Gaius Iulius Caesar
Suudaan	Sudan
Swasiland	Swasiland
Qaansa Roobaad	Regenbogen
Molybdenum	Molybdän
Teknetiyaam	Technetium
Qaramada Midoobay	Vereinte Nationen
Juquraafi	Geographie
Wadno	Herz
Maskax	Gehirn
Maqaar	Haut
Midab	Farbe
Rutheniyaam	Ruthenium
Roodhiyaam	Rhodium
Baluug	Blau
Baladiyaam	Palladium
Naxaas	Silber
Kaadmiyaam	Cadmium
Limburg	Provinz Limburg (Niederlande)
Tin (curiye)	Zinn
Antimony	Antimon
Teluriyaam	Tellur
Waqooyiga Brabant	Provinz Nordbrabant
Aaydhiin	Iod
Siinoon	Xenon
Kaasiyaam	Caesium
Baariyaam	Barium
Haafniyaam	Hafnium
Aktiiniyaam	Actinium
Tantalum	Tantal
Bill Clinton	Bill Clinton
Raadhiyaam	Radium
Raadhoon	Radon
Lorraine	Lothringen
Buerto Riko	Puerto Rico
Niedersachsen	Niedersachsen
Lombardia	Lombardei
Qudus	Jerusalem
Rutherfordium	Rutherfordium
Dubniyaam	Dubnium
Siiborgiyaam	Seaborgium
Badweynta Hindiya	Indischer Ozean
Kosofo	Kosovo
Badda Karabiya	Karibisches Meer
Bohriyaam	Bohrium
Hasiyaam	Hassium
Meitneriyaam	Meitnerium
Darmstadtiyaam	Darmstadtium
Roentgeniyaam	Roentgenium
Dortmund	Dortmund
Ununtriyaam	Ununtrium
Lifermoriyaam	Livermorium
Ununoktiyaam	Ununoctium
Maastricht	Maastricht
Jiilaal	Winter
Gu	Frühling
Xagaa	Sommer
Dayr	Herbst
Sadaam Xuseen	Saddam Hussein
Usaama bin Laadin	Osama bin Laden
Caarcaaro	Webspinnen
Miro	Frucht
Lacagta	Geld
Xasharaad	Insekten
Faladimir Lenin	Wladimir Iljitsch Lenin
Uetersen	Uetersen
Augustus Octavian	Augustus
Microsoft Windows	Microsoft Windows
Jibraltaar	Gibraltar
Nokia	Nokia
Baabuur	Automobil
Juventus FC	Juventus Turin
Texas	Texas
Bruno Mars	Bruno Mars
Sasiiliya	Autonome Region Sizilien
Sardiiniya	Sardinien
Fuuqbax	Morbus Crohn
Buenos Aires	Buenos Aires
Tokyo	Präfektur Tokio
Barcelona	Barcelona
Abidjan	Abidjan
Minnesota	Minnesota
Baqdaad	Bagdad
Isuduwaha Waqtiga Caalamiga	Koordinierte Weltzeit
AC Milan	AC Mailand
Buuri	Tabak
Internet Explorer	Internet Explorer
Sigaar	Zigarette
Nayl armistaroong	Neil Armstrong
Maxamed Faarax	Mo Farah
München	München
Fiyena	Wien
Kobanhaygan	Kopenhagen
Stockholm	Stockholm
Helsinki	Helsinki
Dublin	Dublin
Bratislava	Bratislava
Budapest	Budapest
Frankfurt	Frankfurt am Main
Lanthanum	Lanthan
Kitaabka quduska	Bibel
Phnom Penh	Phnom Penh
Ho Chi Minh City	Ho-Chi-Minh-Stadt
Luteetiyaam	Lutetium
Mida Rumeed Kaniisada Ciise	Wahre Jesus-Kirche
Ingiriis (luqad)	Englische Sprache
Bangkok	Bangkok
Dong Hoi	Đồng Hới
Concepción	Concepción (Chile)
Franck Ribéry	Franck Ribéry
Ottawa	Ottawa
Dayaxa Cirjeex	Liste der Jupitermonde
Juba	Juba (Stadt)
Końskowola	Końskowola
Dar es Salaam	Daressalam
Khartuum	Khartum
Dayaxa raage	Liste der Saturnmonde
2000	2000
2003	2003
2002	2002
2001	2001
2012	2012
2011	2011
2010	2010
2009	2009
2013	2013
2014	2014
2008	2008
2004	2004
2005	2005
2006	2006
2007	2007
1900	1900
1901	1901
Charles De Gaulle	Charles de Gaulle
1906	1906
1908	1908
1909	1909
1992	1992
1991	1991
1990	1990
1993	1993
1994	1994
1995	1995
1996	1996
1910	1910
1911	1911
1912	1912
1913	1913
1914	1914
1997	1997
1998	1998
1999	1999
1918	1918
Cunto	Lebensmittel
Mas	Schlangen
Dayaxa docay	Liste der Neptunmonde
Dashiishe	1. Januar
1920	1920
1919	1919
1921	1921
Georges Pompidou	Georges Pompidou
Malmö	Malmö
Birmingham	Birmingham
Microsoft	Microsoft
Borotoon	Proton
Kurów	Kurów
Kimisteri	Chemie
Robin van Persie	Robin van Persie
27	27
1989	1989
1988	1988
1987	1987
1986	1986
1985	1985
1984	1984
1983	1983
1982	1982
1981	1981
1980	1980
Muqdisho	Mogadischu
Sana'a	Sanaa
1970	1970
1971	1971
1972	1972
1973	1973
1974	1974
1975	1975
1976	1976
1977	1977
1978	1978
1979	1979
1969	1969
18 Abriil	18. April
25 Abriil	25. April
26 Abriil	26. April
Dayax	Satellit (Astronomie)
Kristian Wulff	Christian Wulff
15 Meey	15. Mai
SSC Napoli	SSC Neapel
1968	1968
1967	1967
1966	1966
1965	1965
1964	1964
27 Juun	27. Juni
Kubadda Cagta	Fußball
AS Roma	AS Rom
1963	1963
Holokost	Holocaust
1962	1962
Michael Jackson	Michael Jackson
Bogota	Bogotá
29 Diseembar	29. Dezember
Quito	Quito
Adhi	Hausziege
21 Oktoobar	21. Oktober
Paramaribo	Paramaribo
Wiil	Junge
Gabar	Mädchen
Kanbera	Canberra
Sydney	Sydney
Cagaar	Grün
Gaduud	Rot
Perth	Perth
Galbeed Australia (gobol)	Western Australia
New South Wales	New South Wales
Wabiga Niil	Nil
Jini	Dschinn
Wabiga Nijer	Niger (Fluss)
Rabat	Rabat
Algiers	Algier
Tunis	Tunis
Triboli	Tripolis
Rede Globo	Rede Globo
Jabuuti (magaalo)	Dschibuti (Stadt)
Tahraan	Teheran
Addis Abeba	Addis Abeba
Ankara	Ankara
Asmara	Asmara
Nijamiina	N’Djamena
Niamey	Niamey
Nawakshot	Nouakchott
1961	1961
Bamako	Bamako
Belgaraad	Belgrad
Dakar	Dakar
Banjul	Banjul
Konakri	Conakry
Bissau	Bissau
Category:Template	Kategorie:Vorlage:
Monrofia	Monrovia
Braia	Praia
1960	1960
Akara	Accra
Dimishiq	Damaskus
Yamoussoukro	Yamoussoukro
Faransiis Guyana	Französisch-Guayana
Ougadougou	Ouagadougou
Freetown	Freetown
Abuja	Abuja
Lome	Lomé
Borto-Novo	Porto-Novo
Yawunde	Yaoundé
Malabo	Malabo
Librefille	Libreville
Bangui	Bangui
Kinshasa	Kinshasa
Barasafille	Brazzaville
Bujumbura	Bujumbura
Kigali	Kigali
Dodoma	Dodoma
Nayroobi	Nairobi
Lilongwe	Lilongwe
Lusaka	Lusaka
Qorax madoobaad	Sonnenfinsternis
Mabuto	Maputo
Kambaala	Kampala
Luanda	Luanda
Moroni	Moroni (Komoren)
Mabane	Mbabane
Maseru	Maseru
Dugsi	Schule
Antananarifo	Antananarivo
Jaamacad	Universität
Gaborone	Gaborone
Harare	Harare
Pretoria	Pretoria
Bort Lois	Port Louis
Sao Tome	São Tomé
Windhoek	Windhoek
Wikipedia:Bacaadka	Wikipedia:Spielwiese
Fiktoria	Victoria (Seychellen)
Guri	Haus
Kombuyuuterka Dhabta	Notebook
Computer Hardware	Hardware
Aljebra	Algebra
Webiyada	Fluss
Osasko	Osasco
Garoonka ee Dong Hoi	Flughafen Dong Hoi
Curitiba	Curitiba
Pangea	Pangaea
Keyn	Wald
Anne Frank	Anne Frank
Shilin Soomaali	Somalia-Schilling
Confucius	Konfuzius
Category:Taariikhda Ciraaq	Kategorie:Geschichte Iraks
Corbin Bleu	Corbin Bleu
Category:Xisaab	Kategorie:Mathematik
Jasiiradaha Feroe	Färöer
Maxamed Morsi	Mohammed Mursi
Euro	Euro
Bada Dhexe	Mittelmeer
Masiixiyad	Christentum
Windows 8	Microsoft Windows 8
Template:Dalalka Aasiya	Vorlage:Navigationsleiste Staaten in Asien
Bariis	Reis
Céline Dion	Céline Dion
Qaaradaha	Kontinent
Adelaide	Adelaide
Shimbir	Vögel
Bilaha	Monat
Mustafa Kemal Atatürk	Mustafa Kemal Atatürk
1948	1948
Jeejniya	Tschetschenien
1949	1949
Garoosni	Grosny
Huang Xianfan	Huang Xianfan
1956	1956
1941	1941
1945	1945
1958	1958
1926	1926
1947	1947
1944	1944
1952	1952
Bill Gates	Bill Gates
Encyclopedia	Enzyklopädie
DVD	DVD
Bogga Hore	Wikipedia:Hauptseite
CPU	Hauptprozessor
1959	1959
Dhesibel	Dezibel
Kubadda Koleyga	Basketball
Kab town	Kapstadt
Bada Qaswiin	Kaspisches Meer
Harta Fiktooriya	Victoriasee
Harada malaawi	Malawisee
Salvador Dalí	Salvador Dalí
Finsent van Gogh	Vincent van Gogh
Hokusai	Katsushika Hokusai
Mishelangelo	Michelangelo
Bablo bekaso	Pablo Picasso
Rembrandt van Rijn	Rembrandt van Rijn
Eminem	Eminem
Bas	Omnibus
Baabiyloon	Babylon
Katalooniya	Katalonien
Samarqanda	Samarqand
Bukhaara	Buxoro
Mekka	Mekka
Che Guvara	Che Guevara
Mao Zedong	Mao Zedong
Kabul	Kabul
Luqada Tamil-ka	Tamil
Filasoofiyada	Philosophie
50 Cent	50 Cent
Dr. Dre	Dr. Dre
Snoop Dogg	Snoop Dogg
Shaax	Tee
Tupac Shakur	Tupac Shakur
Xidig-dhul	Stacheligel
1507	1507
Shuuciyad	Kommunismus
Amadeyo afogadro	Avogadro-Konstante
Liberalinimo	Liberalismus
Qaran	Nation
Jow Bayden	Joe Biden
Hillary Clinton	Hillary Clinton
Dabaal	Schwimmen
Category:Xiddigis	Kategorie:Astronomie
1542	1542
1543	1543
Jaan Jaak Rosoo	Jean-Jacques Rousseau
Saxaara	Sahara
Hambeegar	Hamburger
Shaydaanka	Teufel
1606	1606
Maktabad	Bibliothek
FC Barcelona	FC Barcelona
Midowga afrika	Afrikanische Union
Siyaasadda,	Politik
Jaamacada Carabta	Arabische Liga
Dimoqraadi	Demokratie
Hay'ada laanqayrta cas	Internationale Rotkreuz- und Rothalbmond-Bewegung
Gaashaanbuurta NATO	NATO
Qin Shi Huang	Qin Shihuangdi
Bariga Dhexe	Mittlerer Osten
Jamhuriyadda	Republik
Hantiwadaag	Sozialismus
Dowlad	Staat
Xisbi	Politische Partei
Kilimanjaaro	Kilimandscharo
Kristoffer Kolombus	Christoph Kolumbus
Rixlaat Ibn Batuuta	Ibn Battuta
Kanaalka Banama	Panamakanal
Dheg	Ohr
San	Nase
Hees	Lied
Kaneeco	Stechmücken
Libaax Badeed	Haie
Geel	Altweltkamele
Naasley	Säugetiere
Quraansho	Ameisen
Shini	Bienen
Software	Software
Af-Holandees	Niederländische Sprache
DNA	Desoxyribonukleinsäure
Nuucyada dhirta	Art (Biologie)
Hooyo	Mutter
Aabe	Vater
Waalid	Elternschaft
Gaadiidka Dadweynaha	Verkehr
Debian	Debian
1669	1669
1670	1670
1671	1671
1672	1672
1673	1673
1674	1674
1675	1675
1676	1676
1677	1677
1678	1678
1679	1679
1680	1680
1856	1856
Af-Ruush	Russische Sprache
Faladimir Putin	Wladimir Wladimirowitsch Putin
Dastuur	Verfassung
Dalalka Kommonwels	Commonwealth of Nations
OPEC	Organisation erdölexportierender Länder
Rooti	Brot
UNESCO	UNESCO
Baaqa Caalamiga ee Xuquuqda Aadanaha	Allgemeine Erklärung der Menschenrechte
1796	1796
1797	1797
1899	1889
Sawaaxili	Swahili (Sprache)
1893	1893
Unug	Zelle (Biologie)
Dhiig	Blut
Qolfoof	Skelett
Sambab	Lunge
Hab Neefsi	Atemtrakt
Af-Romani	Rumänische Sprache
Roob	Regen
Dhulgariir	Erdbeben
Ibn Siinaa	Avicenna
Nelson Mandela	Nelson Mandela
Martin Luther King,	Martin Luther King
Ensiim	Enzym
Borotiin	Protein
Daad	Hochwasser
Tsunami	Tsunami
Fulkaano	Vulkan
Caad	Wolke
Tirignoometeri	Trigonometrie
Joomitiri	Geometrie
Qarnigii 2aad	2. Jahrhundert
Qarnigii 1aad	1. Jahrhundert
Dhaqaale	Wirtschaftswissenschaft
Warshad	Industrie
Farta laatiinka	Lateinisches Alphabet
Suugaan	Literatur
Category:Faransiiska	Kategorie:Frankreich
Category:Muusig	Kategorie:Musik
Kun Habeen Iyo Habeen	Tausendundeine Nacht
Category:Suugaanta	Kategorie:Literatur
Category:Gabayada	Kategorie:Lyrik
Waxbarasho	Bildung
Qoys	Familie
Hugo Chavez	Hugo Chávez
Nin	Mann
Guur	Ehe
Midab Takoor	Rassismus
Adoon	Sklaverei
Dagaal Sokeeye	Bürgerkrieg
Cumar	ʿUmar ibn al-Chattāb
Suldaan Suleymaan kan 1aad	Süleyman I.
Bun	Kaffee
Caano	Milch
Buur	Berg
Salaaxudiin al-Ayyuubi	Saladin
Karaaji	Karatschi
Riyaal Madrid	Real Madrid
Dagaalkii qaboobaa	Kalter Krieg
Seoul	Seoul
Tomas Edison	Thomas Alva Edison
Michael Faraday	Michael Faraday
Internet protocol	Internet Protocol
HTML	Hypertext Markup Language
Af-Iswiidhan	Schwedische Sprache
Muxamed bin Muuse al-Khwarizmī	Al-Chwarizmi
Karl Marx	Karl Marx
Nabi Muuse C.S.	Mose
Aqoon	Wissen
Naas	Weibliche Brust
Atom	Atom
Ileys	Licht
Af Giriig	Griechische Sprache
Operating system	Betriebssystem
Naf	Seele
Af-Faarsi	Persische Sprache
Diin	Religion
Nabi Ibraahiim C.S.	Abraham
Saladh	Salat (Gericht)
Yuhuuda	Judentum
Af-Hebrow	Hebräische Sprache
Ibn Khalduun	Ibn Chaldun
Beer (xubin)	Leber
Bakeyle	Kaninchen
Cilminafsi	Psychologie
Badweyn	Ozean
Gootama buuda	Siddhartha Gautama
Muxamed	Mohammed
BBC	British Broadcasting Corporation
Shahrukh Khan	Shah Rukh Khan
Al-Ghazaali	Al-Ghazālī
Gerald Ford	Gerald Ford
Shiica	Schia
Suufi	Sufismus
Carab	Zunge
Chelsea FC	FC Chelsea
Arsenal F.C.	FC Arsenal
Ganac	Bauchspeicheldrüse
Qoor	Hals
Af	Mund
Sakaar	Brust
Elizabeth II	Elisabeth II.
Caajiska	Unwohlsein und Ermüdung
Schiphol	Flughafen Amsterdam Schiphol
Haarlem	Haarlem
Ronald Reagan	Ronald Reagan
Af-Zulu	IsiZulu
Foosto	Fass
Sabool	Armut
Gordon Brown	Gordon Brown
Jadwalka Curiyayaasha	Periodensystem
Robert Mugabe	Robert Mugabe
Xamaam(Shinbir)	Tauben
Bakteeri	Bakterien
Geed	Baum
Canab	Weintraube
Malab	Honig
Hilib	Fleisch
Barandho	Kartoffel
Sonkor	Zucker
Khudaar	Gemüse
Robot	Roboter
Makiinad	Maschine
Saxaafad	Journalismus
Taleefoon	Telefon
Dhaqan	Kultur
RNA	Ribonukleinsäure
Xidigisyahan	Astronom
Habdhiska Wareega Dhiiga	Blutkreislauf
Mindhicirka weyn	Dickdarm
Mindhicirka yar	Dünndarm
Ibn Haytham	Alhazen
Isku dhis	Chemische Verbindung
Sharci dajinta	Legislative
Windows 7	Microsoft Windows 7
Boqolleey	Prozent
Windows Vista	Microsoft Windows Vista
Fidel Castaro	Fidel Castro
Category:Barasiil	Kategorie:Brasilien
Tamar	Energie
Awood	Kraft
Cufisjiidad	Gravitation
Cuf	Masse (Physik)
Bir	Metalle
Hawo	Gas
Dareere	Flüssigkeit
Adke	Festkörper
Bushkuleeti	Fahrrad
Markab	Schiff
Beeraha	Landwirtschaft
Cudbi	Baumwollfaser
Tiknolajiga nano	Nanotechnologie
Xaansho	Papier
Bac	Kunststoff
Bed	Flächeninhalt
Lambar	Zahl
Kiilogaraam	Kilogramm
Cristiano Ronaldo	Cristiano Ronaldo
Mitir	Meter
Ilbiriqsi	Sekunde
Galley	Mais
Kelvinka	Kelvin
Dalalka	Liste der Staaten der Erde
Ludwik Lejzer Zamenhof	Ludwik Lejzer Zamenhof
Mesobotaamiya	Mesopotamien
Buti	Bären
Britney Spears	Britney Spears
Habdhiska Dheefshiidka	Verdauung
Habka Samayska Cuntada	Photosynthese
Kansar	Krebs (Medizin)
Boqortooyo	König
Qamadi	Weizen
Kalandar	Kalender
Dhagool	Gehörlosigkeit
Cudur	Krankheit
Niikotiin	Nicotin
Malaariyo	Malaria
Cunto xumida	Mangelernährung
Benseliin	Penicilline
Nantes	Nantes
AIDS	AIDS
Sokorow	Diabetes mellitus
Template:Location map Yemen	Vorlage:Positionskarte Jemen
Mona Lisa	Mona Lisa
Horgale (Fiisikis)	Internationales Einheitensystem
Burj Khalifa	Burj Khalifa
Gidaarka Shiinaha	Chinesische Mauer
Abyoone	Ganze Zahl
Kubad	Kugel
Dawlada Cosmaniya	Osmanisches Reich
Koronto	Elektrizität
Seef	Schwert
Pawlo Kuwelho	Paulo Coelho
Stephan El Shaarawy	Stephan El Shaarawy
Liin	Orange (Frucht)
Af-Soomaali	Somali (Sprache)
Aljaziira	Al Jazeera
Hal-xeraale	Geduldsspiel
Carabi	Arabische Sprache
Xorta ah	Freie Inhalte
Baar	Palmengewächse
Dollar	Dollar
Araga	Optik
Calan	Flagge
Qalin Qori	Bleistift
Saabaan	Möbel
Template:Location map Sudan	Vorlage:Positionskarte Sudan
Template:Location map Eritrea	Vorlage:Positionskarte Eritrea
Template:Location map Ethiopia	Vorlage:Positionskarte Äthiopien
Template:Location map Djibouti	Vorlage:Positionskarte Dschibuti
Template:Location map Somalia	Vorlage:Positionskarte Somalia
Template:Location map Nigeria	Vorlage:Positionskarte Nigeria
Template:Location map Uganda	Vorlage:Positionskarte Uganda
Geri	Giraffe
Faruur	Lippe
Shaarbo	Schnurrbart
Midowga Sofiyet	Sowjetunion
Qolofta kore ee Dhulka	Erdkruste
Lil Wayne	Lil Wayne
FC Bayern München	FC Bayern München
Queen	Queen (Band)
Kanye West	Kanye West
Huguri	Kehle
Wikipedia:Maqaallo Xul Ah	Wikipedia:Exzellente Artikel
Maalmaha	Tageslicht
Aduunka	Welt
Wikipedia:Goob	Wikipedia:Projektdiskussion
Nanjing	Nanjing
Mayotte	Mayotte
Goobo	Kreis
Cesc Fàbregas	Cesc Fàbregas
Mobile	Mobiltelefon
Goronyo	Afrikanischer Strauß
Kuuriya	Korea
Manchester	Manchester
1000	1000
999	999
Yeey	Wolf
1955	1955
1954	1954
1953	1953
1951	1951
1950	1950
1946	1946
1943	1943
1942	1942
1940	1940
1939	1939
1938	1938
1937	1937
1936	1936
Manchester United FC	Manchester United
1935	1935
1934	1934
Axdiga Cusub	Neues Testament
Qafqaas	Kaukasien
Sagaal	Neun
Dabaqaroof	Skorpione
Koobka Adduunka	Fußball-Weltmeisterschaft
Boolo	Pelikane
Macdin Alkaliini ah	Alkalimetalle
Macdin dhuleed ah	Erdalkalimetalle
Rafael Correa	Rafael Correa
Transitional Metal	Übergangsmetalle
Bir la Mood	Halbmetalle
Bir Ma Ahe	Nichtmetalle
Guruubka 17	Halogene
Neefta Gobta	Edelgase
5	5
4	4
3	3
2	2
Buqarest	Bukarest
Louvre	Louvre
Motorhead	Motörhead
Dameer	Hausesel
Wikipedia:Maqaal Cusub	Wikipedia:Lesenswerte Artikel
6	6
Axdigii Hore	Altes Testament
Saddax-xagal	Dreieck
Lady Gaga	Lady Gaga
Luqada Hindo Yurub	Indogermanische Sprachen
Breinigerberg	Breinigerberg
Muammar Qadaafi	Muammar al-Gaddafi
Shabeel	Tiger
Francesco Totti	Francesco Totti
PSY	Psy (Sänger)
Nissan	Nissan
Booyad	Tankwagen
Walhade	Pendel
Samsung	Samsung
Skandinafiyen	Skandinavien
Aruba	Aruba
Smartphone	Smartphone
Shidaal	Erdöl
Isuduwe Habka Juqraafiga	Geographische Koordinaten
Banki	Bank
1	1
10	10
20	20
30	30
Abkhazia	Abchasien
40	40
9	9
7	7
8	8
Todoba	Sieben
Sideed	Acht
Todobaad	Woche
Deero	Hirsche
Baraf	Eis
Toon	Knoblauch
Musée d'Orsay	Musée d’Orsay
Anthroboloji	Anthropologie
Badacas	Rotes Meer
13	13
Koonfur Ossetia	Südossetien
Ulan Bator	Ulaanbaatar
51	51
Jasiirad	Insel
Cad	Weiß
Madaw	Schwarz
37	37
900	900
Lordi	Lordi
Basal	Zwiebel
Lix	Sechs
700	700
Yaanyo	Tomate
George H. W. Bush	George H. W. Bush
68	68
89	89
11	11
Quang Binh	Quảng Bình
Entrena	Entrena
Dhulbare	Äquator
NASA	NASA
Benito Mussolini	Benito Mussolini
15	15
14	14
17	17
500	500
150	150
Qaamuus	Wörterbuch
Bermuda	Bermuda
Madax	Kopf
Wellington	Wellington
23	23
800	800
Heesta qaranka	Nationalhymne
42	42
Afarta jiho	Himmelsrichtung
18	18
Nuurad	Kalkstein
19	19
16	16
21	21
26	26
41	41
32	32
33	33
Falastiin	Palästina (Region)
Valletta	Valletta
200	200
38	38
43	43
39	39
24	24
79	79
61	61
104	104
29	29
102	102
100	100
Haramcad	Gepard
Arabsiyo	Arabsiyo
Afarta xilli	Jahreszeit
101	101
105	105
108	108
Dhuxul Dhagax	Kohle
22	22
46	46
25	25
153	153
156	156
31	31
28	28
Liverpool	Liverpool
85	85
88	88
76	76
54	54
60	60
47	47
Guumees	Eulen
Nederlaan Antiilis	Niederländische Antillen
Bahda Bisada	Katzen
Ambeer	Ampere
Isotope	Isotop
Göteborg	Göteborg
Culeys	Gewichtskraft
Geed Timir	Echte Dattelpalme
Burris	Hammer
Racibórz	Racibórz
Odense	Odense
Kobe Bryant	Kobe Bryant
Luqadaha Berberiga	Berbersprachen
600	600
400	400
300	300
Tilburg	Tilburg
Dayax gacmeed	Satellit (Raumfahrt)
Horseed FC	Horseed FC
Taylor Swift	Taylor Swift
Khaalid bin Waliid	Chālid ibn al-Walīd
Bariga Afrika	Ostafrika
Fiat	Fiat (Marke)
Bartamaha Ameerika	Zentralamerika
Af-Cafari	Afar (Sprache)
Magrib	Maghreb
Amxaari	Amharische Sprache
36)	36
Tin	Haar
Wareeg	Umfang
Portal:Af-maal	Portal:Sprache
Dhicis	Fehlgeburt
Dhar	Textilie
Kacdoonka masar	Revolution in Ägypten 2011
Willis Tower	Willis Tower
Kacbada	Al-Kaʿba
Beatriks	Beatrix (Niederlande)
Isuzu	Isuzu
Dublad	Trichter
159	159
107	107
103	103
152	152
240	240
197	197
70	70
Duqa	Bürgermeister
81	81
69	69
87	87
65	65
66	66
67	67
55	55
34	34
44	44
35	35
64	64
151	151
155	155
50	50
260	260
45	45
49	49
230	230
Zhengzhou	Zhengzhou
154	154
52	52
82	82
84	84
73	73
72	72
62	62
71	71
75	75
74	74
83	83
78	78
77	77
90	90
80	80
91	91
190	190
109	109
53	53
270	270
63	63
86	86
401	401
99	99
98	98
110	110
137	137
138	138
140	140
130	130
210	210
220	220
Dell	Dell
180	180
158	158
157	157
106)	106
48	48
97	97
Yuumbi	Speerfische
56	56
93	93
Alofi	Alofi (Niue)
57	57
Jamestown	Jamestown (St. Helena)
170	170
171	171
172	172
58	58
59	59
139	139
134	134
135	135
96)	96
92	92
133	133
176	176
131	131
Fowdo	Anarchie
Jasiirad Dhuleedka Carabta	Arabische Halbinsel
250	250
280	280
290	290
Mindi	Messer
Masaajid	Moschee
Akon	Akon
Dumnad	Domino
174	174
International Standard Book Number	Internationale Standardbuchnummer
132	132
178	178
Luqadaha Tashaadiga	Tschadische Sprachen
Drake	Drake (Rapper)
Luqadaha Kushiitiga	Kuschitische Sprachen
Afguri	Dialekt
95	95
94	94
257	257
Biriq	Blitz
Gacan	Hand
Luqadaha Omotik	Omotische Sprachen
Af-Oromo	Oromo (Sprache)
Caleen	Blatt (Pflanze)
Jilaa	Schauspieler
Niue	Niue
Luqadaha Semitiga	Semitische Sprachen
Justin Bieber	Justin Bieber
Xusni Mubaarak	Husni Mubarak
Af-Tigrinya	Tigrinya (Sprache)
Af-Tigre	Tigre (Sprache)
Dhululubo	Zylinder (Geometrie)
Subag	Butter
Yaasir Carafaat	Jassir Arafat
Fara-ka hadal	Gebärdensprache
136	136
Injiil	Evangelium (Buch)
Alexander Graham Bell	Alexander Graham Bell
Tasmaniya	Tasmanien
Rotterdam	Rotterdam
Saabuun	Seife
Cabdillahi ibn Cabdi al Mudalib	ʿAbd Allāh ibn ʿAbd al-Muttalib
Mošovce	Mošovce
Shakira	Shakira
Jaamacadda Oxford	University of Oxford
Maxamuud Axmadinajaad	Mahmud Ahmadinedschad
CD	Compact Disc
Al-Qaacida	Al-Qaida
Maxamed Al-faatex	Mehmed II.
Jeer	Flusspferd
Furaat	Euphrat
Gacanka Faarsiga	Persischer Golf
Cilmiga bulshada	Sozialwissenschaften
Somaliland	Somaliland
Ciida sanadka cusub	Neujahr
Babaay	Papaya
Brisbane	Brisbane
Fiitamiin	Vitamin
Towraad	Tora
Koonfur Joorjiya iyo Koonfurta Jasiiradaha Sanwij	Südgeorgien und die Südlichen Sandwichinseln
Maahmaah	Sprichwort
Noemi	Noemi (Sängerin)
Website	Website
Ido	Ido (Sprache)
Sumeer	Sumer
Kolonbo	Colombo
Dariishad	Fenster
Medina	Medina
Akkadiyaan	Akkadische Sprache
Booliis	Polizei
UEFA	UEFA
Tigris	Tigris
Koonfur Australia (gobol)	South Australia
Baarlamaan	Parlament
Maatar	Materie (Physik)
Jaamacadda Cambridge	University of Cambridge
Fulinta (Dawlad)	Exekutive
Hurdo	Schlaf
Neefta	Asthma bronchiale
Doon	Boot
Queensland	Queensland
Mohammed ali Clay,	Muhammad Ali
Beyoncé Knowles	Beyoncé Knowles
Urur	Menge (Mathematik)
Siligo	Siligo
Af-Maay	Maay
Riyo	Traum
Bur	Mehl
Dhigaha	Geographische Länge
Kimikal dibusocod	Chemische Reaktion
Den Haag	Den Haag
Goriila	Gorillas
Daylight saving time	Sommerzeit
Daanta galbeed	Westjordanland
Maraykanka assalkoodii	Indianer
Siinaa	Sinai-Halbinsel
Albaab	Tür
Rihanna	Rihanna
Hargab Doofaar	Schweineinfluenza
Cinjo	Nagel (Anatomie)
Ugaadhsi	Jagd
Toshiro Mifune	Toshirō Mifune
Waji	Gesicht
Aleksander Fileming	Alexander Fleming
Musmaar	Nagel
Nabi Suleymaan C.S.	Salomo
Yahoo	Yahoo
AK-47	AK-47
Mowjad	Welle
Dhexroor	Durchmesser
Bare	Lehrer
Internet Movie Database	Internet Movie Database
Dalai Lama	Dalai Lama
Jilib (xubin)	Kniegelenk
ISO 4217	ISO 4217
Tomas hobis	Thomas Hobbes
Campora San Giovanni	Campora San Giovanni
Jirjiroole	Chamäleons
Cusmaan bin Cafaan	ʿUthmān ibn ʿAffān
Jaandi	Legierung
Nafto	Dieselkraftstoff
Qare	Wassermelone
Toban iyo shan	Fünfzehn
Rikter Cabir	Richterskala
Xamaas	Hamas
Ruhollah Khomeini	Ruhollah Chomeini
Rajab Dayib Erdogaan	Recep Tayyip Erdoğan
Mug	Volumen
Jamaal Cabdinaasir	Gamal Abdel Nasser
Bluetooth	Bluetooth
Cali	ʿAlī ibn Abī Tālib
Marinka Gaza	Gazastreifen
Radio Studio 54 Network	Radio Studio 54 Network
Cabitaan	Getränk
Qoori	Strand
Qabaal	Ellipse
Hobart	Hobart
Dayax Gacmeed	Raumschiff
Doorashada	Wahl
Iskudhufasho	Multiplikation
Saxaraha Galbeed	Demokratische Arabische Republik Sahara
.et	.et
Geeska Afrika	Horn von Afrika
Lisa Gerrard	Lisa Gerrard
Nabi Yaxye C.S.	Johannes der Täufer
Jennifer Lopez	Jennifer Lopez
Faraq	Subtraktion
Breda (Netherlands)	Breda
Shuban	Durchfall
Nancy	Nancy
Honiara	Honiara
PH	PH-Wert
Asiyriya	Assyrien
Qardhaas	Raute
Xayla Siilaasi	Haile Selassie
Xalab	Aleppo
Big Ben	Big Ben
Dhererka Mowjadda	Wellenlänge
Nabi Daa'uud C.S.	David (Israel)
Borussia Dortmund	Borussia Dortmund
Xidido	Wurzel (Pflanze)
Mole	Mol
Frank Lampard	Frank Lampard
Qallal	Epilepsie
Baqal	Maultier
Garaam	Gramm
Shahaadah	Schahāda
Gacanka Cadmeed	Golf von Aden
Beeraha laalaada	Hängende Gärten der Semiramis
Maas	Maas
Khadiija binti Khuweylad	Chadīdscha bint Chuwailid
Waraabe	Hyänen
Sariir	Bett
Madaxwayne kuxigeen	Vizepräsident
Cilmibaadhis	Forschung
Faaranhaayt	Grad Fahrenheit
Dhuldaaqsiin	Savanne
Dhogor	Wolle
Toobin	Kegel (Geometrie)
Daliban	Taliban
MP3	MP3
Ismaamulka Falastiin	Palästinensische Autonomiebehörde
.ke	.ke
Fernando Torres	Fernando Torres
Gar	Barthaar
Nabi	Prophetie
Derbi	Mauer
SMS	Short Message Service
Yaxaas	Echte Krokodile
Majladda Time	Time
Dhedig	Weibliches Geschlecht
Farabadne	Hundertfüßer
Amedeo Avogadro	Amedeo Avogadro
Shambay	Wildkatze
Federaalka	Bundesstaat (Föderaler Staat)
Sedex Geesoodka Bermuda	Bermudadreieck
Arjen Robben	Arjen Robben
Xamid Karzai	Hamid Karzai
Lab	Männliches Geschlecht
Rey mysterio	Rey Mysterio
Dayax madoobaad	Mondfinsternis
Taxane	Matrix (Mathematik)
Kayene	Cayenne
John Cena	John Cena
Waran	Speer
Dadqalato	Kannibalismus
Busbus	Windpocken
Provinces of Argentina	Liste der Provinzen Argentiniens
Dekad	Hafen
Garoonka Diyaaradaha ee Bole	Flughafen Addis Abeba
Dadka Berberiga	Berber
Afganbi	Putsch
Burcad Badeed	Piraterie
RSS	RSS
Lacagta Meherka	Mitgift
Barbaroole	Parallelogramm
Leeb	Pfeil (Geschoss)
Chris Paul	Chris Paul
Awood Socota	Kinetische Energie
Koor	Trapez (Geometrie)
Qaanso	Bogen (Waffe)
Amiibada	Amoeba (Gattung)
Zlatan Ibrahimović	Zlatan Ibrahimović
GSM	Global System for Mobile Communications
Dhaban	Wange
Saint-Denis	Saint-Denis (Réunion)
Arsène Wenger	Arsène Wenger
Baabiylooniya	Babylonien
Muslim	Muslim
Warqadda aqoonsiga	Personalausweis
Template:Commonscat	Vorlage:Commonscat
Qoorgooye	Meningitis
399	399
Iidi Amiin Daada	Idi Amin
Kayseri	Kayseri
CNN	CNN
Drogbaa	Didier Drogba
Dhakhaatiirta Bilaaxuduudaa	Ärzte ohne Grenzen
Abwaan	Poet
Manchester city	Manchester City
Ilaahay	Troms
John Dramani Mahama	John Dramani Mahama
Luqada Masaarida	Ägyptische Sprache
Nabi Ciise	Isa ibn Maryam
Cudurka Ebola	Ebolafieber
Template:Taxobox	Vorlage:Taxobox
Carly Rae Jepsen	Carly Rae Jepsen
Toyota	Toyota
Osmose	Osmose
Af-Hawsa	Hausa (Sprache)
Saxan	Teller
Mwai Kibaki	Mwai Kibaki
Jalaal Daalabaani	Dschalal Talabani
Ismaaciil Cumar Geelle	Ismail Omar Guelleh
Nuur Al-Maliki	Nuri al-Maliki
Dileita Maxamed Dileita	Dileita Mohamed Dileita
Mark Rutte	Mark Rutte
Cumar Cabdirashiid Cali Sharmaarke	Omar Abdirashid Ali Sharmarke
Axmed Dafutoglu	Ahmet Davutoğlu
Robinho	Robinho
Bada Carbeed	Arabisches Meer
Dhircun	Pflanzenfresser
Calanka Denmark	Flagge Dänemarks
Jay-Z	Jay Z
Yuusuf Alqardaawi	Yusuf al-Qaradawi
Sahel	Sahelzone
Henry Kissinger	Henry Kissinger
Abu Hurayra	Abū Huraira
Flums	Flums
Nabi Aadam C.S.	Adam
Diego Milito	Diego Milito
Habaryar	Tante
Abti	Onkel
Shumac	Kerze
Wikipedia:Sharaxaada Maqaalada Xulka Ah	Wikipedia:Kandidaturen von Artikeln, Listen und Portalen
Wikipedia:Sharaxaada Maqaalada Cusub	Wikipedia:Kandidaten für lesenswerte Artikel
Dhalo	Flasche
Raqay	Tamarindenbaum
Shabeelada Tamil	Liberation Tigers of Tamil Eelam
Qaangaadh	Erwachsener
Enjerneer	Ingenieur
Gacanka Caqaba	Golf von Akaba
KwaZulu-Natal Province	KwaZulu-Natal
Hilibcun	Fleischfresser
AFC Ajax	Ajax Amsterdam
VOIP	IP-Telefonie
Jibriil	Gabriel (Erzengel)
Astaamayn	Interpunktion
Taksi	Taxi
Soqotra	Sokotra (Insel)
Timor	Timor
Almere	Almere
Xoor-dubbur	Skunks
Dooli	Hausmaus
Suul	Daumen
Mesut ozil	Mesut Özil
Turki	Türken
Ukun	Hühnerei
HyperText	Hypertext
Xeeb	Küste
Ibb	Ibb (Jemen)
Lobamba	Lobamba
Walxaha	Periode des Periodensystems
Magarete2	Margrethe II. (Dänemark)
Calanka jabuuti	Flagge Dschibutis
Xareed	Süßwasser
Calanka Suudaan	Flagge des Sudan
Daanyeer	Menschenartige
Sodium Hydroxide	Natriumhydroxid
Xoolo	Vieh
Cirid	Zahnfleisch
Chalcogen	Chalkogene
Tufaax	Äpfel
Biniktojiin	Stickstoffgruppe
Lambedusa	Lampedusa
Manuel Neuer	Manuel Neuer
Jalmad	Pfeifkessel
Eris	Eris
Wiz Khalifa	Wiz Khalifa
Agool	Hautschuppe
Barfasoor	Professur
Massari	Massari (Sänger)
Maydhax	Xylem
Dhax kujir	Binnenstaat
Andalus	Al-Andalus
Sako	Zakāt
Dhadhan	Gustatorische Wahrnehmung
ICAO	International Civil Aviation Organization
.so	.so
Western Cape Province	Westkap
Mario Balotelli	Mario Balotelli
Qiiq	Rauch
Eastern Cape Province	Ostkap
Cerebellum	Kleinhirn
Haaruun Alrashiid	Hārūn ar-Raschīd
Kaftan	Witz
Funaanad	T-Shirt
Tangent	Tangente
Niisaabuur	Nischapur
Khilaafada Islaamka	Kalifat
Cadan	Aden
Het Wilhelmus	Het Wilhelmus
Universidade Federal de Minas Gerais	Universidade Federal de Minas Gerais
Mpumalanga Province	Mpumalanga
Northern Cape Province	Nordkap (Provinz)
Mamawdsaw	Mamoudzou
Gauteng Province	Gauteng
Cagaarshow	Ikterus
Du gamla, Du fria	Du gamla, Du fria
Shaydaanimo	Satanismus
Limpopo Province	Limpopo (Provinz)
LG	LG Group
Ogaden	Ogaden
Alexandre Pato	Alexandre Pato
Wabiga Jubba	Juba (Fluss)
Qooleey	Brieftaube
Wabiga Shabeelle	Shabelle
Masago	Lodde
Marsho	Zahnrad
Zain Bikha	Zain Bhikha
Saynab bint Khuzayma	Zainab bint Chuzaima
Saynab bint Jahsh	Zainab bint Dschahsch
Nabi Yuusuf	Josef (Sohn Jakobs)
One Direction	One Direction
Mille	Lösungsmittel
Ajay Devgan	Ajay Devgan
Herpesviruses	Herpesviridae
Degmo	Distrikt
Tomahok (gantaal)	BGM-109 Tomahawk
Dambas	Asche
Eduard Douwes Dekker	Multatuli
Yuusuf Islaam	Cat Stevens
Kiyaawe	Schraubenschlüssel
Awood Kaydsan	Potentielle Energie
Chris Brown	Chris Brown (Sänger)
Universidade Estadual de Feira de Santana	Universidade Estadual de Feira de Santana
Aadan Cabdulle Cusmaan	Aden Abdullah Osman Daar
Saylac	Zeila
Anopheles	Anopheles
Malawad	Mastdarm
Universidade Federal da Bahia	Universidade Federal da Bahia
Centro Federal de Educação Tecnológica de Minas Gerais	Centro Federal de Educação Tecnológica de Minas Gerais
Calanka Soomaaliya	Flagge Somalias
Dhuuso	Flatulenz
Free State Province	Freistaat (Provinz)
Maqal	Auditive Wahrnehmung
Oorfane	Waisenhaus
Ubuc	Rumpf (Anatomie)
Meles Zenawi	Meles Zenawi
Nicki Minaj	Nicki Minaj
Wahaabi	Wahhabiten
Diffusion	Diffusion
DDT	Dichlordiphenyltrichlorethan
Cadnaan Oktaar	Harun Yahya
Dheddin	Commiphora myrrha
Ibrahim Affelay	Ibrahim Afellay
Angry Birds	Angry Birds
Daango	Popcorn
Qalin	Schreibstift
Aadaan	Adhān
Usher	Usher
Hummaag noqod	Reflexion (Physik)
North West Province	Nordwest (Südafrika)
Lelystad	Lelystad
Shax	Shax
Midabada Asaasiga	Grundfarbe
Isnidaamis	Krätze
Daaf	Konjunktivitis
Abkow	Großeltern
CAF	Confédération Africaine de Football
Hargeysa	Hargeysa
Nabiyada Islaamka	Propheten des Islam
Xijaas	Hedschas
Filibs	Philips
Kaliber	Kaliber
Geed Hindi	Niembaum
Jidh	Körper (Biologie)
Qosol	Lachen
Nektar	Nektar (Botanik)
Mount kenya	Mount-Kenya-Massiv
Uunsi	Weihrauch
Jomo Kenyatta	Jomo Kenyatta
Gacan (Joomitiri)	Radius
Centimetre	Zentimeter
Millimeter	Millimeter
Baadiye	Ländlicher Raum
Fasuul Cabdalla Maxamed	Fazul Abdullah Muhammad
Portal:Taariikh	Portal:Geschichte
Hunguriga neefta	Luftröhre
Bowdo	Oberschenkelknochen
Baarlamaanka Federaalka Soomaaliya	Bundesparlament (Somalia)
Qaamo-qashiir	Mumps
Huulaaku Khan	Hülegü
Wadan soo kobcooyo	Entwicklungsland
Dhuxul	Holzkohle
Shansho	Schienbein
Saac (faah faahin)	Armbanduhr
Soon	Saum (Islam)
Alchemist(Buug)	Der Alchimist
The Notorious B.I.G.	The Notorious B.I.G.
Sanab	Statue
Saadiyom bicarbonate	Natriumhydrogencarbonat
Nabi Ayuub C.S.	Ijob
Fatima bint Muxamed	Fatima bint Mohammed
Baras	Vitiligo
Sumad xisaabed	Liste mathematischer Symbole
Daan	Kiefer (Anatomie)
Ricir	Wirbel (Anatomie)
Qol	Zimmer
Dhado	Luftfeuchtigkeit
Curiye	Element
Mucaawiye bin Abii Sufyaan	Muʿāwiya I.
Xasan Nasrallaah	Hassan Nasrallah
Mahathir Bin Maxamed	Mahathir bin Mohamad
Bidaar	Glatze
Aafda tahriibka	Menschenhandel
KLM	KLM Royal Dutch Airlines
Johan Rudolph Thorbecke	Johan Rudolf Thorbecke
Gabareey-maanyo	Meerjungfrau
Mitsubishi	Mitsubishi
Cashuura	Aschura
Tamaashiir	Kreide (Gestein)
Memory card	Speicherkarte
Daxal	Rost
Will.i.am	Will.i.am
Saxaro	Mist
Gaamur	Teer
UFC	Ultimate Fighting Championship
Pitbull	Pitbull (Rapper)
Aayad	Āya
Tariikhda Shiikh Axmed Yaasiin	Ahmad Yasin
Saxaabi	Sahāba
Gows	Molar (Zahn)
Shanbal	Becken (Musikinstrument)
Harar	Harar
Dhismaha websiteka	Webdesign
Golcas	Gazellen
Abuu Xaniifa	Abū Hanīfa
Ammonium	Ammonium
Session Initiation Protocol	Session Initiation Protocol
Salafiya	Salafismus
Berbera	Berbera
Botka internetka	Bot
Bergen op Zoom	Bergen op Zoom
Mengista Xayle Maryam	Mengistu Haile Mariam
Mowliidka Nebiga	Maulid an-Nabī
Ciraaqi Diinaar	Irakischer Dinar
Adenoviridae	Adenoviridae
Daniel arap Moi	Daniel arap Moi
Nabi Huud	Hud (Prophet)
Ne-Yo	Ne-Yo
Sin	Hüftgelenk
Rajab	Radschab
Axmed Binu Xambal	Aḥmad ibn Ḥanbal
Jirid	Trunk
Sheybaar	Mikroskop
Peso (Arjantiina)	Argentinischer Peso
Yamanta Koonfureed	Volksdemokratische Republik Jemen
Assur	Aššur (Stadt)
Decimetre	Dezimeter
Sean paul	Sean Paul
Yazidi (yasiidi)	Jesiden
Calanka somaliland	Flagge Somalilands
Soomaali Galbeed	Somali (Region)
Shilin Kiinyaati	Kenia-Schilling
Astaannta Qaranka ee Soomaaliya	Wappen Somalias
Astaannta Qaranka ee Imaaraatka	Wappen der Vereinigten Arabischen Emirate
Velupillai Prabhakaran	Velupillai Prabhakaran
Federaaliisim	Föderalismus
Nabi Alyasac C.S.	Elischa (Prophet)
Birr	Äthiopischer Birr
Jaad	Kathstrauch
Cows	Rasen
S-block	S-Block
Dab Damis	Feuerwehrfahrzeug
SliTaz	SliTaz
Kung fu	Kung Fu
Maxamed Siyaad Barre	Siad Barre
Salo	Salo
Ívi Adámou	Ivi Adamou
Cafar	Afar (Volk)
Saliid Macsaro	Sesamöl
Cumar Mukhtaar	Umar al-Muchtar
Flo Rida	Flo Rida
Eden Hazard	Eden Hazard
T.I.	T.I.
Budhcad badeeda geeska afrika	Piraterie vor der Küste Somalias
Ayaan Xirsi Cali	Ayaan Hirsi Ali
P-block	P-Block
F-block	F-Block
Cabdullaahi Yuusuf Axmed	Abdullahi Yusuf Ahmed
Ururka Dawladaha aan la aqoonsan Wali	Organisation der nicht-repräsentierten Nationen und Völker
Qof	Person
Darawal	Chauffeur
Addimo-yaqaan	Orthopädie
Dhul (dhulka lagu socdo)	Fußboden
Faysal Bin Cabdil Caziiz	Faisal ibn Abd al-Aziz
Wadar	Summe
Qormo saynis	Wissenschaftliche Notation
C.H	BC
Adam Levine	Adam Levine
Al-Faatixa	Al-Fātiha
Al-Baqara	Al-Baqara
Hogaamiye Kooxeed	Kriegsherr
T-pain	T-Pain
Anggun	Anggun
Carlos the Jackal	Ilich Ramírez Sánchez
Fatima	Fatima
Mombaaso	Mombasa
Alexa Internet	Alexa Internet
Sheekh Xasan Albanaa	Hasan al-Bannā
Daariq ibn Ziyaad	Tariq ibn Ziyad
Seed	Sehne (Anatomie)
Al-Ikhlas	Al-Ichlās
Suurad	Sure
Xadiis	Hadith
Sunna	Sunna
Allaah	Allah
Salaad	Salāt
Xaj	Haddsch
Malag	Engel
Astaannta Qaranka ee Kolombiya	Wappen Kolumbiens
Xisbiga shacabka iyo xoriyada Holalnd	Volkspartij voor Vrijheid en Democratie
Qeshm	Qeschm
Bukhaari	Al-Buchārī
Dadka Soomaaliyeed	Somali (Ethnie)
Haumea	Haumea
Dagaalkii sokeeye ee Soomaaliya	Somalischer Bürgerkrieg
Jason Derulo	Jason Derulo
Macrakadii Ceyn Jaaluut	Schlacht bei Ain Djalut
Iskugeyn	Plus
Akkad	Akkad (Begriffsklärung)
FIFA	FIFA
Uumi	Dampf
Iman model	Iman Abdulmajid
Amina bint Wahb	Āmina bint Wahb
Maryama al-Qibtiyya	Maria al-Qibtiyya
Xafsa bint Cumar	Hafsa bint Umar
Laf	Knochen
Wayne Rooney	Wayne Rooney
Al Hudaydah	Al-Hudaida
Sucuud Alshureym	Saud asch-Schuraim
Sheekh Shariif Axmed	Sharif Sheikh Ahmed
Kismaayo	Kismaayo
Beydaan	Katappenbaum
R. Kelly	R. Kelly
Fool	Schneidezahn
Lacey Duvalle	Lacey Duvalle
Jaamacada Ummada Soomaaliyeed	Nationale Universität Somalias
Geed Walaayo	Jerusalemsdorn
Saaxil	Saaxil
Dhul Udug	Punt (Goldland)
Bakool	Bakool
Nabi Yacquub C.S.	Jakob (Patriarch)
Mariana Ximenes	Mariana Ximenes
Zubeyr bin Cawaam R.C	Az-Zubair ibn al-ʿAuwām
Imaam Nawawi	An-Nawawī
Imaamu Shaafici	Asch-Schāfiʿī
Demba Ba	Demba Ba
Xasan Guuleed Abtidoon	Hassan Gouled Aptidon
K'naan	K’naan
Greyson Chance	Greyson Chance
Cabdiraxmaan Axmed Cali Tuur	Abd-ar-Rahman Ahmad Ali Tur
Cabdul-Qadir Jilani	ʿAbd al-Qādir al-Dschīlānī
Cabdi Bile Cabdi	Abdi Bile
Cabdiqaasim Salaad Xassan	Abdikassim Salat Hassan
Cabdirashiid Cali Sharma'arke	Abdirashid Ali Shermarke
Al-Shabaab	Al-Shabaab (Miliz)
Booc	Calotropis
Al Mahwit	Al-Mahwit
Al Mukalla	Al-Mukalla
Sheekh Yaasir Al-Xabiib	Yasser al-Habib
Imaam Maalik	Mālik ibn Anas
Cody Simpson	Cody Simpson
Cabdullaahi Ciise	Abdullahi Issa
Sh. Cabduraxmaan Alsudeys	Abdurrahman ibn Abdulaziz as-Sudais
Madfac	Granate
Dagaalkii xoraynta ogaden	Ogadenkrieg
Oromo	Oromo (Ethnie)
Ibn Nafiis	Ibn an-Nafīs
Xasan Sheekh Maxamuud	Hassan Sheikh Mohamud
Rodolfo Graziani	Rodolfo Graziani
Maxamed Faarax Caydiid	Mohammed Farah Aidid
Biyo baxa deg dega ah	Vorzeitiger Samenerguss
Dhulka Talyaaniga ee Soomaaliya	Italienisch-Somaliland
Saytuun	Guaven
Trey songz	Trey Songz
Macawiis	Sarong
Nuuraddin Faarax	Nuruddin Farah
Compaq	Compaq
Nabi Saalax	Salih
Unimog	Unimog
Lufthansa Duulimaadkii 181	Entführung des Flugzeugs Landshut
Nabi Idriis	Idris (Koran)
Gob	Indische Jujube
Tooreey	Klinge
Boosaaso	Boosaaso
Dowladda federaalka kumeelgaarka	Übergangsregierung Somalias
Axmed Deedat	Ahmed Deedat
Nabi Dulkifli	Dhu l-Kifl
Abu Bakr	Abū Bakr
Abuu Sufyaan	Abū Sufyān ibn Harb
Imaam Axmed Guray	Ahmad ibn Ibrahim al-Ghazi
Caabudwaaq	Abudwak
IHH	İnsan Hak ve Hürriyetleri ve İnsani Yardım Vakfı
Dun	Thread
Cadale	Adale
Daahir Rayaale Kaahin	Dahir Riyale Kahin
Timo Soini	Timo Soini
Cali maxamed Geedi	Ali Mohammed Ghedi
Iskuqaybin	Divide
Marek Grechuta	Marek Grechuta
Jeddah	Dschidda
Shukaansi	Balz
Sacad bin Abii Waqaas	Saʿd ibn Abī Waqqās
Axmed Maxamed Maxamuud (Siilaanyo)	Ahmed Mohammed Mahamoud Silanyo
Nabi Haaruun C.S.	Hārūn
Afdhere Jama	Afdhere Jama
Afgooye	Afgooye
Afmadow	Afmadow
Xulka Qaranka Soomaaliya	Somalische Fußballnationalmannschaft
Woqooyi bari	North-Eastern (Kenia)
Cabdullaahi bin Cabbaas	ʿAbdallāh ibn ʿAbbās
Masjid al-Aqsa	Al-Aqsa-Moschee
Dadka Tigriga	Tigray (Volk)
Computer Engineering	Technische Informatik
Masjid al-Xaram	Al-Haram-Moschee (Mekka)
Caluula	Aluula
Nuur Xasan Xuseen	Nur Hassan Hussein
Astaanta Calanka Soomaaliya	Somaliyaay toosoo
Pitty	Pitty
Amxaaro	Amharen
Rayhana bint Zayd	Raihana
Ta'izz	Taizz
Maryan Mursal	Maryam Mursal
Xaliimo Khaliif Cumar Magool	Magool
Murgacasho	Verstauchung
Calooleey	Kutteln
Nabi Ismaaciil C.S.	Ismail (Prophet)
Maxamed Xaaji Ibraahim Cigaal	Mohammed Haji Ibrahim Egal
Aamina	Amina (Begriffsklärung)
Dibi	Ochse
Paramore	Paramore
Tuur	Kyphose
Lafdhabar	Wirbelsäule
Luís Carlos Almeida da Cunha	Nani
Paris Saint-Germain FC	Paris SG
Ahlu sunno waljamaaca	Sunniten
Puntland	Puntland
Qureysh	Quraisch
Masjidka Nabiga	Prophetenmoschee
Dagaalkii uxud	Schlacht von Uhud
Sambuus	Samosa
Imaam Mujtahid Sheykhul-Islaam	Ibn Taimīya
Bilaal ibn Ribaax	Bilāl ibn Rabāh
Fiat 124	Fiat 124
Busteejo	Busbahnhof
IGAD	Intergovernmental Authority on Development
Astaanta Calanka Jabuuti	Nationalhymne Dschibutis
Baydhabo	Baidoa
G-Spot	Gräfenberg-Zone
Kulmiye	Kulmiye
Xiriirka Soomaaliyeed ee Kubadda Cagta	Somali Football Federation
Naxariis iyo Nabadgelyo Korkiisa Ha Ahaato	Eulogie (Islam)
Sayid Maxamed Cabdulle Xassan	Mohammed Abdullah Hassan
Salmaan Alfaarisi	Salman der Perser
Maxamed Cabdulaahi Maxamed	Mohamed Abdullahi Mohamed
Sheekh Maxamed Naasiruddiin Al-Albaani	Muhammad Nāsir ad-Dīn al-Albānī
Salaada Magrib	Salat al-Maghrib
Xasan Abshir Faarax	Hassan Abshir Farah
Bayt al-Faqih	Bayt al-Faqīh
Baskin-Robbins	Baskin-Robbins
Haparanda	Haparanda
Xarardheere	Harardheere
Galinsoor	Galinsoor
Baraawe	Baraawe
Xisbiga Hantiwadaagga Kacaanka Soomaaliyeed	Somalische Revolutionäre Sozialistische Partei
Oday	Old Man
Aakhiro	Leben nach dem Tod
Dhuusamareeb	Dhuusamarreeb
Karkaar	Karkaar
Jowhar	Jowhar
Shimbiris	Shimbiris
Marka	Merka
Biciid	Oryxantilopen
Hiiraan	Hiiraan
Astaannta Qaranka ee somaliland	Siegel Somalilands
Dhulka Biritishka ee Soomaaliya	Britisch-Somaliland
Wax soo saar	Produktion (Begriffsklärung)
Nabi Isxaaq C.S.	Isaak (Erzvater)
Soomaaliweyn	Groß-Somalia
Zamenhof	Zamenhof
Xidid	Gefäß
Shabeellaha Dhexe	Shabeellaha Dhexe
Cabdi Faarax Shirdoon	Abdi Farah Shirdon
Hanti maguurto	Immobilie
Salaada Subax	Salat al-Fajr
Maktabadda Dadweynaha ee Minneapolis	Minneapolis Public Library
Naaso hablood	Naasa Hablood
Jalalaqsi	Jalalaqsi
Carta	Arta (Dschibuti)
Godol	Laktation
Mr. Lordi	Mr. Lordi
Bari (Gobol)	Bari (Somalia)
Wajeer	Wajir
Cali Mahdi Maxamed	Ali Mahdi Mohammed
Cismaan Jaamac Cali	Osman Jama Ali
Midowga Maxkamadaha Islaamiga	Union islamischer Gerichte
Somaliland shilling	Somaliland-Schilling
Taleefoonada fiilada	Festnetz
UNICEF	UNICEF
Behra	Beira (Antilope)
Godeey	Gode (Äthiopien)
Abuu Cubeydah Caamir ibn Jaraax	Abū ʿUbaida ibn al-Dscharrāh
Sanaag	Sanaag
Jigjiga	Jijiga
Salaada Casir	Asr (Gebet)
Centro Federal de Educação Tecnológica Celso Suckow da Fonseca	Centro Federal de Educação Tecnológica Celso Suckow da Fonseca
Salaada Cishe	Salat al-ʿIshaʾ
Garoonka Diyaaradaha ee Da Nang	Flughafen Da Nang
Cirbadii dhimashada	Gelber Mittelmeerskorpion
Nansi Ajram	Nancy Ajram
Afti Dastuurka Soomaaliya, 1961	Verfassungsreferendum in Somalia 1961
Nashiido	Naschid
Azania	Azania
Awdal	Awdal (Region)
Awdheegle	Awdheegle
Ayuub Daa'uud	Ayub Daud
Bankiga Somaliland	Baanka Somaliland
Baardheere	Baardheere
Badhan	Badhan
Jasiiradaha Jubbada Hoose	Bajuni-Inseln
Baki	Baki (Somalia)
Banaadir	Banaadir
Baargaal	Bargaal
Bari	Bari (Begriffsklärung)
Baay	Bay (Somalia)
Sedjibeke	Würfel (Geometrie)
Beledweyne	Beledweyne
Reer Xamar	Benadiri
Garoowe	Garoowe
Derg	Derg
Kilometer	Kilometer
Web feed	Web-Feed
Salaada Duhur	Salat al-Zuhr
YouPorn	YouPorn
Liiska magaalooyinka adduunka dad ahaan	Liste der Millionenstädte
Guraag	Gurage
Hectometre	Hektometer
Gaarisa	Garissa
Siltee	Silt’e (Volk)
Decametre	Dekameter
Sool	Sool (Somalia)
York University	York University
Buurta Xira	Hirā'
Gedo	Gedo
Gaalkacyo	Gaalkacyo
Guddi	Ausschuss
Togdheer	Togdheer
Goobogali	Multiple Choice
Galguduud	Galguduud
Woqooyi Galbeed	Woqooyi Galbeed
Shabeellaha Hoose	Shabeellaha Hoose
Mudug	Mudug
Jubbada Hoose	Jubbada Hoose
Saxiixu Muslim	Sahīh Muslim
Boorama	Boorama
Taran	Produkt (Mathematik)
Reoviruses	Reoviridae
Matoor	Motor (Begriffsklärung)
Wikipedia:Caawinaad	Hilfe:Übersicht
Wikipedia:Tutorial	Wikipedia:Tutorial
Miraha Mucjisada	Wunderbeere
Pontifícia Universidade Católica de Minas Gerais	Pontifícia Universidade Católica de Minas Gerais
Hadaaftimo	Hadaaftimo
Galmudug	Galmudug
Doorashada Baarlamaanka Soomaaliya, 1964	Parlamentswahlen in Somalia 1964
Canjeelo	Injera
USC	Vereinigter Somalischer Kongress
Dawladii Mamaaliikta	Mamluken
Poxviruses	Poxviridae
Digri	Dhikr
Burco	Burao
Ajdjadajd	Jubaland
Mandheera	Mandera
Cadaad	Gummiarabikumbaum
Qabaa'ilka Soomaaliya	Clansystem der Somali
Sagaaro	Silberdikdik
Sheekh Aways	Hassan Dahir Aweis
Ibraahim Xasan Caddoow	Ibrahim Hassan Addow
Bu’aale	Bu’aale
Budka Suflera	Budka Suflera
Buuhoodle	Buhoodle
Gabiley	Gabiley
Warshiikh	Warsheikh
Hobyo	Hobyo
Jamaame	Jamaame
Xudur	Huddur
Doolow	Doolow
Garbahaarey	Garbahaarrey
Murshid abad	Murshidabad
Ceerigaabo	Erigabo
Galdogob	Galdogob
Feerfeer	Ferfer
Iskushuban	Iskushuban
Xaafuun	Hafun
Laascaanood	Las Anod
Laasqoray	Laasqorey
Maydh	Maydh
Buuloburde	Buulobarde
Buurhakaba	Buurhakaba
Eyl	Eyl
Saxiixul Bukhaari	Sahīh al-Buchārī
Shiilaabo	Shilabo
Abuu Dar Alghafaari	Abū Dharr al-Ghifārī
Calool	Magen
Senary	Senär
Jubbada Dhexe	Jubbada Dhexe
Nugaal	Nugaal (Region)
Internet Adult Film Database	Internet Adult Film Database
Ceres	Ceres
Lambar Tubaxan	Ternärsystem
Ciidamada Qalabka Sida ee Masaarida	Streitkräfte Ägyptens
Dadka Tigrega	Tigre (Volk)
Daallo Airlines	Daallo Airlines
Kaniini	Pille
Garoonka Diyaaradaha ee Aadan Cadde	Flughafen Mogadischu
Liverpool FC	FC Liverpool
Xariiqanta Cagaaran	Grüne Linie
Duurjoog	Humbug (Album)
Tusbax	Misbaha
Raas Caseyr	Kap Guardafui
GCompris	GCompris
Jacfar Bin Abii Daalib	Dschaʿfar ibn Abī Tālib
Siyaasadda Soomaaliya	Politik Somalias
Makemake	Makemake
Ciise (qabiil)	Issa (Clan)
Wabiga Daawa	Dawa (Fluss)
Wikipedia:Safaarad	Wikipedia:Botschaft
Dhoobley	Dhobley
Naafto	Diesel
U qeybin	Division (Mathematik)
Dir	Dir (Clan)
UCID	UCID
Samuel Eto'o	Samuel Eto’o
RedTube	RedTube
Noole	Kreatur
Islii	Eastleigh (Nairobi)
Taariikhda Somaliland	Geschichte Somalilands
Shabiixa	Schabiha
Maakhir	Maakhir
Ceeldheer	Eldheere
Ra'iisul wasaarayaashii Soomaaliya	Liste der Premierminister Somalias
Qurac	Vachellia tortilis
Garoonka Diyaaradaha ee Bender Qaasim	Flughafen Boosaaso
Imtixaan	Prüfung
Agnes Monica	Agnes Monica
Ismaaciil	Ismail
Sabuur	Zabur
Farta Cismaaniya	Osmaniya-Schrift
Xuseen Maxamed Faarax Caydiid	Hussein Mohammed Farah
Mustafa Maxamed	Mustafa Mohamed
Maxamed Cabdi Yuusuf	Mohammed Abdi Yusuf
Ibn Mandhuur	Ibn Manzūr
Cali Khaliif Galayr	Ali Khalif Galaid
Category:Jarmal	Kategorie:Deutschland
Category:Talyaaniga	Kategorie:Italien
Category:Qaramada Midoobey ee Maraykanka	Kategorie:Vereinigte Staaten
Category:Ruushka	Kategorie:Russland
Category:Midowga boqortooyada Britan	Kategorie:Vereinigtes Königreich
Category:Isbania	Kategorie:Spanien
Category:Shiinaha	Kategorie:China
Category:Hindiya	Kategorie:Indien
Category:Sucuudiga	Kategorie:Saudi-Arabien
Category:Turki	Kategorie:Türkei
Category:Koonfur Afrika	Kategorie:Südafrika
Category:Masar	Kategorie:Ägypten
Category:Iiraan	Kategorie:Iran
Category:Arjantiina	Kategorie:Argentinien
Jamhuuriya	Liste arabischer Zeitungen
Wanlaweyn	Wanlaweyne
Category:Afqaanistan	Kategorie:Afghanistan
Category:Austriya	Kategorie:Österreich
Category:Itoobiya	Kategorie:Äthiopien
Category:Ciraaq	Kategorie:Irak
Category:Nederland	Kategorie:Niederlande
Category:Bakistaan	Kategorie:Pakistan
Category:Boland	Kategorie:Polen
Category:Bortuqaal	Kategorie:Portugal
Category:Suudaan	Kategorie:Sudan
Category:Iswisarland	Kategorie:Schweiz
Category:Fiyetnam	Kategorie:Vietnam
Category:Shimbir	Kategorie:Vögel
Category:Fiisikis	Kategorie:Physik
Category:Bayoloji	Kategorie:Biologie
Category:Kimisteri	Kategorie:Chemie
Category:Taariikh	Kategorie:Geschichte
Category:Juqraafi	Kategorie:Geographie
Category:Diin	Kategorie:Religion
Category:Ciyaaraha	Kategorie:Sport
Category:Saynis	Kategorie:Wissenschaft
SYL	Somalische Jugendliga
Category:Filimaanta	Kategorie:Film
Category:Isgaadhsiin	Kategorie:Kommunikation
Jamhuuriyadda Dimuqraadiga Soomaaliya	Demokratische Republik Somalia
Dhaqaallaha Soomaaliya	Wirtschaft Somalias
Jabhadda Wadaniga Xoreynta Ogaadeenya)	Ogaden National Liberation Front
Wabiga Togdheer	Togdheer (Fluss)
Jilib	Jilib
Sheekh Mukhtaar Abu-Mansuur	Mukhtar Robow
Hergab	Rauchfang
Bolol	Echter Hausschwamm
Hawd	Haud
Hawiye	Hawiye
Qardho	Qardho
Ciidamada Midowga Afrika	Mission der Afrikanischen Union in Somalia
Cabdiraxmaan bin Cawf	ʿAbd ar-Rahmān ibn ʿAuf
International Rescue Committee	International Rescue Committee
Qandala	Qandala
Janaale	Janaale
Ciidamada Somaliland	Streitkräfte von Somaliland
Ras kambooni	Kaambooni
Luqmaan Alxakiim	Luqman
Cali Cadde	Ali Adde
Submission (film)	Submission (Film)
SNM	Somali National Movement
Mustaxiil	Mustahil
Laas Geel	Laas Geel
Riyaalu Saalixiin	Riyad as-Salihin
Cal Madow	Al Mado
Xisbiga talada ee dalka jabuuti RPP	Rassemblement Populaire pour le Progrès
Isaaq	Isaaq
Luuq	Luuq
Elman FC	Elman FC
Muxaram	Muharram
Muuse Suudi Yalaxow	Musa Sudi Yalahow
Shirkada Isgaariinta ee Nationlink	NationLink Telecom
Category:Filasoofiyada	Kategorie:Philosophie
Category:Cilminafsi	Kategorie:Psychologie
Category:Masiixiyad	Kategorie:Christentum
Category:Islaam	Kategorie:Islam
Goronyo soomaaliyeed	Somalistrauß
Garbisaar	Kopftuch
Digil iyo Mirifle	Rahanweyn
UDUB	UDUB
Doorashada Baarlamaanka Soomaaliya, 1969	Parlamentswahlen in Somalia 1969
Doorashada Baarlamaanka Soomaaliya, 1979	Parlamentswahlen in Somalia 1979
Doorashada Baarlamaanka Soomaaliya, 1984	Parlamentswahlen in Somalia 1984
Xisbiga Nabadda iyo Horumarka	Partei für Frieden und Entwicklung
Qoryooley	Qoryooley
Waajid	Wajid (Somalia)
Doorashadii madaxtinimo ee somaliland 2010	Präsidentschaftswahlen in Somaliland 2010
Dafo	Adler (Biologie)
PornoTube	PornoTube
Doorashada Madaxtinimada Soomaaliya, 1986	Präsidentschaftswahlen in Somalia 1986
May 2013	Mai 2013
Jaamacadda Roma Tre	Universität Rom III
Bankiga Dhexe ee Soomaaliya	Somalische Zentralbank
Saldanadii Cadal	Sultanat Adal
Dad	Volk
Universidade do Estado de Minas Gerais	Universidade do Estado de Minas Gerais
Afti Dastuurka Soomaaliya, 1979	Verfassungsreferendum in Somalia 1979
Villa Somalia	Villa Somalia
Boon (firimbi)	Schneckenhorn
Bander Beyla	Bandarbeyla
Maher Zain	Maher Zain
Cali Cabdi faarax	Ali Abdi Farah
Seedi	Schwager
Jaamacada Urdun Ee Culuumta Iyo Teknoloojiyada	Jordanische Universität für Wissenschaft und Technologie
Laan	Ast
Category:Dhaqan	Kategorie:Kultur
Category:Tobaneeyada sano	Kategorie:Jahrzehnt
Category:Sanad	Kategorie:Jahr
Category:Qaaradaha	Kategorie:Kontinent
Edmond Debeaumarché	Edmond Debeaumarché
Portal:Cilmi Fallag	Portal:Astronomie
Portal:Juqraafi	Portal:Geographie
Gunbur	Pyramide (Geometrie)
Turunbo	Tanbur
Anna Rita Del Piano	Anna Rita Del Piano
Category:Wikipedia bots	Kategorie:Benutzer:Bot
Dagaal Dhaqameedka shiineeska	Chinesische Kampfkünste
Portal:Bulsho	Portal:Gesellschaft
Cufka atamka	Atommasse
Hotmail	Hotmail
Wikipedia:Su'aal/Hordhac	Wikipedia:Auskunft
Wikipedia:Graphics Lab	Wikipedia:Redaktion Bilder
Wikipedia:Soo Bandhigga Sawirka Xulka	Wikipedia:Kandidaten für exzellente Bilder
Wikipedia:Maamulka	Wikipedia:Administratoren
Category:Shaqsiyadaad	Kategorie:Person
Wikipedia:Requests for adminship	Wikipedia:Kandidaturen
Wikipedia:Bots	Wikipedia:Bots
Category:Amin	Kategorie:Zeit
Category:Internet	Kategorie:Internet
Category:Siyaasad	Kategorie:Politik
Category:Waxbarasho	Kategorie:Bildung
Category:Araga	Kategorie:Optik
Category:Fan	Kategorie:Kunst
Masar	Ägypten
Category:Filasoofiyaasha	Kategorie:Philosoph
Category:Doorashooyinka	Kategorie:Wahl
Template:Bot	Vorlage:Bot
Kanada	Kanada
Category:Denmark	Kategorie:Dänemark
Category:Giriig	Kategorie:Griechenland
Category:Iswiidhan	Kategorie:Schweden
Category:Islofaakiya	Kategorie:Slowakei
Wikipedia:Copyright	Wikipedia:Lizenzbestimmungen
Wikipedia:Ku saabsan	Wikipedia:Über Wikipedia
Qolobaa Calankeed	Qolobaa Calankeed
Category:Microsoft	Kategorie:Microsoft
Portal:Saynis	Portal:Wissenschaft
Wikipedia:Ogaysiiska Maamulka	Wikipedia:Administratoren/Anfragen
Wikipedia:Goob/Farsamo	Wikipedia:Technik/Werkstatt
Category:Wadamada Yurub	Kategorie:Staat in Europa
Category:Yurub	Kategorie:Europa
Wikipedia:Bogga Isticmaalaha	Hilfe:Benutzernamensraum
Template:Documentation	Vorlage:Dokumentation
Wikipedia:Ilaalinta badelka	Wikipedia:Geschützte Seiten
Wikipedia:Albaabka bulshada	Wikipedia:Autorenportal
Category:Luqadaha wikipediyaasha	Kategorie:Benutzer:nach Sprache
Wikipedia:Shan walxood	Wikipedia:Grundprinzipien
Wikipedia:Userboxes	Benutzer:Vorlage
Wikipedia:Saxiix	Hilfe:Signatur
Caa'isha binti Abiibakar	Aischa bint Abi Bakr
Ganacsi	Unternehmen
Instituto Federal da Bahia	Instituto Federal da Bahia
Template:Softredirect	Vorlage:Interwiki redirect
Template:Tirtir	Vorlage:Löschen
Qaw	Bender Siyaada
Category:Teknooloji	Kategorie:Technologie
Category:Afafka	Kategorie:Einzelsprache als Thema
Category:Kalandar	Kategorie:Kalender
Category:Wikipedia	Kategorie:Wikipedia
Wikipedia:Masuul la'aan guud	Wikipedia:Impressum
Category:Pages with broken file links	Kategorie:Wikipedia:Defekter Dateilink
Wikipedia:Tirakoob	Wikipedia:Statistik
Wikipedia:Xeerka Wiki	Wikipedia:Datenschutz
Template:Navbox	Vorlage:Erweiterte Navigationsleiste
Portal:Siiro	Portal:Biografien
Template:Clear	Vorlage:Absatz
Template:Nowrap	Vorlage:Nowrap
Millan	Lösung (Chemie)
Wikipedia:Maqaalada aan u baahan laheen	Wikipedia:Artikel, die es in allen Wikipedias geben sollte
Category:Afrika	Kategorie:Afrika
Category:Elektaroonig	Kategorie:Elektronik
Category:Kitaabka quduska	Kategorie:Bibel
Category:Buugta	Kategorie:Buchwesen
Category:Bilaha	Kategorie:Monat
Template:Babel	Vorlage:Babel
Category:Isbitaal	Kategorie:Krankenhaus
Wikipedia:Soo bandhigida xogta	Wikipedia:Literatur
Wikipedia:Habka maqaalada Xulka Ah	Wikipedia:Kandidaturen von Artikeln, Listen und Portalen/Kriteriendarstellung
Template:Digniin	Vorlage:Achtung
Template:User ar-1	Vorlage:User ar-1
Template:See also	Vorlage:Siehe auch
Template:User da-2	Vorlage:User da-2
Template:User da	Vorlage:User da
Template:User de	Vorlage:User de
Template:User de-1	Vorlage:User de-1
Template:User es	Vorlage:User es
Template:User de-3	Vorlage:User de-3
Template:User en-3	Vorlage:User en-3
Template:User en-1	Vorlage:User en-1
Template:User en-2	Vorlage:User en-2
Template:User en-4	Vorlage:User en-4
Template:User fi	Vorlage:User fi
Template:User en-0	Vorlage:User en-0
Template:User en	Vorlage:User en
Template:User de-2	Vorlage:User de-2
Template:User fi-1	Vorlage:User fi-1
Template:User fr-1	Vorlage:User fr-1
Template:User sk	Vorlage:User sk
Template:User fr-2	Vorlage:User fr-2
Template:User ja	Vorlage:User ja
Template:User ja-1	Vorlage:User ja-1
Template:User fr	Vorlage:User fr
Category:Aasiya	Kategorie:Asien
Category:Jili	Kategorie:Chile
Category:Ameerikada koonfureed	Kategorie:Südamerika
Template:Mod	Vorlage:Modulo
Template:User es-2	Vorlage:User es-2
Category:Maalmaha usbuuca	Kategorie:Wochentag
Category:Bogga Hore	Kategorie:Wikipedia:Hauptseite
Template:Click	Vorlage:Click
Template:Image label	Vorlage:Image label
Template:Dalalka Afrika	Vorlage:Navigationsleiste Staaten in Afrika
Template:Sidebar	Vorlage:Seitenleiste
Template:Infobox Xooga Dalka Soomaaliyeed	Vorlage:Infobox Streitkräfte
Template:Maqaal Xul Ah	Vorlage:Exzellent
Category:Gaana	Kategorie:Ghana
Category:User en	Kategorie:User en
Category:User en-2	Kategorie:User en-2
Template:Infobox	Vorlage:Infobox
Template:User eo	Vorlage:User eo
Template:User zh	Vorlage:User zh
Category:Farta	Kategorie:Alphabet
Template:Min	Vorlage:Min
Category:Astaannta Qaranka	Kategorie:Wappen
Category:Beeraha	Kategorie:Landwirtschaft
Template:Maamulka	Vorlage:Admininfo
Category:Dowladaha	Kategorie:Staat
Category:Bahda Midaysay Qoraxdu	Kategorie:Planet des Sonnensystems
Category:Falastiin	Kategorie:Palästina
Category:Language user templates	Kategorie:Vorlage:Babel-Sprache
Category:Kacaanka	Kategorie:Revolutionär
Category:Qoraaga	Kategorie:Autor
Category:Jaamacadaha	Kategorie:Universität
Wikipedia:Maxaan akoon usamaynayaa	Hilfe:Benutzerkonto anlegen
Template:User pt-1	Vorlage:User pt-1
Template:Infobox planet	Vorlage:Infobox Planet
Template:User nl	Vorlage:User nl
Template:Infobox website	Vorlage:Infobox Website
Template:Image label end	Vorlage:Image label end
Template:Documentation subpage	Vorlage:Dokumentation/Dokuseite
Template:Infobox number	Vorlage:Infobox Ganze Zahl
Template:Rtl-lang	Vorlage:Rtl-lang
Category:Dekedaha	Kategorie:Hafen
Template:Lang-la	Vorlage:LaS
Template:User	Vorlage:Benutzer
Template:References	Vorlage:Belege fehlen
Template:Kaydka wadahadalka	Vorlage:Archiv
Portal:Fiisikis	Portal:Physik
Template:User de-0	Vorlage:User de-0
Template:Usbuuc	Vorlage:Navigationsleiste Wochentage
Template:Hooyga Maqaalada	Vorlage:Index
Category:Booliis	Kategorie:Polizei
Template:Astaamayn	Vorlage:Satzzeichen
Template:User sandbox	Vorlage:Benutzerspielwiese
Template:MainPageInterwikis	Wikipedia:Hauptseite/Interwikis
Template:User pt-3	Vorlage:User pt-3
Template:User pt-2	Vorlage:User pt-2
Category:User sk	Kategorie:User sk
Category:User eo	Kategorie:User eo
Category:User ja	Kategorie:User ja
Category:User da-2	Kategorie:User da-2
Category:Ganacsi	Kategorie:Wirtschaft
Template:Correct title	Vorlage:Korrekter Titel
Category:User ar	Kategorie:User ar
Category:Jasiirad	Kategorie:Insel
Category:User da	Kategorie:User da
Category:User sk-N	Kategorie:User sk-M
Category:User de	Kategorie:User de
Category:User fi	Kategorie:User fi
Category:Nabiyada Islaamka	Kategorie:Prophet des Islam
Category:Tiirarka Islaamka	Kategorie:Fünf Säulen des Islam
Category:User ja-1	Kategorie:User ja-1
Category:User ko	Kategorie:User ko
Template:Macluumaad	Vorlage:Information
Wikipedia:Babel	Wikipedia:Babel
Category:Badaha	Kategorie:Meer
Category:Ingiriiska	Kategorie:England
Template:Str ≥ len	Vorlage:Str ≥ len
Category:Taariikhda Soomaaliya	Kategorie:Geschichte (Somalia)
Category:Ururada caalamiga ah	Kategorie:Internationale Organisation
Category:Gobolada Soomaaliya	Kategorie:Region in Somalia
Category:Juquraafiga Soomaaliya	Kategorie:Geographie (Somalia)
Category:Madaxda Soomaaliya	Kategorie:Präsident (Somalia)
Category:Cilmiga bulshada	Kategorie:Sozialwissenschaft
Category:Wadamada Afrika	Kategorie:Staat in Afrika
Template:User da-3	Vorlage:User da-3
Template:User pt-4	Vorlage:User pt-4
Category:User so	Kategorie:User so
Category:User so-N	Kategorie:User so-M
Category:1542	Kategorie:1542
Fenerbahce SK	Fenerbahçe SK
Universidade Federal do Recôncavo da Bahia	Universidade Federal do Recôncavo da Bahia
Category:Farshaxanka	Kategorie:Maler
Wikipedia:Xeerka adeegsiga sawirada	Wikipedia:Bildrechte
Template:Raadiyoow	Vorlage:Infobox Hörfunksender
Category:Dhirta	Kategorie:Baum
Portal:Baayooloji	Portal:Biologie
Category:Juquraafiga Hindiya	Kategorie:Geographie (Indien)
Category:Xisbiyada Somaliland	Kategorie:Partei in Somaliland
Category:Jabuuti	Kategorie:Dschibuti
Category:Ereteriya	Kategorie:Eritrea
Category:Kiinya	Kategorie:Kenia
Muqdisho Stadium	Mogadischu-Stadion
Category:Komoros	Kategorie:Komoren
Category:Libiya	Kategorie:Libyen
Category:Diinta Soomaaliya	Kategorie:Religion (Somalia)
Category:Dhaqaalaha Soomaaliya	Kategorie:Wirtschaft (Somalia)
Category:Lacagta	Kategorie:Währung
Category:Webiyada	Kategorie:Fluss
Category:Juquraafiga Jabuuti	Kategorie:Geographie (Dschibuti)
Template:User pt	Vorlage:User pt
Category:Holland	Kategorie:Holland
Category:Soomaaliya	Kategorie:Somalia
Category:Webiyada Soomaaliya	Kategorie:Fluss in Somalia
Template:DecreasePositive	Vorlage:GefallenPositiv
Category:Juquraafiga Yemen	Kategorie:Geographie (Jemen)
Category:Magaalooyinka Yemen	Kategorie:Ort im Jemen
Template:Maanta	Vorlage:Heute
Category:User nl	Kategorie:User nl
Category:Hay'ada laanqayrta cas	Kategorie:Rotes Kreuz
Category:Suuriya	Kategorie:Syrien
Category:Qarniyada	Kategorie:Jahrhundert
Category:Qarnigii 16aad	Kategorie:16. Jahrhundert
Category:Qooriyada	Kategorie:Strand
Category:Ciidanka Soomaaliya	Kategorie:Militär (Somalia)
Codweyne	Oodweyne
Category:Harraha Afrika	Kategorie:See in Afrika
Category:Madaxda Faransiiska	Kategorie:Staatspräsident (Frankreich)
Category:Madaxda Iiraan	Kategorie:Präsident (Iran)
Category:Norway	Kategorie:Norwegen
Category:Yemen	Kategorie:Jemen
Category:Mutolojiyada	Kategorie:Mythologie
Category:Qaamuus	Kategorie:Wörterbuch
Category:Axdiga Cusub	Kategorie:Neues Testament
Category:Ilko	Kategorie:Zahn
Category:Dhaqanka Soomaalida	Kategorie:Kultur (Somalia)
Category:Wikimedia	Kategorie:Wikimedia
Category:Radio	Kategorie:Hörfunk
Category:Xayawaan	Kategorie:Vielzellige Tiere
Category:Jamhuriyadda	Kategorie:Republik
Category:Muqdisho	Kategorie:Mogadischu
Category:Bartamaha Ameerika	Kategorie:Mittelamerika
Category:Caasimadaha	Kategorie:Hauptstadt
Category:Magaalooyinka Hindiya	Kategorie:Ort in Indien
Category:Isgaarsiinta	Kategorie:Telekommunikation
Category:Gaadiidka	Kategorie:Verkehrswesen
Category:Ameerikada waqooyi	Kategorie:Nordamerika
Category:Harraha	Kategorie:See
Category:Saxaabada	Kategorie:Sahāba
Category:Calamada	Kategorie:Flagge
Template:Macluumaad luqadda	Vorlage:Infobox Sprache
Category:Dimoqraadi	Kategorie:Demokratie
Kaaroot	Karotte
Category:Caasimadaha afrika	Kategorie:Hauptstadt in Afrika
Category:Magaalooyinka Jabuuti	Kategorie:Ort in Dschibuti
Category:Guurka	Kategorie:Ehe
Category:Aadam iyo Xaawo	Kategorie:Adam und Eva
Category:Caasimadaha yurub	Kategorie:Hauptstadt in Europa
Category:Somaliland	Kategorie:Somaliland
Category:Caafimaadka	Kategorie:Gesundheit
Template:Clickable button 2	Vorlage:MediaWiki-Button
Template:Lang-pl	Vorlage:PlS
Category:Buuraha Soomaaliya	Kategorie:Berg in Somalia
The Narrative	The Narrative
Portal:Xisaab	Portal:Mathematik
Trojany	Trojany (Woiwodschaft Masowien)
Category:Wadamada Aasiya	Kategorie:Staat in Asien
Portal:Siyaasadda	Portal:Politik
Portal:Qaynuun	Portal:Recht
Category:Abidjan	Kategorie:Abidjan
Category:Antananarifo	Kategorie:Antananarivo
Lug (xubin)	Unterschenkel
Category:Bamako	Kategorie:Bamako
Eray bixin	Terminologie
Category:Esperanto	Kategorie:Esperanto
Template:Lang-am	Vorlage:AmS
Template:Lang-sv	Vorlage:SvS
Category:Garoomaha Ciyaaraha Soomaaliya	Kategorie:Fußballstadion in Somalia
Portal:Kimistari	Portal:Chemie
Category:Linux	Kategorie:Linux
Category:Soomaali Galbeed	Kategorie:Somali
Category:Siyaasada Soomaaliya	Kategorie:Politik (Somalia)
Category:Komunistiyaasha	Kategorie:Mitglied einer kommunistischen Partei
Category:Qiyaasaha Masaafooyinka	Kategorie:Längeneinheit
Category:Triboli	Kategorie:Tripolis
Category:Jaamacadaha Soomaaliya	Kategorie:Universität in Somalia
Category:User so-3	Kategorie:User so-3
Category:User so-4	Kategorie:User so-4
Category:User nl-4	Kategorie:User nl-4
Category:Template:Maqaal Xul Ah Bogga Hore	Kategorie:Wikipedia:Hauptseite/Artikel des Tages
Template:Image label begin	Vorlage:Image label begin
Category:Magaalooyinka Soomaali Galbeed	Kategorie:Ort in Somali
Category:Suuradaha Qur'aanka	Kategorie:Sure
Category:User en-1	Kategorie:User en-1
Universidade Fundação Mineira de Educação e Cultura	Universidade Fundação Mineira de Educação e Cultura
Portal:Caafimaad	Portal:Medizin
Template:Afarta xilli	Vorlage:Navigationsleiste Jahreszeiten
Kalagoyn	Minuszeichen
Wikipedia:Tutorial (Talk pages)	Wikipedia:Tutorial/5
Wikipedia:Tutorial (Keep in mind)	Wikipedia:Tutorial/1
Template:User nl-3	Vorlage:User nl-3
Template:Wayback	Vorlage:Webarchiv
Wikipedia:Tutorial (Wrap-up and more info)	Wikipedia:Tutorial/6
Template:User so-2	Vorlage:User so-2
Template:User so-3	Vorlage:User so-3
Template:User so-1	Vorlage:User so-1
Template:User so	Vorlage:User so
Template:User so-4	Vorlage:User so-4
Portal:Soomaaliya	Portal:Somalia
Template:Weather box/colpastel	Vorlage:Weather box/colpastel
Parvoviruses	Parvoviridae
Rooman	Wasserversorgung im Römischen Reich
Wikipedia:Editnotice	Hilfe:Editnotice
Kim Cesarion	Kim Cesarion
Magaca Muuse	Moses (Vorname)
Adnan Januzaj	Adnan Januzaj
Cabdiweli Sheekh Axmed	Abdiweli Sheikh Ahmed
Barkhad Cabdi	Barkhad Abdi
Special:RecentChanges	Spezial:Letzte Änderungen
Aqriste	Reader
Category:Wabiyada Afrika	Kategorie:Fluss in Afrika
